id,name,1,2,3,4,5,N
73329271,Killer Innovations with Phil McKinney - A Show About Ideas Creativity And Innovation,1,0,2,1,30,34
73329284,Science Friday,52,44,56,39,236,427
73329293,Escape Pod,7,3,3,1,36,50
73329404,This Week in Tech (Audio),173,61,45,29,192,500
73329520,Distorted View Daily,2,1,0,1,46,50
73329548,Las Vegas Podcast: Five Hundy by Midnight,9,5,2,5,77,98
73329638,Big Picture Science,6,6,4,9,144,169
73329719,KQED's Forum,5,1,6,3,25,40
73329726,The Deadpod,1,0,2,3,198,204
73329771,"KCRW's Left, Right & Center",154,74,74,58,140,500
73329816,The Roadhouse,0,0,0,0,59,59
73329877,The Radio Adventures of Dr. Floyd,1,0,0,5,44,50
73330054,The Science Show - Full Program Podcast,3,1,2,0,19,25
73330112,Filmspotting: Reviews & Top 5s,16,9,10,12,453,500
73330188,Endurance Planet,2,1,5,0,42,50
73330265,Comic Geek Speak Podcast - The Best Comic Book Podcast,14,14,15,12,145,200
73330306,Background Briefing,8,1,1,2,84,96
73330343,Life Matters - Full program podcast,2,0,3,1,11,17
73330406,Sci-Fi Talk,0,0,1,1,6,8
73330501,This Week in Science – The Kickass Science Podcast,35,16,11,11,140,213
73330528,Feast of Fun: Gay Talk Show,8,1,3,2,36,50
73330572,Fighting Talk,9,4,7,10,100,130
73330703,Design and Architecture,3,2,1,2,8,16
73330715,On the Media,14,1,2,2,31,50
73330785,Mac Geek Gab (Enhanced AAC),2,6,8,27,457,500
73330855,Marketplace Tech,12,8,3,2,25,50
73330895,In Our Time,12,12,15,18,120,177
73330911,All In The Mind,2,3,1,9,64,79
73330961,Late Night Live - Full program podcast,8,0,1,5,77,91
73331136,Utah's Morning News,1,0,1,0,4,6
73331167,Geek News Central Podcast,0,2,2,12,34,50
73331209,From Our Own Correspondent Podcast,2,1,1,2,41,47
73331296,Slice of SciFi Radio,4,5,2,6,47,64
73331325,Dr Karl Podcast,10,1,3,6,111,131
73331418,Zencast,3,1,1,7,94,106
73331469,The Autoblog Podcast,8,8,13,5,16,50
73331490,Digital Planet,0,1,0,1,9,11
73331636,The Brian Lehrer Show,7,3,2,5,49,66
73331713,Nightline,18,10,10,6,12,56
73799286,Studio 360 with Kurt Andersen,6,1,0,7,66,80
73800749,Pulse of the Planet Podcast with Jim Metzner | Science | Nature | Environment | Technology,0,1,0,0,4,5
73800820,HomeShow Radio Show | Tom Tynan,1,2,0,0,2,5
73802253,AEW Week in Review - AEW News & Opinion Podcast,9,3,3,4,66,85
73802266,Life.Church with Craig Groeschel,0,1,2,2,82,87
73802605,LensWork - Photography and the Creative Process,0,0,0,0,9,9
73802620,The Documentary Podcast,0,0,0,0,8,8
73802698,Kermode and Mayo's Film Review,17,6,4,8,60,95
73802706,The Tech Guy (Audio),28,22,13,31,267,361
73834678,Sports Business Radio Podcast,0,0,0,2,17,19
73907228,Into Tomorrow With Dave Graveline,0,0,0,0,5,5
74071760,Polyamory Weekly,2,2,1,8,94,107
74171648,The Naked Scientists Podcast,4,0,1,11,100,116
74173178,World of Warcast: A World of Warcraft Podcast,6,2,6,5,31,50
74198801,Manager Tools,8,7,6,5,174,200
74241109,Art Talk,0,0,0,0,6,6
74254710,All Of It,15,7,1,9,31,63
74257105,Film Junk Podcast,14,4,4,12,144,178
74374416,"MacCast - For Mac Geeks, by Mac Geeks",6,1,7,22,328,364
74840240,NBC Meet the Press,176,57,32,34,109,408
74844038,CounterSpin,0,1,1,3,42,47
74844126,WSJ Tech News Briefing,20,16,21,16,79,152
74848525,Major Nelson Radio,8,6,4,8,24,50
74849126,Law Report - Full program podcast,0,0,0,0,1,1
74942331,Apple Quarterly Earnings Call,1,2,0,2,15,20
75081757,Free Buddhist Audio,0,0,0,1,10,11
75089978,Slate Daily Feed,26,21,10,14,106,177
75089988,Berkeley Buddhist Monastery,0,0,0,0,5,5
75092679,Basic Brewing Radio,1,0,0,5,99,105
75112144,Calvary Chapel Chino Hills,2,0,0,1,45,48
75195584,Gamertag Radio,7,4,4,1,34,50
75462585,NBC Nightly News with Lester Holt,52,24,19,15,55,165
75519213,Audio Dharma,0,2,1,0,85,88
75551187,Bishop Robert Barron’s Sermons - Catholic Preaching and Homilies,2,1,1,5,230,239
75643495,Soundcheck,0,0,1,2,10,13
75908431,English as a Second Language (ESL) Podcast - Learn English Online,3,0,0,4,43,50
76069540,The Weekly Mix,0,0,0,4,46,50
76207297,iCritical Care: All Audio,1,4,2,1,11,19
76583739,Bethel Church Sermon of the Week,15,1,1,4,242,263
76591483,Chabad.org - Daily Torah Study,1,1,0,1,12,15
76699727,MuggleCast: the Harry Potter podcast,15,9,6,18,152,200
77001367,The Dave Ramsey Show,308,84,78,30,262,762
77001367,The Ramsey Show,154,42,39,15,131,381
77407482,Irish and Celtic Music Podcast,1,2,3,2,42,50
77712661,PUB SONGS & STORIES,0,0,0,1,17,18
77840861,White Roof Radio - The MINI Cooper Podcast,2,0,0,0,48,50
78149892,Chobo-Ji's Zen Podcast,0,0,0,0,10,10
78311760,CAGcast,10,2,3,0,35,50
78370505,ARRL Audio News,0,0,0,0,5,5
78459818,PARANORMAL PODCAST,21,8,16,34,420,499
78561049,Scott Sigler's Audiobooks,1,0,0,0,49,50
78571725,Skydive Radio,0,0,1,0,21,22
78775671,WMMR's Preston & Steve Daily Podcast,1,1,2,5,41,50
78780644,The RELEVANT Podcast,45,15,17,32,391,500
78797836,Duct Tape Marketing,0,0,0,2,47,49
78833595,Talking Metal,5,3,2,2,38,50
78911087,Face the Nation on the Radio,62,30,18,14,41,165
78995043,Hack,23,5,6,6,55,95
79016499,Security Now (Audio),19,20,22,19,204,284
79063354,Travel with Rick Steves,10,8,10,10,91,129
79085800,I Should Be Writing,3,1,3,8,81,96
79138340,PotterCast: The Harry Potter Podcast (since 2005),42,17,7,10,124,200
79155128,BirdNote,2,1,0,1,36,40
79424011,Amateur Traveler Travel Podcast,6,6,6,22,184,224
79430865,Video Game Outsiders,14,4,5,5,22,50
79453758,A Spoonful of Russian - Learn Russian Online from Russian Tutor,1,0,0,0,30,31
79497721,Decoder Ring Theatre,0,0,0,1,49,50
79677184,The Martin Bailey Photography Podcast,0,1,0,2,47,50
79678009,Blackhawks Insider - Official Chicago Blackhawks Podcast,0,3,1,3,18,25
79681292,KQED's The California Report,7,3,0,2,24,36
79681293,The Environment Report,1,0,0,2,8,11
79687345,All Songs Considered,9,4,8,3,26,50
79896290,Raw Material,0,1,1,0,15,17
79898010,Betty in the Sky with a Suitcase!,3,2,3,1,41,50
79900698,The Project Management Podcast,2,1,1,4,34,42
79906946,The Genealogy Guys Podcast & Genealogy Connection,1,0,0,2,47,50
79930757,Persiflagers Infectious Disease Puscast,3,1,1,0,45,50
80028216,Pardes from Jerusalem,1,0,1,4,23,29
80106872,Living Planet | Deutsche Welle,0,0,0,0,2,2
80693391,Greg Laurie Podcast,0,2,4,4,132,142
81210923,60 Minutes,21,7,7,7,8,50
81415836,Entitled Opinions (about Life and Literature),2,1,2,4,49,58
81501666,Stuck in the '80s Podcast,0,4,1,6,58,69
81837345,The Digital Story Photography Podcast,2,0,0,5,43,50
81854832,The Math Factor,1,0,2,4,11,18
82014403,The Village Church - Sermons,4,1,5,5,254,269
82550696,Learn Japanese Pod,0,1,1,1,47,50
82775064,The Final Lap Weekly - NASCAR Talk Show,1,1,2,2,31,37
83213431,We the People,7,4,4,14,93,122
83326050,Urban Dharma,0,0,0,5,50,55
83653087,School of Podcasting,0,0,2,0,48,50
84246334,Bridgetown Audio Podcast,3,1,0,6,95,105
84867344,The Karel Cast,2,0,1,2,26,31
84885574,The Finer Points - Aviation Podcast,0,1,1,6,25,33
85496087,Ted Wells living : simple,0,1,0,0,4,5
86997870,The Splendid Table,25,26,19,10,120,200
88410531,Gateway People Audio Podcast,1,1,4,1,71,78
89411073,The Penguin Podcast,0,2,0,0,7,9
89603501,Insight for Living Daily Broadcast,4,1,9,6,121,141
90253586,Cast On,1,0,0,0,49,50
90983408,iFanboy - Comic Books,3,0,1,3,93,100
91235908,Talkin' Birds,0,0,0,0,14,14
91473880,Truth For Life Programs,0,1,1,1,162,165
91689834,"Planetary Radio: Space Exploration, Astronomy and Science",0,5,3,4,195,207
91959525,This Week with George Stephanopoulos,151,49,32,32,49,313
92613227,All Sides with Ann Fisher Podcast,0,1,0,0,9,10
93424211,The Accidental Creative,1,1,0,1,47,50
93465727,WhiskyCast,2,0,0,1,47,50
94009100,History of Photography Podcast,1,1,0,2,25,29
94571049,Storynory - Stories for Kids,6,2,4,3,35,50
94661257,Understanding the Times,7,0,1,0,55,63
94688506,Conversations,16,8,16,20,228,288
94793843,Sound Opinions,5,3,5,6,31,50
98746009,Real Time with Bill Maher,138,33,30,30,269,500
100441369,Holy Quran Daily Podcast,3,1,0,3,62,69
101102043,InDesign Secrets,0,0,0,0,9,9
103496481,A Buddhist Podcast,2,0,0,4,109,115
104559468,Animal Radio®,1,0,0,1,3,5
105441909,LearnItalianPod,2,4,4,9,31,50
105924375,The Dice Tower,5,6,7,3,29,50
106320028,Unfettered Mind,1,2,0,0,12,15
107134018,Point of Inquiry,19,10,8,13,121,171
107541824,World Cafe Words and Music from WXPN,6,3,3,2,13,27
107629726,Apple Context Machine,9,5,3,4,20,41
107923803,Documentary on One Podcast,0,0,0,0,10,10
109522474,Learning English Broadcast - VOA Learning English,0,0,0,0,2,2
110916650,Renewing Your Mind with R.C. Sproul,6,1,1,4,174,186
111065122,1 Year Daily Audio Bible,6,4,2,10,478,500
111121779,golf SMARTER,8,7,5,23,223,266
111739892,Learn Japanese | JapanesePod101.com (Video),1,1,1,2,16,21
112831729,Learn Japanese | JapanesePod101.com (Audio),1,1,5,6,37,50
112983123,Notes in Spanish Advanced,0,0,2,8,31,41
115155893,CO2 mon Amour,0,0,0,0,1,1
115156841,Le masque et la plume,0,1,0,1,4,6
115594899,The Instance: The Podcast for Lovers of WoW and Blizzard Games,11,4,1,3,31,50
117488860,Hanselminutes with Scott Hanselman,1,1,1,3,80,86
117752146,Daily Radio Program with Charles Stanley - In Touch Ministries,7,1,1,10,481,500
118290367,"Astronomy 162 - Stars, Galaxies, & the Universe",0,0,0,1,26,27
118334327,The Babylon Podcast,0,0,0,1,24,25
118352548,The Jodcast - astronomy podcast,1,0,3,4,49,57
118720919,The Atheist Experience,28,10,10,19,252,319
118796495,Paws & Tales Paws-cast,5,1,1,5,38,50
119843495,Learn Chinese - Easy Situational Mandarin Chinese Audio Lessons,5,1,2,4,38,50
120107389,Defected Radio,2,3,2,5,35,47
120315179,The Book Review,6,5,8,11,170,200
120315823,Popcast,24,20,11,20,41,116
120329020,Science Magazine Podcast,3,11,13,10,25,62
120703592,MicrobeWorld Video,0,0,0,0,5,5
120867842,Mac OS Ken,7,5,6,8,321,347
120906714,Software Engineering Radio - the podcast for professional software developers,1,1,1,2,22,27
120975641,Learn French With Alexa,0,1,5,4,40,50
121362031,Money Guy Show,2,2,2,8,186,200
121393815,Song of the Day,4,2,7,14,143,170
121493640,"A Way with Words: language, linguistics, and callers from all over",2,1,2,1,44,50
121493675,NPR News Now,68,18,22,20,168,296
121493688,Piano Puzzler,0,0,0,1,31,32
121493799,This I Believe,3,2,0,3,23,31
121493804,Wait Wait... Don't Tell Me!,14,4,8,16,148,190
121534955,On Point,52,28,32,17,71,200
121592912,Israel Hour Radio - Israeli Music Podcast,0,0,0,0,25,25
121592949,Off The Hook,6,0,0,1,8,15
121809318,The Money Pit Home Improvement Podcast,0,4,5,7,6,22
121834929,Jeff Curto's Camera Position,1,0,1,3,60,65
122384595,Science Talk,20,13,8,15,47,103
122415315,American Conservative University,11,2,3,2,32,50
122477102,PRN - Fast Talk Podcast,0,0,0,0,7,7
122478100,PRN - The Pit Reporters Podcast,0,0,0,1,2,3
123885923,Meditation Station by Stin Hansen,2,1,0,2,45,50
124686671,PODRUNNER: Workout Music,1,1,1,1,46,50
124960485,"Best of the Left - Progressive Politics and Culture, Curated by a Human",16,2,2,1,29,50
127338490,Easy French Poetry (French Today),0,0,0,1,29,30
127782776,Deejay Chiama Italia,0,0,0,0,1,1
127842171,The Candid Frame: Conversations on Photography,1,0,0,1,98,100
128594474,Zen Tiki Lounge,2,1,0,0,47,50
128859062,The Skeptics' Guide to the Universe,41,32,21,17,389,500
128978076,JAMA Editors' Summary,5,5,2,1,9,22
128985955,Around Comics - Comic Book Podcast,5,2,1,17,125,150
129558037,Superego,2,0,0,0,48,50
129584472,606,37,18,13,16,53,137
129684370,Catholic Answers Live,11,2,1,6,252,272
130062462,Carnegie Council Audio Podcast,1,1,0,2,7,11
130950322,Woman's Hour,18,7,10,9,52,96
132125271,Intelligent Design the Future,58,1,3,6,66,134
133542489,The Don Tony Show / Wednesday Night Don-O-Mite,45,12,13,14,104,188
135061239,"World Soccer Talk: Premier League, MLS, Champions League, EFL and more",29,12,15,16,85,157
135066958,EconTalk,3,5,4,2,36,50
135067274,Global News Podcast,364,203,182,245,1785,2779
135244146,Ask About Fly Fishing - Podcast,1,4,0,7,16,28
135353439,Philosopher's Zone,2,0,0,5,22,29
136697669,Science Weekly,3,1,1,4,13,22
137002798,Accounting Best Practices with Steve Bragg,0,0,1,2,23,26
137254859,Joel Osteen Podcast,136,4,4,28,332,504
137307413,Hora 25,4,1,1,1,4,11
137323360,Word In Your Ear,1,0,0,0,13,14
137329814,Marketplace Morning Report,8,5,2,7,28,50
137331757,Le journal de 8H00,0,0,0,0,1,1
137699414,Baseball Tonight with Buster Olney,114,37,34,54,261,500
137933382,Talking Beasts: The Narnia Podcast,0,0,1,2,26,29
138029914,The Brewing Network Presents | The Jamil Show,0,4,2,4,30,40
138155144,Podcasts – ESL Teacher Talk – ESL Podcasts for Teachers,3,2,0,1,0,6
138581935,Le journal de 18h00,0,0,0,0,2,2
138752347,Poetry Off the Shelf,1,2,2,5,51,61
140685432,Arts & Ideas,2,2,5,2,15,26
142870459,Upaya Zen Center's Dharma Podcast,0,0,0,0,7,7
142891498,Aquarium Drunkard - SIDECAR (TRANSMISSIONS) - Podcast,1,1,0,1,15,18
143250328,IMTalk,0,1,0,2,69,72
146224928,The Ageless Wisdom Mystery School with Michael Benner,1,0,1,2,25,29
147232181,PTI,123,27,37,41,272,500
147247199,Mad Money w/ Jim Cramer,64,12,10,8,104,198
147511169,Classical Performance,0,1,1,5,36,43
147907532,Food for Thought: How to Live Compassionately and Healthfully,3,2,0,1,94,100
148391214,CapRadio: Latest News Podcast,0,0,1,0,1,2
148759439,The Advanced Selling Podcast,6,2,3,3,77,91
150892556,On Being with Krista Tippett,0,0,0,0,5,5
151230264,Economist Radio,0,0,4,0,44,48
151451644,CraftLit - Serialized Classic Literature for Busy Book Lovers,0,0,0,2,95,97
152016440,WSJ What’s News,14,6,2,1,27,50
152022135,HBR IdeaCast,0,0,1,0,5,6
152024419,WSJ Your Money Briefing,12,7,5,10,16,50
152249110,Radiolab,80,28,14,12,56,190
152564324,Joyce Meyer Enjoying Everyday Life® TV Audio Podcast,12,3,3,10,249,277
152564333,Joyce Meyer Radio Podcast,0,0,1,0,12,13
152788201,Freethought Radio,6,10,14,12,73,115
153162007,FINRA Unscripted,0,0,0,0,6,6
154626007,"Fear the Boot, RPG Podcast",0,2,2,4,42,50
155864176,Let's Speak Italian!,6,4,1,6,33,50
155974141,Common Sense with Dan Carlin,108,20,17,9,346,500
156274672,Radio Free Nintendo,2,4,4,5,35,50
158004629,Audio Book Club,12,21,15,12,34,94
158004641,Political Gabfest,10,6,8,5,21,50
158175220,Rick Steves' Europe Video,1,1,1,3,17,23
158961219,Cato Daily Podcast,14,3,5,15,80,117
159168290,Zen Talks from Windhorse Zen Community,1,1,0,0,7,9
159752078,This Morning With Gordon Deal,48,55,62,41,172,378
160064459,The DIS Unplugged - A Weekly Roundtable Discussion About All Things Disney World,80,39,33,39,309,500
160075139,Linux Action News,7,3,2,5,48,65
160256534,Learn French by Podcast,3,1,3,6,37,50
160372141,Futures in Biotech (Audio),1,3,2,3,10,19
160835381,Vedanta and Yoga,1,0,0,0,17,18
160892972,TED Talks Daily (SD video),6,1,0,2,41,50
160904630,TED Talks Daily,245,98,63,154,399,959
161198236,Sekulow Radio Show,7,3,5,3,32,50
161305549,SBS Italian - SBS in Italiano,0,1,1,1,5,8
161305788,SBS Polish - SBS po polsku,0,0,0,1,1,2
163297674,Slate's Spoiler Specials,87,32,25,23,49,216
164330831,Big Ideas,5,2,4,8,40,59
164829166,Merriam-Webster's Word of the Day,21,8,10,14,55,108
165432351,PediaCast: Pediatric Podcasts for Parents,0,1,0,2,47,50
165764097,Morning Ireland,2,8,2,8,5,25
168151452,Lean Blog Interviews,0,0,0,0,12,12
169078375,My History Can Beat Up Your Politics,6,2,4,0,38,50
170271930,Learn Spanish - Survival Guide,11,6,4,6,23,50
170664746,Bigfoot Information Project Podcast,1,0,0,2,30,33
171668359,Puck Podcast,5,8,1,9,192,215
172243529,College of Judaism,0,0,0,0,2,2
173001861,Dan Carlin's Hardcore History,28,12,12,16,1008,1076
173429229,Grammar Girl Quick and Dirty Tips for Better Writing,5,4,2,1,38,50
174194853,Pure Sex Radio,0,0,0,0,13,13
174829950,RNZ: Nine To Noon,1,0,1,0,13,15
175135787,RNZ: Saturday Morning,2,0,0,1,21,24
178145160,48 Days to the Work You Love Internet Radio Show,6,3,1,5,140,155
179237749,MacBreak Weekly (Audio),10,7,11,7,15,50
179237854,Mark Driscoll Audio,49,4,2,9,266,330
179911785,PseudoPod,1,3,2,0,44,50
179927309,Beats in Space,0,1,0,0,34,35
181439332,Zorba Paster On Your Health,3,2,2,2,11,20
182496736,National Park Service,3,0,0,0,3,6
183589475,PHOTOGRAPHY 101,6,3,5,8,36,58
185237578,Uncontrolled Airspace: General Aviation Podcast,2,8,4,2,34,50
185699549,"""A Tale of Two Cities"" Audiobook (Audio book)",0,0,4,1,51,56
185795418,The Deer Park Dharmacast,0,0,0,0,7,7
185803769,"In the Groove, Jazz and Beyond",5,1,0,3,41,50
187310910,Patriots Unfiltered,17,8,7,9,150,191
187812953,11 O'Clock Comics Podcast,3,4,2,1,90,100
188247710,Better at English,0,1,0,1,18,20
188333691,Effortless English Podcast | Learn English with AJ Hoge,4,4,1,5,36,50
188674007,Football Weekly,26,4,12,8,96,146
189053885,Dragon Talk - An Official Dungeons & Dragons Podcast,12,3,7,8,20,50
189219027,Notes in Spanish Intermediate,0,0,2,3,28,33
189330872,60-Second Science,25,13,12,21,86,157
189512936,The Philosophy Podcast,1,7,3,16,13,40
190516844,Gun Talk,6,3,2,0,39,50
191303933,Learn French with daily podcasts,8,1,2,1,38,50
191316367,Messianic Shabbat - The Harvest,17,0,0,1,13,31
191636169,Astronomy Cast,11,9,12,22,446,500
192740136,Astronomy 161 - Introduction to Solar System Astronomy,0,0,1,3,45,49
192820274,The Ziglar Show,1,0,5,6,138,150
193128576,Farrakhan Speaks,4,2,0,0,18,24
193181775,The Official Adventures in Odyssey Podcast,3,0,2,2,43,50
194167775,The Real Estate Guys Radio Show - Real Estate Investing Education for Effective Action,12,3,3,5,94,117
196050704,John Piper Sermons,3,1,1,3,90,98
196090889,Medmal Insider,0,0,0,0,3,3
197308794,Learn To Meditate - Meditation Podcast,0,2,2,1,45,50
197875368,Windows Weekly (Audio),29,18,13,17,92,169
199024793,Live Wire with Luke Burbank,3,3,2,2,31,41
200323953,The Meditation Podcast,8,3,2,4,33,50
201376301,Savage Lovecast,13,3,2,5,27,50
201598403,Coffee Break Spanish,2,3,2,1,42,50
201661540,NASACast Audio,0,2,0,1,8,11
201671138,This American Life,300,96,108,66,1272,1842
201680433,SpyCast,17,8,4,9,12,50
201853034,Marketplace,114,66,36,38,482,736
202883543,Player One Podcast,16,5,9,14,215,259
203252838,Gardens Illustrated Magazine,0,1,0,0,1,2
203844864,Skeptoid,42,15,18,16,409,500
204558483,NOS Met het Oog op Morgen,0,0,0,0,5,5
204570355,Meditation Oasis,2,1,4,1,42,50
204724562,Mooney Goes Wild,0,0,0,0,1,1
205578441,Deeper Shades of House - weekly Deep House Podcast with Lars Behrenroth,1,0,2,4,42,49
205892240,Test Match Special,4,6,8,16,64,98
205946918,ESPN On Ice with Wyshynski and Kaplan,23,18,15,19,120,195
206197047,Messianic Jewish Teachings: David Levine,30,2,2,1,45,80
206222584,My Thought Coach,0,2,3,0,45,50
206389261,THE OPINION ZONE : A Sonic The Hedgehog Podcast,6,5,1,1,37,50
206603090,Business English Pod :: Learn Business English Online,1,0,0,4,19,24
206783908,The Thomas Jefferson Hour,7,3,2,3,35,50
207118381,New England Journal of Medicine Interviews,0,0,0,1,3,4
207505466,Radio Diaries,2,4,4,9,99,118
207526159,Mason & Ireland,11,7,4,9,46,77
207724573,The Clark Howard Podcast,7,3,7,9,174,200
207936024,Parsha Podcast with Ari Goldwag,0,0,0,0,24,24
207994337,Reduced Shakespeare Company Podcast,0,0,1,1,44,46
208011837,RNZ: Morning Report,1,2,0,0,3,6
208070383,Start Cooking,1,0,1,10,106,118
208317025,Made in Germany: Das Wirtschaftsmagazin,0,0,0,0,1,1
208318433,The National Archives Podcast Series,0,1,0,1,4,6
208643372,The Michael Kay Show,27,8,8,12,123,178
208990540,Airspeed,0,1,2,1,27,31
209135475,Music to my Ears,0,0,0,0,1,1
209377688,Mark Levin Podcast,98,22,10,22,542,694
209659095,MarriageToday with Jimmy & Karen Evans,1,0,0,0,53,54
209859739,Money Girl's Quick and Dirty Tips for a Richer Life,4,6,8,7,175,200
209991975,Fox News Radio Newscast,32,5,4,3,6,50
210064273,Books and Ideas with Dr. Ginger Campbell,0,0,0,1,18,19
210065679,"Brain Science with Ginger Campbell, MD: Neuroscience for Everyone",1,1,0,7,182,191
210206924,One Thing In A French Day,0,0,0,1,49,50
210951638,Power Yoga with Dave Farmar,3,9,1,1,36,50
211053321,The Mustache Rangers Podcast: Comedy | Sci-Fi | Improv,0,0,0,1,49,50
211075561,My Daily Phrase Italian,2,3,0,4,41,50
211075596,My Daily Phrase German,5,4,0,5,12,26
211752923,Buddhist Geeks,5,3,4,3,50,65
211872550,Your Move with Andy Stanley Podcast,9,1,0,6,215,231
212174303,FamilyLife Today®,2,0,2,4,66,74
212814743,Carrusel Deportivo,0,1,0,0,2,3
213334232,Hamish & Andy,2,0,2,2,174,180
213508091,Talkin' Cowboys,40,19,11,13,48,131
213810432,The Wigglian Way Pagan Podcast,3,0,0,2,33,38
214017745,Fresh Life Church,5,0,0,1,60,66
214089682,Fresh Air,90,27,39,27,255,438
214330677,Bass Edge's THE EDGE,0,2,1,4,61,68
214663465,KQED Science News,0,0,0,0,1,1
214825230,Math Mutation,0,1,0,0,47,48
214886950,The Truth of the Matter,3,1,2,2,12,20
214936144,Learn Chinese & Culture @ iMandarinPod.com,1,1,0,1,17,20
215154836,This Birding Life,0,0,0,0,7,7
215419879,Inside Yellowstone,1,0,0,1,9,11
215445813,The Mighty Mommy's Quick and Dirty Tips for Practical Parenting,2,3,4,9,32,50
215510110,KSL Greenhouse,0,0,0,1,4,5
215516451,The Psych Files,4,2,1,2,41,50
215517191,The WDW Radio Show - Your Walt Disney World Information Station,8,8,8,12,464,500
215529509,"CNBC's ""Fast Money""",88,22,12,19,59,200
216013968,Creating Wealth Real Estate Investing with Jason Hartman,8,3,0,2,87,100
216015753,Elevation with Steven Furtick,1,0,1,1,32,35
216296032,Radio Drama Revival,1,2,1,4,23,31
216478078,Risky Business,9,2,0,0,31,42
216662405,The Social Work Podcast,0,0,1,0,85,86
216713308,Intelligence Squared U.S. Debates,3,2,4,5,36,50
216793682,The Drabblecast Audio Fiction Podcast,1,0,2,2,45,50
217388029,Bible Study Podcasts,6,5,2,6,95,114
217580108,Doctor Who: Radio Free Skaro,2,4,3,1,52,62
217652795,The Brewing Network Presents | The Session,12,3,2,1,32,50
217999782,The Disciplined Investor,6,4,5,12,73,100
218155493,The Mountain Top For Men (formerly The Chick Whisperer):,1,3,0,2,44,50
218290471,The Dirtbag Diaries,8,8,8,6,260,290
218453800,Conversations with John & Lisa Bevere,0,0,0,1,13,14
218703932,Vanguard Advisor's Alpha Podcast,1,0,2,0,2,5
218916008,World News Tonight with David Muir,19,5,12,4,10,50
219044787,"Expanded Lovemaking: Sex, Love, and Consciousness",1,3,1,1,17,23
219258773,The Brian Kilmeade Show Free Podcast,18,1,1,1,29,50
219558725,Sales Gravy: Jeb Blount,0,2,3,3,92,100
219708992,Case Closed! (old time radio),1,0,0,2,34,37
220075115,Composers Datebook,1,0,0,3,7,11
250500859,StoryCorps,20,19,12,22,358,431
250987403,The Genealogy Gems Podcast with Lisa Louise Cooke     -      Your Family History Show,2,2,2,4,40,50
251471480,Wood Talk | Woodworking,1,1,1,1,46,50
251507798,CLUBLIFE,5,1,6,6,32,50
251668874,US Citizenship Podcast,0,0,1,2,4,7
252064376,Superman on the Radio,4,0,1,1,7,13
252251368,Around the Horn,47,11,13,32,182,285
252578478,Frankenstein by Mary Shelly - The Audio Book,3,5,4,6,8,26
252820844,"Today in iOS  - The Unofficial iPhone, iPad, and Apple Watch Podcast",25,15,13,24,232,309
253167631,Keith and The Girl comedy talk show,4,0,0,1,45,50
253191823,The Best of Car Talk,2,0,0,2,46,50
253191824,Selected Shorts,18,6,11,20,145,200
253212700,Knit Picks' Podcast,2,1,5,5,37,50
253568181,Rochester Zen Center Teisho (Zen Talks),1,2,0,2,10,15
253635069,PC Perspective Podcast,5,3,5,10,56,79
253702215,American Journal of Psychiatry Audio,3,1,3,5,7,19
253984147,The Golf Psychology Podcast,0,0,1,0,4,5
254078311,Football Ramble,8,10,4,2,283,307
254113729,San Francisco Zen Center Dharma Talks,0,3,0,0,6,9
254465298,Philosophy: The Classics,1,1,0,8,19,29
254707344,ICU Rounds,0,0,1,1,48,50
254921943,Classic Poetry Aloud,4,1,2,3,18,28
256177096,Louis French Lessons,6,1,2,4,26,39
256493656,The Relic Radio Show (old time radio),0,0,0,1,28,29
256493679,The Horror! (Old Time Radio),1,0,2,8,189,200
256580326,History Extra podcast,9,9,18,21,84,141
256943801,q: The Podcast from CBC Radio,1,0,0,2,14,17
256945396,The New Yorker: Fiction,12,8,6,22,152,200
257042117,Philosophy Bites,9,3,4,17,84,117
257048136,Druidcast - The Druid Podcast,1,0,0,3,174,178
257441540,Learn Spanish: Notes in Spanish Inspired Beginners,4,2,5,2,37,50
257473028,Pride and Prejudice,2,4,6,15,23,50
257529602,Kabbalah & Physics,1,0,0,0,3,4
258214995,The Classic Tales Podcast,0,1,1,1,47,50
258401691,Guitar Music Theory,0,1,0,0,49,50
258509321,Nature's Voice,0,0,0,0,1,1
258530615,The Bowery Boys: New York City History,2,2,0,0,46,50
258804994,Perry Mason,8,2,2,1,1,14
258864037,Shea Anything,6,3,11,5,41,66
259617791,Now Playing - The Movie Review Podcast,34,24,25,30,387,500
259657960,Woodworking with The Wood Whisperer (HD),0,0,0,0,21,21
259695657,The Cold-Case Christianity Podcast,5,1,2,3,72,83
259744514,20 min. Yoga Sessions from YogaDownload.com,1,3,1,8,37,50
259841761,Redleg Nation Radio: A Cincinnati Reds Podcast,2,3,2,6,76,89
259863713,IQ - Wissenschaft und Forschung,0,0,0,0,1,1
260010384,Naval Air,0,0,0,0,6,6
260317789,Chess Killer Tips Video Podcast with Alexandra Kosteniuk,2,0,0,5,13,20
260335249,BrainStuff,41,44,45,28,83,241
260537420,Fantasy Focus Football,117,46,30,23,283,499
260626837,Judaism's response to Christian Missionaries with Rabbi Tovia Singer,3,0,2,0,19,24
260832564,"Retirement Talk for Boomers, Seniors, and Retirees",0,0,2,1,45,48
260843816,John Eldredge and Wild at Heart (Audio),5,1,0,6,172,184
260979915,Star Trek: Lost Frontier,0,0,0,0,3,3
261058960,iMore show,23,13,13,16,197,262
261059112,Focus on Parenting Podcast,19,0,1,1,29,50
261059123,Focus on Marriage Podcast,4,1,6,7,32,50
261086208,Wormwood: A Serialized Mystery,4,2,2,6,36,50
261109847,Sesho's Anime And Manga Reviews,0,1,0,1,9,11
261185732,Learn Portuguese - BrazilianPodClass,1,1,0,3,32,37
261291929,Football Daily,28,10,15,16,71,140
261350282,The Spurs Show,0,3,1,3,13,20
261548752,Thinking Allowed,1,0,2,3,15,21
261654474,The History of Rome,2,2,2,1,43,50
261735167,Fantasy Football Today,4,4,1,9,482,500
261779765,Great Lives,3,3,0,1,17,24
261786876,Business Daily,7,0,4,4,25,40
262026947,6 Minute English,0,0,0,0,3,3
262026989,The English We Speak,1,0,1,1,9,12
262026995,Science in Action,0,1,1,2,9,13
262033197,RadioWest,3,2,0,5,89,99
262134637,Overeaters Anonymous Virtual Speakers Bureau,0,2,1,0,24,27
262223371,Learn Korean | KoreanClass101.com,4,0,3,2,13,22
262309363,Once Upon a Time in Vegas audio drama,0,0,1,2,9,12
262317288,North Point Community Church,6,0,1,0,86,93
262408151,Spanish Grammar Review,1,0,0,4,14,19
262444919,The Stoop Storytelling Series,1,1,3,3,25,33
262520106,Art History Podcast,0,0,1,0,2,3
262840395,National Gallery of Art | Audio,0,1,0,2,5,8
262921699,The Big Boo Cast,1,1,1,2,45,50
263170419,Coffee Break French,0,0,0,0,4,4
263174305,The WDW News Today Podcast - Standard,31,22,17,12,104,186
263185014,Ray Edwards Show,0,2,0,0,48,50
263417520,Medical Spanish Podcast,0,0,0,2,35,37
263456080,Plus podcast – Maths on the Move,0,1,0,0,2,3
263570678,Money Box,6,1,4,8,32,51
264306390,RPG Cast,5,0,3,8,27,43
264318446,Learn to Speak Spanish with Discover Spanish,3,2,1,2,42,50
264537349,Sesame Street Podcast,5,2,3,7,33,50
264938549,The Metamor City Podcast,1,1,2,1,45,50
265029591,Abnormal Psychology Lectures,4,0,0,2,6,12
265133111,Ancient Dragon Zen Gate Dharma Talks,0,1,0,0,2,3
265264862,Tara Brach,4,2,6,8,305,325
265307784,Friday Night Comedy from BBC Radio 4,294,78,80,64,286,802
265799883,The Bugle,6,2,1,2,127,138
265970428,The Archers,10,4,3,8,25,50
266288159,Neurology® Podcast,2,0,0,1,32,35
266386337,Creating a Family: Talk about Adoption & Foster Care,3,2,1,5,39,50
266391367,Gadget Lab: Weekly Tech News,2,6,1,4,22,35
266791433,Yarnspinners Tales's Podcast,0,1,0,2,19,22
267142101,Unbelievable?,2,0,5,9,127,143
267200514,The Strength Coach Podcast,1,2,4,2,41,50
267257453,Buddhist Temple of Toledo Podcast,0,0,0,0,13,13
267300806,Analysis,3,0,0,1,13,17
267300884,More or Less: Behind the Stats,8,5,2,3,75,93
267350404,Final Fantasy & Kingdom Hearts Union,1,4,1,2,42,50
267928081,Orson Welles On The Air,1,0,0,0,10,11
267972899,Live In Concert from NPR's All Songs Considered,3,3,9,8,109,132
268003768,The People's Pharmacy,2,2,0,2,44,50
268178375,Logical Weight Loss,4,3,4,5,34,50
268213039,The New Yorker: Politics and More,21,7,14,15,78,135
268252729,U.S. Presidents Podcast,6,0,2,4,3,15
268332091,Deutsch - warum nicht? Serie 1 | Deutsch lernen | Deutsche Welle,0,0,0,1,1,2
268481668,Deutsch - warum nicht? Series 2 | Learning German | Deutsche Welle,0,0,0,1,4,5
268557178,Modern Mentor,13,11,9,15,137,185
268565125,Classics For Kids,2,0,1,4,41,48
268577000,Wieso nicht? | Learning German | Deutsche Welle,0,0,0,0,2,2
268613141,Max Lucado,0,0,0,1,29,30
268800565,Eye On College Basketball,23,10,8,6,453,500
268822504,Recovered Podcast,1,0,1,1,47,50
268977062,Student Pilot Journal Aviation Podcast,1,0,0,0,11,12
269018823,Ramblings,0,0,0,0,16,16
269169796,No Agenda,9,5,3,0,33,50
269661947,Endurance Nation Podcast,0,1,0,0,15,16
269795738,All TWiT.tv Shows (Audio),3,2,2,2,25,34
270037732,The Solid Verbal - College Football Podcast,25,8,11,15,441,500
270053936,Poem Talk,3,0,0,1,10,14
270053937,Avant-Garde All the Time,1,0,0,1,5,7
270054093,The Poetry Magazine Podcast,0,0,2,1,12,15
270054094,Audio Poem of the Day,0,1,2,6,18,27
270128470,TGC Podcast,3,1,1,2,37,44
270338166,Pure Trance Radio Podcast with Solarstone,3,0,5,4,38,50
270352658,The Story Home Children's Audio Stories,18,3,2,2,25,50
270419729,The New Man,0,0,3,1,46,50
270572701,Learn Spanish | SpanishPod101.com,3,2,1,6,24,36
271154661,The Bigfoot Show,4,1,2,8,66,81
271202930,The Old Time Radio Superman Show,0,3,3,2,27,35
271206562,Living on the Edge with Chip Ingram Daily Podcast,2,0,2,1,112,117
271269211,One Minute German,0,0,3,3,6,12
271782069,MMA Junkie Radio,13,6,21,32,377,449
271866252,Talkin Mets with Mike Silva,18,4,5,1,41,69
272230438,Rick Steves Italy Audio Tours,0,0,0,2,17,19
272512829,Leadership and Loyalty™,0,0,0,0,6,6
272812937,www.MANMINDSET.com DATING SHOW FOR MEN,1,0,1,0,6,8
272824755,Useless Information Podcast,1,2,6,2,39,50
272848127,Celtic Myth Podshow,0,0,2,1,49,52
272960227,Fantasy Baseball from Prospect361.com,15,10,9,9,194,237
273130612,City Journal's 10 Blocks,5,1,2,0,42,50
273148505,Comic Book Club,3,5,3,2,45,58
273149718,Fantasy Baseball Today,23,5,10,12,350,400
273450951,Learn Italian | ItalianPod101.com,9,4,4,3,30,50
273594953,Hermetic Astrology Podcast,1,1,3,2,56,63
273772632,KunstlerCast - Suburban Sprawl: A Tragic Comedy,8,4,2,7,77,98
273916368,Hadar Institute Online Learning,0,1,0,0,3,4
274089424,Major Spoilers Comic Book Podcast,5,3,4,7,81,100
274232502,Peristyle Podcast - USC Trojan Football Discussion,5,2,5,6,219,237
274450056,Giant Bombcast,44,30,23,20,383,500
274583068,Ancient Warfare Podcast,3,4,2,10,31,50
274994551,The Truth About Money with Ric Edelman,18,10,5,8,33,74
275218346,Fantasy Focus Baseball,142,57,41,38,222,500
275458204,Gardenerd Tip of the Week,1,2,2,2,15,22
275472625,Tu Ingles! podcast,0,0,1,3,46,50
275625131,The Reflex Blue Show : A Graphic Design Podcast,0,1,2,1,6,10
275699983,The Moth,57,9,9,18,318,411
275834665,Apple Events (video),80,19,27,25,349,500
275924761,"Mantra, Kirtan and Stotra: Sanskrit Chants",1,1,0,0,8,10
275948755,Learn German | GermanPod101.com,6,4,4,11,16,41
276266378,PodCastle,3,2,2,6,37,50
276268070,Podcast Beyond - IGN's PlayStation Show,17,9,4,4,16,50
276268226,Game Scoop!,2,1,2,3,42,50
276268454,Podcast Unlocked,17,5,6,7,15,50
276268457,Nintendo Voice Chat,6,6,5,5,28,50
276584069,Be Our Guest WDW Podcast,8,12,13,13,454,500
276896060,the DharmaRealm,0,0,0,0,5,5
277522775,Relic Radio Thrillers (Old Time Radio),0,1,0,0,25,26
277975394,Bloomberg Law,28,7,14,4,15,68
278088281,Learn French | FrenchPod101.com,3,3,4,1,11,22
278093331,The Student Pilot Cast (mp3),0,0,0,0,4,4
278128007,Investing Insights,3,2,4,4,9,22
278131039,"Essential Tennis Podcast - Instruction, Lessons, Tips",0,1,0,4,191,196
278170377,Tokyo Midtown presents The Lifestyle MUSEUM,0,0,0,0,1,1
278196007,The World: Latest Edition,6,3,4,2,35,50
278579370,Knitmoregirls's Podcast,5,1,7,7,80,100
278930814,The Orvis Fly-Fishing Podcast,3,0,1,10,280,294
278968170,Radio Astronomy,0,0,0,0,1,1
278974813,Pop Culture Happy Hour,65,43,23,35,334,500
278981407,Stuff You Should Know,343,84,98,70,1421,2016
279188498,Slate Culture,28,23,12,9,128,200
279428154,LSE: Public lectures and events,0,0,0,1,1,2
279620985,The Dana Show with Dana Loesch,2,0,1,2,45,50
279743630,Social Psychology Lectures,2,0,0,0,2,4
279743708,The Language of Tarot - A Tarot Podcast,0,0,1,4,22,27
279999557,Culips Everyday English Podcast,0,0,0,1,49,50
280208841,Learn Arabic | ArabicPod101.com,3,2,2,0,7,14
280383574,The Look & Sound of Leadership,0,1,1,2,196,200
280564708,Valley Baptist Bakersfield Sermons Podcast,0,0,0,0,2,2
280789489,InvestTalk,28,22,23,22,100,195
281113993,Daily Kabbalah Lesson with Ari Goldwag,0,0,0,0,6,6
281128135,"Arseblog - the Arsecasts, Arsenal podcasts",3,2,5,0,490,500
281261324,BackStory,5,9,3,5,28,50
281400220,The /Filmcast (AKA The Slashfilmcast),60,29,21,24,366,500
281629288,Media Monarchy,1,0,1,0,12,14
282068968,Daily Daf Yomi with Ari Goldwag,0,0,0,0,4,4
282229761,Hoy por Hoy,4,0,1,1,0,6
282795787,TechStuff,46,43,17,32,288,426
282825594,Airplane Geeks Podcast,3,3,1,2,41,50
282930329,Langsam gesprochene Nachrichten | Deutsch lernen | Deutsche Welle,0,1,1,1,32,35
282932005,Top-Thema mit Vokabeln | Deutsch lernen | Deutsche Welle,0,0,0,0,3,3
282933246,Deutsche im Alltag - Alltagsdeutsch | Deutsch Lernen | Deutsche Welle,0,0,0,0,6,6
283038015,Reading Marx's Capital,0,0,0,1,3,4
283062441,Today's Walk Radio Podcast,0,0,0,0,4,4
283537064,Reading Marx's Capital (audio),0,0,0,0,7,7
283593221,Chop Bard,0,0,1,0,52,53
283605519,Stuff You Missed in History Class,134,76,58,64,386,718
283627069,Relic Radio Sci-Fi (old time radio),1,0,0,1,36,38
283657561,Snap Judgment,18,6,12,14,150,200
283908977,Ben Greenfield Fitness,10,2,2,0,36,50
284148583,The Survival Podcast,19,7,8,9,190,233
284198852,Dudes On Hockey,1,0,0,6,58,65
284220611,"Issues, Etc.",4,1,5,0,176,186
284227873,Market Wrap with Moe,7,1,2,2,16,28
284445819,RunRunLive 4.0 - Running Podcast,2,2,0,1,63,68
284580802,Learn Russian | RussianPod101.com,0,0,2,3,17,22
284922000,icqpodcast's Amateur / Ham Radio Podcast,0,0,0,1,3,4
285097604,Toolroom Radio,0,0,1,1,27,29
285147281,BLACK NIGHT MEDITATIONS - Underground Metal Radio,1,0,0,1,2,4
285582454,TMRO:Space,0,0,0,1,8,9
286098451,Never Not Knitting,2,2,2,10,50,66
286123041,"Dom, Meg & Randell Catchup Podcast - The Edge",8,2,2,4,62,78
286198045,inSocialWork - The Podcast Series of the University at Buffalo School of Social Work,0,0,0,0,2,2
286362280,the 12-Step Buddhist Podcast,0,0,2,1,9,12
286632221,THE RAGGED EDGE RADIO ....with Russ Dizdar,2,1,0,0,29,32
286889904,Above & Beyond: Group Therapy,8,1,13,13,465,500
287031335,Money Clinic with Claer Barrett,0,0,1,1,3,5
287114592,Ask the Naked Scientists,0,1,0,0,10,11
287477468,#321,0,1,2,0,13,16
288022392,Mousetalgia! - Your Disneyland Podcast,5,8,4,9,307,333
288159649,Love Worth Finding on Oneplace.com,0,2,3,3,141,149
288175736,Sarah and Vinnie Full Show,5,2,3,6,34,50
288415651,Matinee Movies,1,0,1,0,1,3
288416113,Science Fiction Theater,1,0,0,1,4,6
288417479,Mystery Theatre,2,1,1,1,18,23
288425495,NEI Podcast,0,0,1,2,2,5
288472896,Clarkesworld Magazine - Science Fiction & Fantasy,5,4,4,7,30,50
288508989,The Public Speaker's Quick and Dirty Tips for Improving Your Communication Skills,4,7,4,14,121,150
288814084,Dinosaurs: Before They Were Fuels (mp3),0,0,0,0,1,1
288838352,The Brewing Network Presents |  Brew Strong,2,4,1,1,19,27
288898242,MotorWeek,3,2,4,2,17,28
289189131,French Verb Drills (French Today),0,0,0,0,3,3
289265912,Freight Train Boogie Podcasts,0,0,0,0,14,14
289338154,The Nutrition Diva's Quick and Dirty Tips for Eating Well and Feeling Fabulous,5,6,8,6,25,50
289339403,Nicolas Canteloup - La revue de presque sur Europe 1,0,0,0,3,11,14
289419806,Meet the Microbiologist,0,0,0,2,3,5
290055666,Andy Stanley Leadership Podcast,5,1,4,6,119,135
290139091,La Ventana,3,0,0,0,3,6
290143444,Meditation Peace - Guided Meditations audio podcast,0,0,0,2,11,13
290152576,Laurent Gerra,2,0,0,1,10,13
290159292,Old Time Radio Mystery Theater,0,0,0,3,32,35
290170401,Biology 2110-2120: Anatomy and Physiology with Doc C,7,6,1,2,28,44
290580703,The Reality Check,6,6,3,4,64,83
290618642,AOPA Never Again,0,0,2,1,15,18
290779540,Biology 3020 -- Pathophysiology with Doc C,1,0,0,1,22,24
290783428,Planet Money,69,18,12,21,324,444
290803395,Focus on the Family Broadcast,5,2,0,1,42,50
291493280,Japanese Classical Literature Audiobooks,0,1,0,0,7,8
291683417,Torah Talk,0,0,0,0,5,5
291832580,Original Science Fiction – Makeshift Stories,0,0,1,1,10,12
291975625,Poetry Lectures,1,0,0,0,2,3
291975627,Essential American Poets,1,0,0,2,3,6
292018914,NEJM Journal Watch Podcasts: Clinical Conversations,0,1,0,0,4,5
292130379,All CNET Video Podcasts (video),3,0,5,2,17,27
292186110,Show Time Spanish,1,1,0,2,37,41
292546170,THEMIXLAB,0,0,0,1,3,4
292681379,Grace to You: Radio Podcast,1,0,0,0,77,78
293048667,The Gospel Truth,2,0,0,1,60,63
293184847,Surgery 101,1,0,0,5,9,15
293257920,Bowery Boys Archive: The Early Years,2,1,0,2,57,62
293376147,Brian Windhorst & The Hoop Collective,156,65,58,33,188,500
293560442,Calvary Chapel Kaneohe,0,1,0,0,9,10
293597632,Two Chairs No Waiting Andy Griffith Show Fan Podcast,0,0,0,1,34,35
293743265,Big Mad Morning Show,4,1,0,2,43,50
294055448,MSNBC Rachel Maddow (video),7,2,4,5,32,50
294055449,The Rachel Maddow Show,84,3,15,18,177,297
294182889,"""The Scarlet Letter"" Audiobook (Audio book)",5,0,2,8,21,36
294540619,The Art of Photography,4,1,1,7,87,100
294809296,Marketplace All-in-One,7,5,4,9,54,79
294932425,The Insightful Leader,0,0,1,0,4,5
295647558,Grace to You: Pulpit Podcast,6,0,2,0,41,49
295908830,"The 365 Days of Astronomy, the daily podcast of the International Year of Astronomy 2009",0,0,2,7,33,42
295946198,The Classic Metal Show,17,1,2,1,29,50
295980567,Dermcast.tv Dermatology Podcasts,0,0,0,0,15,15
296189771,Tritonia,2,3,4,6,44,59
296237493,Bloomberg Surveillance,56,16,13,4,66,155
296244441,The Child Whisperer Podcast with Carol Tuttle & Anne Brown,1,1,0,0,25,27
296714733,World Cricket Show,0,0,1,2,27,30
296762605,Climate One,1,0,0,1,27,29
297680411,CarStuff,7,7,2,3,31,50
298442629,"Question of the Week, from the Naked Scientists",0,0,0,0,1,1
298729068,Waffle On Podcast,0,0,0,1,13,14
299197832,AES Journal Podcast,0,0,1,0,2,3
299436963,the memory palace,0,2,1,4,43,50
299826841,Career Tools,3,3,7,4,54,71
299877804,Music and the Brain,0,0,0,3,1,4
300765836,Dharma Seed - dharmaseed.org: dharma talks and meditation instruction,0,0,1,3,11,15
301352142,"Walk, Talk and Learn French",0,0,0,1,33,34
301405577,Starship Excelsior: A Star Trek Fan Audio Drama,0,0,0,3,18,21
301444064,Tennis Psychology Podcast,1,0,0,1,3,5
301670981,The Bitcoin Knowledge Podcast,0,0,0,0,8,8
301683725,Anything Ghost Show,5,5,11,20,328,369
301774100,Rebel FM,2,3,0,1,44,50
301924660,The Naturist Living Show,1,0,0,0,37,38
302005364,LogoTalk Radio,0,0,0,0,2,2
302187586,Law of Attraction Talk Radio,8,2,2,0,19,31
302364123,People and Projects Podcast: Project Management Podcast,0,0,0,0,31,31
302754403,cocktailnation,0,0,0,0,16,16
303127788,"CNBC's ""Options Action""",11,3,5,1,18,38
303504204,Peach And Black - A Podcast About Prince,0,0,3,5,19,27
303672420,SEO Podcast The Unknown Secrets of Internet Marketing,9,5,2,0,34,50
304114245,UN News,0,0,1,1,6,8
304431374,The Chad Benson Show,0,0,0,0,16,16
304434112,First Draft,19,13,18,15,95,160
304481704,The Leviathan Chronicles,4,3,4,4,35,50
304534298,Switch Hit Podcast,1,0,0,2,3,6
304855471,Science for the People,1,2,1,3,30,37
304863991,SANS Internet Stormcenter Daily Network/Cyber Security and Information Security Stormcast,0,1,0,1,48,50
305561100,DH Unplugged,5,5,2,7,29,48
305590390,Spanish Podcast,5,2,4,0,39,50
305910224,Serving Worlds,0,0,1,2,19,22
305930522,Reading And Writing Podcast,0,1,0,4,32,37
306106212,Motley Fool Money,10,6,6,22,146,190
306300922,Noticias ONU,0,0,0,1,0,1
306347401,The Whole Child Podcast: Changing the Conversation About Education,0,1,0,0,1,2
306390087,Adam Carolla Show,60,30,30,22,154,296
306454334,Tri Swim Coach Triathlon Swimming Podcast,0,0,0,12,50,62
306597476,The World Next Week,7,3,5,6,61,82
306719560,Sound Retirement Radio,3,2,3,3,36,47
307002396,"Voice Over Training | Complete Training, Demo Development & Support",0,0,0,2,2,4
307176617,Three Moves Ahead,4,1,2,8,78,93
307266753,Seattle Insight Meditation Society,0,0,0,0,4,4
307368679,How She Really Does It,0,1,0,0,49,50
307483087,Superscoreboard,30,9,12,10,32,93
307580286,Perfecto Podcast: featuring Paul Oakenfold,2,5,2,7,52,68
307703283,Sustainable World Radio- Ecology and Permaculture Podcast,1,0,0,2,41,44
307906331,Erotic Awakening Podcast,4,0,1,4,66,75
307934313,Sounds True: Insights at the Edge,2,3,2,12,139,158
308192284,Pilots Journey Aviation Podcast,0,0,0,1,10,11
308382038,Iron Radio,0,0,0,2,48,50
308614478,A Mediocre Time with Tom and Dan,2,5,1,1,41,50
308800732,The Frank Skinner Show,4,0,4,4,37,49
309303712,Pharmacy Podcast Network,0,0,0,0,38,38
309426367,The Creative Penn Podcast For Writers,1,0,1,1,115,118
309501861,Smart Wrestling Fan,20,14,9,6,139,188
309927499,The Starting Zone: The World of Warcraft Podcast!,4,1,0,0,45,50
310512541,Common Ground Meditation Center: dharma talks and meditation instruction,0,0,0,0,6,6
310656913,Jim Harold's Campfire,13,8,16,11,452,500
311851745,WHY? - Philosophical Discussions About Everyday Life,0,0,0,0,4,4
311852588,The Psychology of Attractiveness Podcast,0,0,1,3,15,19
312014249,The Dog Trainer's Quick and Dirty Tips for Teaching and Caring for Your Pet,0,1,3,0,29,33
312059190,Luke's ENGLISH Podcast - Learn British English with Luke Thompson,0,1,0,0,45,46
312094772,Mormon Stories - LDS,62,10,14,6,408,500
312900254,"Your Money, Your Wealth",1,0,0,1,46,48
313139609,Solomonster Sounds Off,8,5,3,3,405,424
313165399,Anne Ortelee Weekly Weather Astrology,10,0,2,1,37,50
313300476,We're Alive,0,1,2,1,46,50
313540278,Against the Stream,2,1,2,1,35,41
313848583,Editor's Picks from The Economist,0,0,0,1,2,3
314020330,EMCrit Podcast - Critical Care and Resuscitation,0,1,0,1,48,50
314073213,BroadwayRadio,3,4,3,6,69,85
314461026,This Week in Startups - Video,8,3,2,8,65,86
315114957,This Week in Startups - Audio,18,11,9,8,265,311
315592691,IGN.com - Daily Fix (Video),10,0,8,9,82,109
315592694,IGN.com - Game Scoop! TV (Video),5,0,0,1,34,40
316019334,Show Archives – Armed American Radio |,8,1,5,3,33,50
316045799,Comedy Bang Bang: The Podcast,4,2,0,2,42,50
317130752,Learn Chinese | ChineseClass101.com,0,0,0,1,8,9
317164632,Voddie Baucham on SermonAudio,0,0,0,1,16,17
317763837,The MuscleCar Place,0,0,2,0,48,50
317780087,Recovery Radio Network,1,1,1,1,13,17
317809747,The Dressage Radio Show,0,0,0,0,10,10
318185524,Rooster Teeth Podcast,20,9,4,1,16,50
318345767,The Partially Examined Life Philosophy Podcast,7,11,3,12,272,305
318705261,The Reith Lectures,1,0,0,1,3,5
318930292,The Horse Racing Radio Network Podcast,1,1,0,0,7,9
319307387,Helping Writers Become Authors,1,5,3,1,128,138
319637902,Bhagavad Gita Discourses,0,0,0,0,2,2
320642139,MMA Fighting,26,9,11,14,323,383
320705565,The Strenuous Life Podcast with Stephan Kesting,1,1,2,3,74,81
321926788,Horse Tip Daily,0,0,0,0,1,1
323127331,Elucidations,0,0,0,0,33,33
323145903,Learn English | EnglishClass101.com,1,0,1,0,1,3
323200344,Insight Meditation Society - Forest Refuge: dharma talks and meditation instruction,0,0,0,1,1,2
323397049,Cut The Fat Weight Loss Podcast,2,1,0,1,46,50
323506039,Cheap Astronomy Podcasts,0,0,0,2,17,19
323773207,Couch to 5K (C25K) 5K101.com,0,1,0,2,47,50
323983193,CarCast,11,5,7,8,19,50
324173353,BreakPoint,4,1,2,4,74,85
324475434,Sri Rama Lila Ramayana,0,0,0,0,3,3
324601605,The Livin' La Vida Low-Carb Show With Jimmy Moore,9,3,2,3,33,50
324688342,"Naked Scientists, In Short Special Editions Podcast",1,0,0,0,1,2
324698394,Anime Addicts Anonymous,7,2,6,5,415,435
325079170,MonsterTalk,16,13,13,29,319,390
325404506,StarTalk Radio,0,0,0,0,8,8
325418914,The Porch,4,0,3,1,81,89
325945259,Gardeners' Question Time,1,0,1,0,18,20
326093823,Renaissance English History Podcast: A Show About the Tudors,4,1,3,1,41,50
326120877,This Week in Google (Audio),29,22,19,9,91,170
326301337,The Tape,15,7,12,4,24,62
326483650,Rick Steves Travel Talks,2,0,0,0,6,8
326503574,WSCAL - Office Hours,1,0,0,0,11,12
326731407,Rime Buddhist Center Dharma Talks,1,0,0,1,1,3
326782101,Ganesha - Ganesha selections read from The Lilas of the Sons of Shiva’s by Vanamali Mataji.    This ...,0,0,0,0,1,1
327055102,Blue Moon Podcast - A Manchester City Show,0,1,0,2,24,27
327207852,Fitzdog Radio,6,4,2,2,36,50
327466681,"Total Soccer Show: USMNT, Champions League, EPL, and more ...",14,6,15,12,453,500
327725953,Critical Hit: A Major Spoilers RPG Podcast,0,2,2,1,45,50
327751771,No Question About That - a Manchester United podcast,1,0,0,2,113,116
327760868,The Brutal Truth About Sales & Selling - B2B Social SaaStr Cold Calling SaaS Salesman Advanced Hacke...,6,1,4,4,185,200
327760888,This Week in Travel,4,4,4,3,29,44
328074695,Design Matters with Debbie Millman,1,4,2,1,128,136
328076847,Rob Has a Podcast | Survivor / Big Brother / Amazing Race - RHAP,19,13,10,8,449,499
328200975,the Building Performance Podcast,0,0,0,2,18,20
328585600,Escape From Illustration Island,0,0,0,2,27,29
329032812,The Shared Security Show,1,0,0,2,6,9
329632748,Deen Over Dunya,0,1,0,1,7,9
329875043,WTF with Marc Maron Podcast,102,38,62,42,756,1000
329902285,The Marty Sheargold Show  - Triple M Melbourne 105.1,20,4,10,9,32,75
329937558,Mysterious Universe,85,19,23,17,356,500
330322710,The Conspiracy Show with Richard Syrett,33,8,6,5,79,131
330446233,PedsCases: Pediatric Education Online,2,2,0,2,9,15
330585133,Shadow Nation,4,1,0,1,7,13
330665807,Talking Flutes!,0,0,0,0,1,1
330992379,Cruise Radio,2,2,1,3,171,179
331047135,Wildcat Radio: Arizona Football. Arizona Basketball,1,0,0,1,23,25
331191165,MGoBlog: The MGoPodcast,14,1,0,2,71,88
331535493,Quran Talk,9,0,0,0,14,23
331749062,Gardeners' Corner,0,0,0,0,6,6
332157580,Genesis Avalon audio drama,0,2,1,2,6,11
332516054,The Art of Manliness,11,2,4,12,471,500
333016788,Astronomy 141 - Life in the Universe - Autumn Quarter 2009,0,0,0,0,29,29
333093081,The Secular Buddhist,1,1,1,0,12,15
333225899,Science... sort of,8,5,7,14,325,359
333229078,Curry Smugglers - Bollywood | Hindi | Desi | Bhangra | Chill | Indian,0,0,0,2,18,20
333252982,Prophecyzoneradionews,2,0,1,1,1,5
333469871,Outlook,1,0,1,0,26,28
334179090,Criterion Cast: Master Audio Feed,5,1,0,4,50,60
334204277,Joseph Prince Audio Podcast,0,0,0,0,6,6
334633370,K-12 Greatest Hits:The Best Ideas in Education,0,0,2,0,3,5
334648685,The Social-Engineer Podcast,2,4,3,1,17,27
334724074,RISK!,25,10,16,10,139,200
335246945,The Game Informer Show,10,3,8,4,25,50
335549005,The Great Detectives of Old Time Radio,5,3,9,13,170,200
335971413,The Un-Billable Hour,0,0,0,0,3,3
336704577,Podcasts – Weird Things,11,6,7,5,112,141
336817472,Churchome with Judah Smith,4,3,4,3,74,88
336829720,Amaravati Podcast | Latest Dhamma Talks,0,0,0,0,3,3
337004125,IGN UK Podcast,2,0,1,0,46,49
337502156,Old Time Radio Westerns,1,1,0,4,46,52
337713843,Judge John Hodgman,6,2,0,0,42,50
337801413,Living Zen Podcast,1,0,0,1,57,59
337870313,Carry the One Radio: The Science Podcast,0,0,0,0,11,11
337958524,The Marital Intimacy Show,1,0,0,0,6,7
338329527,Audio Dharma: Gil Fronsdal's most recent Dharma talks,1,0,0,0,31,32
338529121,The Archers Omnibus,58,7,14,13,49,141
338540446,Tibetan Buddhist teachings and meditations,0,0,0,0,1,1
338848099,Village Zendo Teacher Talks,0,0,0,0,1,1
338879769,The Architecture Happy Hour,1,0,0,0,9,10
339001481,The Tobolowsky Files,1,1,1,3,494,500
339853848,Dishing Up Nutrition,9,5,3,4,29,50
339875623,TENNIS.com Podcast,3,4,6,4,31,48
339986758,Witness History,6,0,3,4,31,44
340137077,Bayyinah Institute,0,0,0,2,88,90
340221970,"Robb Wolf - The Paleo Solution Podcast - Paleo diet, nutrition, fitness, and health",5,4,1,4,35,49
340512495,This Week in Parasitism,0,1,1,1,116,119
340815181,Mojo For Running Podcast,2,1,0,6,195,204
340903074,RJ Bell's Dream Preview,70,42,47,23,223,405
341410942,Shnayim Mikra,0,0,0,1,4,5
341596834,Introduction to Psychology,2,2,0,5,13,22
341596844,Neuroscience & Behavior,0,1,0,0,2,3
341597455,Introduction to Computer Science and Programming,0,1,1,3,19,24
341623264,The Changelog: Software Dev & Open Source,0,0,0,1,33,34
341650730,"The Civil War and Reconstruction Era, 1845-1877 - Audio",3,0,0,1,46,50
341651987,Ancient Greek History - Audio,7,0,6,5,32,50
341652042,Psychology - Audio,0,0,0,0,14,14
341652575,Psychology - Video,0,1,1,2,21,25
341813080,"Wall Street Unplugged - Your Best Source for Finance, Investing & Economics",22,8,1,7,162,200
342735925,Desert Island Discs,0,0,0,0,18,18
342927791,The Food Programme,0,0,0,1,11,12
343172752,The Chris Voss Show,0,0,1,0,15,16
343580439,The Infinite Monkey Cage,46,16,28,40,458,588
344105585,Cooking with Paula McIntyre,0,0,0,0,2,2
344499708,Shannon Cason's Homemade Stories,1,1,1,7,190,200
344869087,"Kate, Tim and Joel",17,3,5,11,137,173
344979790,"Kid Friday - apps, websites, gadgets, games, fun!",2,0,2,2,44,50
346459024,Aro Buddhism Podcasts,0,0,0,0,4,4
346479906,Zenbitchslap Talks,1,0,0,2,7,10
346735400,PUCL: A Pokemon Podcast,3,1,1,1,44,50
347832278,Aeon Byte Gnostic Radio,4,3,3,3,39,52
347854569,Sadhguru,3,0,2,0,41,46
347854569,Sadhguru's Podcast,3,0,2,0,41,46
347874892,Best Stocks Now with Bill Gunderson,7,1,1,0,16,25
348096293,Anxiety Slayer™ with Shann and Ananga,5,0,1,3,41,50
348466252,This Week in Computer Hardware (Audio),8,2,7,3,29,49
348650936,TWiT News (Audio),0,0,0,0,10,10
348655557,Geek News Central Podcast (Video),0,1,0,0,4,5
348852826,"Naked Astronomy, from the Naked Scientists",0,0,0,0,11,11
349091786,The Square Ball: Leeds United Podcast,0,1,1,0,8,10
349470184,The Steve Matthes Show on RacerX,0,1,0,0,60,61
349527672,Spilled Milk,12,13,7,13,155,200
349529445,The PulpMX.com Show,9,1,3,2,117,132
349625395,New World Witchery - The Search for American Traditional Witchcraft,0,1,1,5,99,106
349669609,ONE Extraordinary Marriage Show,2,0,7,2,39,50
349803049,Korean Podcast for Beginners,0,0,0,0,1,1
350035346,Marathon Talk,0,1,0,0,42,43
350035466,Mangala Shri Bhuti - The Link,0,0,0,0,2,2
350070282,Strange Tales (Old Time Radio),0,0,0,4,43,47
350359306,Stuff To Blow Your Mind,37,30,31,32,370,500
350580455,Duncan Trussell Family Hour,4,1,2,5,38,50
350709629,The Sporkful,19,7,9,14,151,200
350801853,Know Direction Network,1,1,0,3,14,19
351065142,Talk To Me In Korean,0,0,2,0,46,48
351096296,A History of the World in 100 Objects,2,1,1,3,43,50
351948564,A Taste of the Past,7,10,4,3,21,45
351953012,Rationally Speaking Podcast,5,2,3,4,68,82
351975870,Paul van Dyk's VONYC Sessions Podcast,2,3,0,4,53,62
352470437,BacterioFiles,1,0,0,2,4,7
352660924,Timothy Keller Sermons Podcast by Gospel in Life,0,0,1,0,16,17
352772018,Messianic Messages with Izzy (Audio),1,0,0,0,7,8
352962705,The Gary Null Show,2,1,1,2,41,47
354082588,For Crying Out Loud,18,6,5,1,20,50
354153569,Hockey Central,35,13,14,13,51,126
354627460,Life on the Swingset - The Swinging & Polyamory Podcast,1,3,1,1,44,50
354668519,Freakonomics Radio,266,98,98,126,1155,1743
354697208,Rick Steves Britain & Ireland Audio Tours,0,0,0,0,3,3
354850879,Mahabharata Podcast,0,0,1,2,77,80
355187485,ID10T with Chris Hardwick,10,1,6,1,32,50
355330932,Today's Homeowner Podcast,0,0,1,0,10,11
355421944,The Math Dude Quick and Dirty Tips to Make Math Easier,1,0,3,4,42,50
355813248,The Hackers Paradise,3,0,0,2,48,53
356157099,Newshour,14,2,4,2,31,53
356200509,FanGraphs Baseball,18,4,8,17,91,138
356704771,Project Camelot,3,1,1,0,3,8
356920632,White Horse Inn,6,1,2,11,121,141
356994764,Hangar49,0,0,0,1,6,7
357001831,Three Guys On,0,0,0,1,49,50
357520844,NPR's Mountain Stage,2,0,0,1,32,35
357537542,Tell Em Steve-Dave,1,0,1,0,48,50
357581998,Lawdibles Audio – Lawdibles,0,1,2,0,0,3
358195817,RTL Matin,5,0,0,1,0,6
358555806,Government Accountability Office (GAO) Podcast: Watchdog Report,1,0,0,1,10,12
358731231,Home Studio Corner Podcast,0,0,0,1,49,50
359208879,Marathon Training Academy,0,1,0,1,48,50
359588988,Monstercat Silk Showcase,0,0,0,1,13,14
360084272,The Joe Rogan Experience,560,66,104,98,1172,2000
360234201,The FrogPants Studios Ultra Feed!,5,0,0,0,84,89
360804281,The Rush Hour Melbourne Catch Up - 105.1 Triple M Melbourne - James Brayshaw and Billy Brownless,8,2,3,5,61,79
360861303,The Bible Geek Show,1,2,2,5,58,68
360889910,This is Only a Test,8,17,11,13,127,176
361294213,This Week in League NRL Podcast,0,0,0,0,7,7
361910564,psychicteachers,4,3,0,1,42,50
362115318,Tiny Desk Concerts - Video,2,2,3,5,38,50
362354211,Beer Sessions Radio (TM),0,0,0,1,5,6
363143310,The Takeaway,7,6,5,2,27,47
363368392,Irish History Podcast,0,0,1,1,48,50
363783680,NBA Hang Time,9,0,8,5,36,58
363785533,MLF Bass Fishing Podcast,3,2,0,1,6,12
364682371,The Potter's Touch on Lightsource.com,0,0,0,0,9,9
365374471,Yosemite Trip Planning,1,0,0,0,1,2
365643318,"Veterinary Advice, Animal News & Views with hosts, Dr. Roger Welton & Dr. Karen Louis",0,1,0,1,7,9
365770501,Expanding Mind,0,0,3,5,45,53
366130254,Aaron's World,0,0,1,0,32,33
366349073,"Homilies by Fr. Richard Rohr, OFM",1,2,1,2,49,55
367330921,"My Brother, My Brother And Me",22,4,17,12,444,499
367825854,The Sports Junkies,33,9,10,16,119,187
367950158,Podcast Kid,3,1,1,4,33,42
368045786,Jason & Alexis,1,1,0,0,24,26
368045794,Lori & Julia,3,0,1,2,11,17
368166171,iRunFar,0,0,0,1,2,3
368421863,The Independent Characters - A Warhammer 40k Podcast | Radio,1,3,0,0,46,50
368426151,Taking Control: The ADHD Podcast,1,2,2,0,45,50
368930767,Sacredlearning All Podcast,0,0,0,0,12,12
369032477,The Strong Towns Podcast,0,1,1,2,37,41
369607516,Hypnosis With Joseph Clough,0,0,1,0,49,50
369757090,The H.P. Lovecraft Literary Podcast,0,2,3,4,191,200
369826173,Bass Fishing Tactics Videos [BassFishin.Com],0,0,0,2,4,6
369948549,Zencare Podcast,0,0,1,0,4,5
370576370,Military Mom Talk Radio,0,0,0,0,6,6
370995272,Russian Rulers History Podcast,2,3,2,2,41,50
371045355,"Robert Kelly's ""You Know What Dude!""",8,3,5,5,29,50
371481351,Family Talk on Oneplace.com,1,0,1,0,50,52
371750376,Get-Fit Guy's Quick and Dirty Tips to Get Moving and Shape Up,4,7,1,7,31,50
372257397,Revolution Health Radio,3,1,3,4,39,50
372536736,The Off-Kilter Quilt,0,0,0,0,50,50
373596600,The Digital Marketing Podcast,0,1,0,0,20,21
373955557,Your Money Minute,3,5,1,3,12,24
374202913,Krishna's Mercy,0,0,0,0,2,2
374798846,From The Rookery End - A show about Watford FC,0,0,0,0,7,7
375253882,Model Railroad Hobbyist,1,2,3,2,4,12
375385132,Tech News Weekly (Audio),122,29,28,35,222,436
375802058,LIGHTSPEED MAGAZINE - Science Fiction and Fantasy Story Podcast (Sci-Fi | Audiobook | Short Stories),2,0,5,5,38,50
376386901,Podcast from Italy: Ashley & Jason Bartner,0,0,0,2,52,54
376646782,Transformation Church - Audio Podcast,0,0,0,0,10,10
376674442,Positively Dog Training - The Official Victoria Stilwell Podcast,9,3,1,2,6,21
376934417,Inside The Mind of Teens and Tweens,2,0,1,0,1,4
377008759,ABA Journal Podcasts - Legal Talk Network,0,0,0,2,1,3
377668980,Did This Happen?,0,0,1,0,4,5
377763645,Frank Delaney's Re: Joyce,0,0,0,0,37,37
377785090,Fareed Zakaria GPS,25,13,17,15,138,208
379077036,"ExtraTime, the Official Podcast of Major League Soccer (MLS)",18,12,24,23,197,274
379453196,Alison Rosen Is Your New Best Friend,5,1,0,3,41,50
379613801,FT News in Focus,2,2,1,0,3,8
379897399,Astral Projection Podcast,0,1,0,0,10,11
380038677,The Beekeeper's Corner Beekeeping Podcast,4,0,2,0,44,50
380095926,The Wired Homeschool,0,0,0,0,15,15
380231309,"Space, Time and Consciousness - for iPod/iPhone",0,0,0,0,6,6
380278390,Deep Sunset House and Progressive Podcast - The Melodic Sessions by Prototype 202,0,0,0,1,42,43
380317598,Cooking Issues,3,1,0,3,27,34
380452617,Anthropology,1,0,0,0,0,1
380627890,The Morning Rumble Catchup Podcast,1,0,0,0,10,11
380864498,Knitting Pipeline,0,0,0,0,50,50
380971273,BlogAid WordPress Tips Tuesday,1,0,0,0,20,21
380996798,The Bob Cesca Show,16,4,6,5,285,316
381009138,Learn Greek | GreekPod101.com,1,0,0,0,1,2
381009175,Learn Portuguese | PortuguesePod101.com,3,0,0,1,5,9
381153201,Classical Podcasts,1,2,1,1,4,9
381697894,Perry Nickelston: Stop Chasing Pain,0,0,1,2,18,21
381700973,History of Art,4,1,0,1,0,6
381701267,Nietzsche on Mind and Nature,0,0,0,0,1,1
381701367,General Philosophy,0,0,1,2,3,6
381702006,Quantum Mechanics,2,0,0,1,7,10
381704095,Philosophy for Beginners,0,0,3,0,11,14
381972795,iOS Today (Audio),16,11,10,16,54,107
382068940,Intro to Buddhism,1,1,0,0,1,3
382356132,The Dave Hill Goodtime Hour (Formerly known as Dave Hill's Podcasting Incident and The Goddamn Dave ...,4,2,1,0,43,50
382998388,The Walking Dead ‘Cast,46,13,14,23,404,500
383084001,The Smart Passive Income Online Business and Blogging Podcast,7,3,2,2,186,200
383137121,Tafseer Quran - Shaarawy,1,1,0,1,17,20
383323406,Our Daily Bread Podcast | Our Daily Bread,1,2,3,2,42,50
383631335,LetsRun.com's Track Talk,6,2,1,0,37,46
383711194,Behind the Bets with Doug Kezirian,6,2,4,16,102,130
383998810,It's Rainmaking Time!®,0,0,0,1,12,13
384233048,Machine Learning,0,0,0,1,7,8
384366241,Spider-Man Crawlspace Podcast,5,4,3,2,36,50
384453923,In the Loop,1,0,1,1,30,33
384519677,Crime and Punishment,0,1,0,1,7,9
384520085,Dracula,0,0,2,0,8,10
384522641,It's Super Effective: A Pokemon Podcast,1,1,5,1,42,50
384826044,The Hermetic Hour,1,3,4,1,27,36
385051731,Limited Resources,1,0,0,2,47,50
385304252,Yokoji Zen Dharma Talks,0,1,0,0,10,11
385427377,The Science of Everything Podcast,1,0,2,5,105,113
385668065,The Save or Die Podcast!,4,1,3,2,40,50
385987142,Green Tech Today (Audio),0,0,0,0,2,2
385998721,Heart and Hand - The Rangers Podcast,0,0,1,1,8,10
386001601,Boomer & Gio,15,1,8,7,45,76
386002649,Carton & Roberts,23,3,9,5,63,103
386058485,Green Tech Today (Video),1,1,0,0,6,8
386170702,NEJM This Week — Audio Summaries,1,5,3,0,15,24
386362948,"The Sodshow, Garden Podcast - Sod Show",0,0,0,0,6,6
386530277,Story Worthy,1,2,1,4,42,50
386547290,The Amp Hour Electronics Podcast,0,0,1,0,34,35
386705792,Ending The Sexual Dark Age,0,2,0,0,48,50
386786633,The Tolkien Professor,0,1,1,3,10,15
387042247,C-SPAN Radio - Washington Today,2,1,3,3,17,26
387232684,Psychology,1,0,1,1,4,7
387385712,Resident by Hernan Cattaneo,0,0,2,4,31,37
387550196,Locked-Up: Prison in America,0,0,0,0,2,2
387601688,WallBuilders Live! with David Barton & Rick Green,6,2,2,1,87,98
387875756,Critical Reasoning for Beginners,1,4,2,3,9,19
387946678,Black Agenda Radio,3,1,0,1,24,29
388692010,Sonic Daydream,0,0,0,0,1,1
389016231,Portland Center for Spiritual Living Podcast,0,0,0,0,3,3
389061788,Daily Halacha Podcast - Daily Halacha By Rabbi Eli J. Mansour,0,0,0,0,9,9
389246402,Rex Factor,0,0,0,3,47,50
389665229,Talking Fussball,1,2,0,1,33,37
389801544,Advanced Clinical Pathophysiology (NUR 6951),0,0,0,1,17,18
390094813,Larry Miller Show,1,0,3,3,43,50
390165181,Les Enjeux internationaux,1,1,0,0,0,2
390165399,Les Chemins de la philosophie,0,0,0,0,1,1
390167105,La Revue de presse internationale,0,0,0,0,1,1
390278738,The Briefing - AlbertMohler.com,17,6,11,12,318,364
390278978,Thinking in Public - AlbertMohler.com,0,1,2,2,27,32
390453558,Locked On Jazz - Daily Podcast On The Utah Jazz,12,6,6,8,468,500
391294609,Toute une vie,0,0,0,1,1,2
391402151,The Chels - The Chelsea Podcast,0,1,1,2,9,13
391404394,Dr. Ross Greene,2,0,3,0,5,10
391428315,Buddhism on Air,0,0,0,0,5,5
391574302,Sex Chat with Dr. Kat and her Gay BF | Sexual Relationships Marriage and Dating Advice,2,0,0,1,17,20
392364162,The Twilight Zone Podcast,0,1,1,4,164,170
393107187,Bloomberg Businessweek,17,6,3,4,9,39
393313455,FIGARINO Geschichten,0,0,0,0,4,4
393525078,True Murder: The Most Shocking Killers,17,8,18,14,43,100
393557569,8-4 Play,13,4,8,8,184,217
393831513,DJcity Podcast,0,0,0,4,41,45
394172161,Edict Zero - FIS,4,1,0,4,80,89
394242270,Notes on the Week Ahead,2,0,2,0,2,6
394384987,NHS Couch to 5K,6,2,2,9,113,132
394432287,PBS NewsHour - Full Show,11,5,9,5,75,105
394447340,The Fretboard Journal Guitar Podcast,0,0,2,0,36,38
394647425,100 Words Or Less: The Podcast,2,3,3,10,116,134
394775318,99% Invisible,132,60,60,54,978,1284
394958297,Insights Now,2,0,1,0,3,6
395114976,Nauka XXI wieku,0,0,0,0,5,5
395503030,"MouseChat.net – Disney, Universal, Orlando FL News & Reviews",40,22,25,17,206,310
395738416,Geek's Guide to the Galaxy - A Science Fiction Podcast,14,9,8,11,158,200
396452781,The Story Collider,3,9,12,11,63,98
396542314,Cyclone Fanatic Podcast Network,3,3,1,1,42,50
396903391,History of Philosophy Without Any Gaps,1,2,1,5,105,114
397533430,The Shaft - A Minecraft Podcast,2,0,2,2,44,50
397757376,Coping with Depression - for iPod/iPhone,1,0,0,0,2,3
398228827,Baking & Pastry,2,1,1,2,8,14
398500515,BeerSmith Home and Beer Brewing Podcast,1,1,4,7,25,38
398635015,The Tournament Poker Edge Podcast,1,0,0,1,43,45
398954920,WordPress Plugins from A to Z,2,1,3,4,40,50
399120782,Bakugan Podcast,1,0,0,1,6,8
399194760,Approaching Shakespeare,1,1,0,1,15,18
399509351,In The Pattern Podcast,0,0,0,0,7,7
399642059,Left Handed Radio | A Sketch Comedy Podcast,1,1,0,2,46,50
399643353,"Developmental Psychology, Fall 2008",0,0,0,0,1,1
399718603,The Permaculture Podcast,0,1,0,2,50,53
400379025,Passion City Church Podcast,1,0,1,0,81,83
400715715,On Iowa Podcast,1,1,3,3,34,42
401030539,Felger & Massarotti,21,5,6,1,39,72
402050558,The David Pakman Show,15,9,7,12,234,277
402306412,The Majority Report with Sam Seder,35,19,19,8,419,500
402427480,"The Copyblogger Podcast: Content Marketing, Copywriting, and Social Media Marketing",2,3,2,7,107,121
403112252,The KiddChris Show,0,0,0,0,10,10
403912558,The Easiest Way to Learn the Tarot--EVER!!,0,0,2,3,12,17
404310362,Human Behavioral Biology,0,0,0,0,32,32
404893471,The WIRED Podcast,2,0,1,0,6,9
404963432,The Peter Schiff Show Podcast,28,5,6,4,157,200
405247258,Audio Tutor | Learning German | Deutsche Welle,0,0,1,0,4,5
405271228,We Hate Movies,23,14,10,16,437,500
406217561,Runner's Block,0,0,0,1,49,50
406250030,Knifepoint Horror,1,3,3,8,185,200
406782386,Tony Evans' Sermons on Oneplace.com,4,1,3,5,233,246
407893346,The Attractions Podcast,2,1,1,3,31,38
408691897,The Thrilling Adventure Hour,3,3,3,2,39,50
409050115,Learn Persian with Chai and Conversation,0,0,1,0,49,50
409287913,How Did This Get Made?,2,3,2,0,43,50
410006184,Tony Martignetti Nonprofit Radio,0,0,1,2,39,42
410021783,Spice | Romantic Stories of Love | Sex Charged Audio Stories Podcast,0,0,1,1,2,4
410339697,Conversations with Dr Bauchner,1,0,0,1,11,13
410937196,Under The Hood show,2,1,4,4,39,50
411665520,Emergency Medicine Cases,0,1,0,1,33,35
412151541,Comedy of the Week,7,3,1,5,3,19
412308695,TheThinkingAtheist,13,5,12,7,281,318
412308812,The History of England,1,0,0,0,49,50
412308821,Dragnet,0,0,0,2,9,11
412457621,The Longest Shortest Time,8,3,6,4,29,50
412678859,Catholic Stuff You Should Know,19,11,11,13,446,500
412684163,I Love Marketing,2,2,3,0,43,50
413046628,The Kyle & Jackie O Show,23,1,4,7,62,97
413505303,Alt.Latino,1,2,2,5,49,59
413551999,MarketFoolery,6,3,7,10,229,255
413602792,Awesome Vegans with Elysabeth Alfano,0,0,1,0,2,3
413879919,Wine for Normal People,8,11,5,10,166,200
413880792,Astrology & The Hermetic Arts: Holes to Heavens,1,0,3,3,273,280
413995650,Adam Beyer presents Drumcode,0,0,0,1,30,31
414324896,"Murphy, Sam & Jodi",1,0,2,1,4,8
414414318,Zen Parenting Radio,1,1,2,0,46,50
414496714,Eventual Millionaire Podcast,1,3,1,2,93,100
414672788,New Solo,1,0,0,0,18,19
415068220,"Jeep Talk Show, A Jeep podcast!",4,5,2,2,37,50
415315189,Dig Me Out - The 90s rock podcast,3,2,0,3,24,32
415512829,The Rizzuto Show,2,0,0,0,48,50
415535037,Back to Work,32,22,10,21,402,487
415602144,The Soulless Minions of Orthodoxy - Movie Commentaries,0,0,0,3,3,6
415788926,In The Rabbit Hole Urban Survival,1,0,2,4,85,92
415983183,The History Chicks,1,1,1,2,45,50
416046902,Driven Car Reviews,1,0,0,2,47,50
417007039,3 Martini Lunch,10,3,2,2,33,50
417009927,Breastfeeding Medicine Podcast,0,0,0,0,3,3
417051167,Treeleaf Zendo Podcasts,0,0,0,0,1,1
417396316,Cleveland Moto,2,0,1,3,44,50
417622409,Footballistically Arsenal,5,1,3,2,3,14
417826820,The Cloudcast,0,0,0,3,18,21
418152882,Fox News Sunday Audio Podcast,29,5,2,2,12,50
418170278,HCG Body For Life -How To Burn The Fat and Reveal The Muscle,1,0,0,0,11,12
418368811,Keeping It Real: Conversations with Jillian Michaels,11,5,4,4,26,50
418685623,Inside Forbes India,1,0,1,1,2,5
418877476,Journal de 19h,0,0,0,0,2,2
418898487,MASH 4077 Podcast,4,1,6,3,56,70
419046224,Ludology,2,1,0,5,42,50
419184337,11:11 Talk Radio,2,0,1,1,11,15
419196370,"Get In The Door Podcast | Sales Leadership, Training and Development by Scott ""The Professor""- Plum ...",2,0,1,1,48,52
419204493,Great Ideas in Psychology Podcast,0,0,0,0,13,13
419655104,Moonlight Audio Theatre,0,0,0,1,11,12
419879946,Nintendo Pulse – Nintendo Switch and 3DS News,1,0,1,1,47,50
419889705,The Creative Coding Podcast,0,0,0,2,22,24
419981670,The Familyman Show,0,1,0,0,20,21
420535283,Arming the Donkeys,1,0,0,1,5,7
420543296,How To Do Everything,17,4,5,17,213,256
420790840,Steve Dale's Pet World,0,0,0,0,1,1
421110541,Westminster Hour,3,0,0,0,0,3
421863760,The Projection Booth Podcast,2,4,0,5,136,147
422037667,Drama of the Week,3,1,2,3,29,38
422332846,This Week in Microbiology,0,1,0,2,92,95
423487977,The Sweep Spot - Former Disneyland Cast Members Talking Disneyland,0,3,6,8,136,153
424397634,Qalam Institute Podcast,0,0,1,1,46,48
424521521,The Parsha In My Life - By Rabbi Reuven Wolf - Maayon Yisroel,0,0,0,0,1,1
424632230,PSYC 213: Abnormal Psychology (DSM-IV-TR Edition),2,0,1,3,23,29
424640831,ASTR 104: Introduction to Stellar Astronomy - Complete,0,0,0,0,5,5
425179503,Anderson Cooper 360,94,17,13,25,104,253
425187524,New Books in Economics,1,0,0,2,0,3
425195053,New Books in Anthropology,0,1,1,0,2,4
425196394,New Books in Art,0,1,0,0,0,1
425210498,New Books in Architecture,0,0,0,0,1,1
425328515,"Oh No, Ross and Carrie",24,17,13,25,421,500
425361249,World Ocean Radio,0,0,0,0,3,3
425369034,New Books in Jewish Studies,0,0,0,2,5,7
425400236,New Books in Gender Studies,1,0,0,0,1,2
425414426,New Books in Political Science,1,0,1,2,7,11
425416616,New Books in African Studies,0,0,0,1,2,3
425659636,Joyce Meyer Ministries TV Podcast,9,2,1,1,92,105
425683368,New Books in Sociology,0,0,0,0,3,3
425700062,New Books in Public Policy,0,0,0,1,0,1
425715938,GuildSomm Podcast,4,1,2,4,23,34
426013000,Homesteading and Permaculture by Paul Wheaton,8,2,7,2,33,52
426081063,The Great Detectives Present Box 13,0,2,0,0,7,9
426081250,The Great Detectives Present Jeff Regan,0,0,0,0,1,1
426208821,New Books in Philosophy,1,0,1,0,2,4
426430244,Aesthetics and Philosophy of Art lectures,1,0,0,1,1,3
426476799,Understanding the Global Economy,0,0,0,1,0,1
426497635,Pro Football Talk Live with Mike Florio,58,11,11,19,96,195
426698661,Here & Now,12,7,4,3,24,50
427166321,Programming Throwdown,18,9,4,13,191,235
427374434,GeekWire,1,0,2,0,17,20
427377900,Mental Illness Happy Hour,2,0,1,1,46,50
427441597,Gunsmoke - OTRWesterns.com,0,0,0,0,17,17
427475874,The Six Shooter - OTRWesterns.com,0,0,0,0,5,5
427476432,The Lone Ranger - OTRWesterns.com,0,0,0,0,5,5
427720308,The Great Detectives Present the Thin Man,0,0,0,0,2,2
427774337,French Podcast,7,2,0,3,23,35
427896693,Far Post Podcast,1,2,3,2,16,24
427907708,COUN510 - Theories of Counseling,2,1,0,0,0,3
428492554,The Story of Psychology,0,1,1,0,7,9
428497602,Intro to Criminal Justice - Podcasts,0,0,0,0,2,2
428499961,The Speakeasy,0,0,1,3,26,30
428952840,Swami Sivananda,0,0,0,0,2,2
428989929,First Take,164,44,53,60,179,500
429201733,The Comic Conspiracy,21,2,8,11,96,138
429260982,The American Revolution - Audio,1,1,2,3,35,42
429307630,All About Android (Audio),3,4,2,4,19,32
429399962,Cook The Perfect...,0,0,0,0,1,1
429579781,Old Time Radio Nero Wolfe,2,0,0,2,7,11
429580370,The Great Detectives Present Let George Do It,0,0,0,1,2,3
429677585,Blue & Gold Illustrated: Notre Dame Football And Recruiting,7,3,8,8,42,68
429857721,The Great Detectives Present Sherlock Holmes,0,0,0,3,5,8
430140287,Listen to Dharma Talks – Orlando Insight Meditation Group,0,0,0,0,2,2
430244417,Great Detectives Present Yours Truly Johnny Dollar,0,1,1,2,20,24
430247008,The Baba Gonesh Podcast - Lessons in Indian Culture and Breaking News from the Homeland,0,0,0,0,1,1
430277324,Samurai Archives Japanese History Podcast,1,2,2,3,39,47
430333725,The Vergecast,70,40,23,21,346,500
430335151,Systematic Theology,0,1,1,0,1,3
430335653,Church History,0,0,0,1,0,1
430362452,Improvised Star Trek,0,0,0,0,50,50
430426112,PsychOut: Where We Explore Psychology Outside the Classroom,0,0,0,1,3,4
430657557,Foundations of Modern Social Theory - Audio,2,0,1,2,2,7
430939693,MLB Network: Intentional Talk,6,4,7,8,59,84
431167790,Jill on Money with Jill Schlesinger,3,3,5,1,188,200
431180569,Challenge of the Yukon - OTRWesterns.com,1,0,0,0,2,3
431181519,Have Gun Will Travel - OTRWesterns.com,0,1,1,0,5,7
431183292,Tales of the Texas Rangers - OTRWesterns.com,1,0,0,1,4,6
431258512,Unofficial Universal Orlando Podcast,1,3,3,4,120,131
431321611,All Things Gardening,0,0,0,0,1,1
431496967,Inside The Crew,0,0,0,0,8,8
431497094,The Vampire Diaries Reviews and After Show - AfterBuzz TV,2,1,7,8,86,104
431530532,The Psychic Viewpoint,3,2,2,1,11,19
431743772,The Corvette Mechanic,0,0,0,0,5,5
432002422,The House Of Ephraim,0,0,0,0,5,5
433059024,TechSNAP,0,1,0,0,39,40
433061815,Stories from the Borders of Sleep,1,0,0,1,48,50
433122457,PODCAST – Radio D,0,0,0,1,2,3
433426711,Decibel Geek Podcast,1,2,4,4,244,255
434132570,New Books in National Security,1,0,0,1,1,3
434136047,Mindful Meditations,0,1,0,4,24,29
434204845,The Game Of Thrones Podcast,45,24,15,18,80,182
434344872,Deeper Down The Rabbit Hole,3,0,1,3,10,17
434406265,AOPA Live This Week,1,0,0,0,2,3
434703649,The Voice Podcast - AfterBuzz TV,4,2,5,0,14,25
434716755,Ending Human Trafficking Podcast,0,0,0,0,22,22
435318964,BirdTalk Radio Podcast,1,0,2,1,3,7
435403033,Aetheryte Radio - A Final Fantasy XIV Shadowbringers Podcast,3,1,3,1,20,28
435571316,What On Earth Is Happening,2,1,1,1,44,49
435713106,Desert Island Discs: Archive 2000-2005,1,1,0,0,1,3
435713614,Desert Island Discs: Archive 2005-2010,0,0,0,0,2,2
435717297,American Patchwork & Quilting Podcast,5,9,3,3,40,60
435836905,The EntreLeadership Podcast,6,1,6,3,184,200
436133392,"Because Language - a podcast about linguistics, the science of language.",1,0,0,1,9,11
436270201,Minus Three,48,34,28,43,347,500
437441453,Easy Japanese: Grammar Lessons | NHK WORLD-JAPAN,0,1,0,2,13,16
437474360,Happiness Podcast,0,2,1,0,47,50
437608292,The Rise Guys,0,0,0,0,19,19
437751010,"Stuck Mic AvCast – An Aviation Podcast About Learning to Fly, Living to Fly, & Loving to Fly",0,2,2,1,9,14
438234007,Canine Nation,0,0,0,0,2,2
438242800,Stella Culinary School,0,1,0,0,19,20
438444016,ASTR 103: Introduction to Planetary Astronomy - Complete,0,0,0,0,1,1
438896324,UX Podcast,0,1,0,2,9,12
439843599,Learn German by Podcast,0,0,1,3,17,21
440569219,MRN Classic Races,0,0,1,5,17,23
440985304,The British History Podcast,7,5,5,1,32,50
441028270,Airline Pilot Guy - Aviation Podcast,0,4,3,0,43,50
442136254,The Micah Hanks Program,17,12,14,18,107,168
442428860,The Elements of Drawing,1,0,3,2,4,10
442476215,Irish Sports Daily Podcast,9,5,4,6,91,115
442759031,Family Vision with Dr. Rob & Amy Rienow,0,0,0,0,3,3
443158849,W&W Rave Culture Radio,1,0,0,0,35,36
443236145,Austin Zen Center Dharma Talks,0,0,0,0,3,3
443780324,Satellite Sisters,2,1,4,2,193,202
444083093,The NoSleep Podcast,9,4,6,3,28,50
444092800,Elevation with Steven Furtick,0,0,0,1,80,81
444665343,RNZ: Checkpoint,0,0,0,1,2,3
444970939,The Great Detectives Present Rogue's Gallery,0,0,0,1,0,1
446258670,Convert to Raid: The podcast for raiders in the World of Warcraft!,12,6,2,0,30,50
446611090,Epic Real Estate Investing,7,1,1,0,141,150
447609711,Prophetic News,10,1,0,1,5,17
447725304,Dog Training Q&A What Would Jeff Do?,2,0,0,0,14,16
448018230,Chairshot Radio Network,1,0,0,0,4,5
448067764,"DSR: Become a Better Man by Mastering Dating, Sex and Relationships (formerly Dating Skills Podcast)",4,0,0,2,44,50
448302257,FT Alphachat,0,1,2,3,34,40
448501269,Learn Dutch | DutchPod101.com,3,0,0,0,4,7
448501803,Learn Hebrew | HebrewPod101.com,0,0,1,1,0,2
448783667,HouseSmarts Radio with Lou Manfredini,0,0,0,0,2,2
448795390,Mohr Stories - JayMohr.com,12,3,0,1,34,50
449451010,Whence Came You? - Freemasonry discussed and Masonic research for today's Freemason,0,0,0,4,36,40
449564024,LSAT Kung Fu,1,1,1,0,8,11
449870843,WFO Radio Podcast,1,0,1,0,33,35
450992627,The 4x4 Podcast,0,1,2,1,46,50
451249755,Cast of Wonders,2,0,2,1,13,18
451295014,Bulletproof Radio,0,0,0,1,11,12
452161951,Kali Mandir Satsang,0,0,0,0,5,5
452620851,The Jim Hill Media Podcast Network,5,2,22,41,381,451
452827225,Cleveland Browns Daily & More,12,13,8,11,78,122
453044527,HowSound,0,0,1,0,49,50
453647774,EM Basic,0,0,0,1,49,50
454059519,Alien vs. Predator Galaxy Podcast,1,0,1,0,4,6
454541097,PSYC475 - Criminal Psychology,1,0,1,0,0,2
454714085,Physio Edge podcast,0,0,0,0,36,36
454755642,The World and Everything In It,4,1,9,4,482,500
455065811,Sex Nerd Sandra,2,6,3,4,35,50
455078215,Team Beachbody Coach Podcast,6,2,1,1,14,24
455422434,Jonathan Foust,0,0,0,1,33,34
456029341,TWFS,12,1,2,2,215,232
456417547,ILLUSIONOID,0,0,0,0,34,34
456574751,Radio 4 Quiz,1,0,0,3,2,6
457187387,"The Automotive Hour, Weekly Podcast of AGCO Automotive Corporation",0,1,0,1,48,50
457469049,DaUnknownAdmin Podcast,0,0,0,0,27,27
457915504,ASTR 104: Introduction to Stellar Astronomy - Fall 2019,0,0,0,0,1,1
457946327,Gleeman and The Geek,6,3,8,21,136,174
458062576,Professor Hallux: The Human Body Podcast for Kids,0,0,1,2,0,3
458066753,Mac Power Users,7,12,10,17,427,473
458210899,New Books in Buddhist Studies,0,0,0,1,1,2
458213762,Nuclear Hotseat hosted by Libbe HaLevy,1,0,0,0,1,2
458371107,Mel and Warp's Time-Travel Adventures: Story for Kids,3,1,1,0,4,9
458574334,Minecraft Me - SD Video,4,0,2,3,40,49
459436811,Hypnogoria,1,0,0,0,20,21
459476611,Gambling With an Edge,1,2,1,5,39,48
460107093,Markus Schulz presents Global DJ Broadcast,0,0,0,1,49,50
461580517,Geology 102 - Physical Geology,0,0,0,0,1,1
462374421,SoonerNation: Oklahoma Sooners,1,2,3,2,9,17
462415188,The Peak Prosperity Podcast,4,0,1,0,19,24
462443971,2 Knit Lit Chicks,6,1,2,1,40,50
462495496,Scriptnotes Podcast,3,8,8,12,424,455
463196186,The Kiss Me Quick's Erotica,9,1,1,3,130,144
463290655,WRESTLING SOUP,19,3,12,7,177,218
463678271,The Real Housewives of Beverly Hills After Show Podcast,29,23,15,6,32,105
463700741,In Our Time: History,5,2,7,10,24,48
463700760,In Our Time: Culture,1,1,6,4,11,23
463701000,In Our Time: Science,0,0,1,0,17,18
463701224,In Our Time: Religion,0,0,1,0,3,4
463701671,In Our Time: Philosophy,0,1,3,1,19,24
464108542,Watch Out for Fireballs!,15,9,4,10,312,350
464156500,NFL Fantasy Football Podcast,40,11,17,32,399,499
464722938,Sports Gambling Podcast,12,1,6,4,477,500
465081916,The Secret Cabal Gaming Podcast,1,1,1,4,43,50
465093758,Highly Questionable,21,4,11,5,111,152
465769847,Power Hour with Alex Epstein,4,1,0,1,32,38
466365255,Adventures in Urban Judaism,2,0,0,0,6,8
466659176,Down the Security Rabbithole Podcast,0,1,0,0,15,16
466679255,Amazin' Avenue: for New York Mets fans,7,4,2,2,43,58
467041704,The Cane and Rinse videogame podcast,2,0,1,3,44,50
467393422,Show-mp3 – Sunday Morning Linux Review,0,0,1,0,5,6
467876958,Miracle Internet Church Radio,0,0,0,0,4,4
468293449,Ari Shaffir's Skeptic Tank,11,2,0,0,37,50
468609197,Internet Box,3,0,2,0,45,50
468957505,Morelia pythons radio,1,0,0,0,15,16
469008348,Story Quest – Stories for Kids,0,0,0,2,9,11
469193661,Locked On Panthers - Daily Podcast On The Florida Panthers,0,1,1,0,7,9
469912037,The Life Scientific,0,0,3,2,10,15
470196204,The Unofficial WWE RAW After Show,33,10,8,11,121,183
470392993,Rewatchability,4,1,1,1,29,36
470616189,TED Talks Art,0,0,0,1,2,3
470622782,TED Business,0,0,0,0,4,4
470623175,TED Talks Kids and Family,1,0,0,2,11,14
470623182,TED Talks Music,2,0,0,0,6,8
470623801,TED Talks Science and Medicine,1,0,0,0,7,8
470623803,TED Talks Society and Culture,1,0,1,2,7,11
470624027,TED Talks Technology,0,0,0,1,3,4
470846331,"Soul Deep Sessions - ""House Made Sexy""",0,0,0,5,40,45
471410627,BrightFocus Chats: Macular Degeneration,0,0,0,0,1,1
471418144,Roderick on the Line,9,3,3,5,190,210
471896367,To The Best Of Our Knowledge,1,2,3,5,50,61
471920226,Hockey Night In New York,0,1,1,3,7,12
472131391,Comic Book Podcast | Talking Comics,22,13,10,12,116,173
472302597,Sexy Marriage Radio,0,6,2,0,42,50
472939437,Here's The Thing with Alec Baldwin,7,1,1,0,41,50
473140281,Decades of Horror 1980s,1,0,0,1,12,14
473532017,Watching Dead - Walking Dead Podcast,41,27,16,20,396,500
473550858,Washed Up Emo,1,0,0,2,23,26
474208361,Physics World Stories Podcast,0,0,1,1,3,5
474472126,Gita Wisdom Teachings by Joshua M. Greene (Yogesvara),0,0,0,0,3,3
474529211,The Rights To Ricky Sanchez: The Sixers (76ers) Podcast,15,2,7,3,473,500
474722933,London Real,16,1,1,1,31,50
474762601,Monocle 24: Monocle on Design,0,0,0,0,2,2
474763572,Monocle 24: The Urbanist,0,0,0,0,2,2
474787597,The New Psychology of Depression,1,0,1,0,9,11
475220376,Monocle 24: The Menu,0,1,0,0,2,3
475878118,You Made It Weird with Pete Holmes,7,4,5,2,32,50
477098768,Age of the Dinosaurs,2,1,0,0,6,9
477157900,The Once Upon A Time Podcast,15,7,7,21,96,146
477248343,You Need A Budget (YNAB),4,0,3,2,41,50
477534265,Taylor Talk: The Taylor Swift Podcast | reputation | 1989 | Red | Speak Now | Fearless | Taylor Swif...,1,0,2,5,42,50
477768571,I Didn't Know That!,12,1,4,2,17,36
478352618,This Week in Marvel,11,8,10,11,52,92
478840375,This Week in Tech (Video),5,1,1,1,6,14
479042177,Juke In The Back,0,0,0,0,14,14
479647724,Lacrosse All Stars Network,0,0,0,0,22,22
479679002,Sodajerker On Songwriting,0,0,0,1,49,50
479811154,The Modern Art Notes Podcast,1,1,1,3,44,50
479820088,improv4humans with Matt Besser,2,0,3,1,44,50
479879119,Podcast on the Brink,1,2,1,5,71,80
479961157,Information on Cruising the Great Loop,0,0,2,0,1,3
480486345,Monday Morning Podcast,55,13,18,16,398,500
480528933,The Real Housewives of Atlanta After Show Podcast,16,5,5,11,76,113
480787112,Thich Nhat Hanh Dharma Talks,1,2,1,1,17,22
481087877,Steve Deace Show,0,0,0,1,49,50
481165891,Horror a la Media Noche,3,0,0,1,12,16
481461646,The Conversation Art Podcast,2,0,3,1,48,54
482034476,CarProUSA Radio Show,1,0,0,0,11,12
482138043,The Citadel Cafe: A Sci-Fi and Fantasy Podcast,0,0,0,0,12,12
482494468,"Vos and Bonnie's ""My Wife Hates Me""",12,1,2,5,30,50
483046074,Podcast UFO,5,3,0,2,41,51
483223024,Official PlayStation Podcast,6,4,1,5,34,50
483522868,Universo Saint Seiya - Caballeros del Zodiaco,0,0,0,0,1,1
483978280,The Titanium Physicists Podcast,5,0,2,5,158,170
484409506,The China in Africa Podcast,1,1,0,0,21,23
484661268,Trail Runner Nation,1,6,8,6,132,153
485166512,Kerry Lutz's--Financial Survival Network,0,0,2,1,36,39
485603358,VO Buzz Weekly,0,0,0,0,15,15
485769640,Trinity Force Podcast - A League of Legends Podcast,2,1,2,1,44,50
487237857,Down N Dirty Sexy Hot Adult Stories from the Street,7,1,5,5,8,26
487257543,Philosophy Now,1,4,3,1,3,12
488721911,Tim and Sid,0,0,0,1,7,8
489361869,"Smart Podcast, Trashy Books: Reviews, Interviews, and Discussion About All the Romance Novels You Lo...",1,0,0,4,51,56
489369498,The China History Podcast,3,1,0,1,45,50
490027390,The Enormocast: a climbing podcast,5,1,3,6,314,329
490267185,The Podcast for Social Research,2,0,0,0,0,2
490297492,Strangers,28,17,13,19,423,500
491102842,Library Rap: The Hip Hop Interviews with Tim Einenkel,0,0,0,0,8,8
491922610,ASTR 103: Introduction to Planetary Astronomy - Spring 2019,0,0,0,1,0,1
491945086,Islamic History Podcast,2,1,3,5,51,62
492152715,Ultrarunnerpodcast.com,4,1,0,3,206,214
492432054,Simply Scottish,0,0,0,1,17,18
492447550,Chicken Thistle Farm CoopCast,2,1,2,11,484,500
492465503,Campfire Radio Theater,1,1,0,0,48,50
492711030,Tales to Terrify,11,2,6,7,79,105
492778219,Whoa Podcast About Horses Horsemanship,0,0,0,0,21,21
493151356,Changing Your World Podcast with Creflo Dollar,8,2,2,0,82,94
493253759,The History of WWII Podcast - by Ray Harris Jr,5,3,7,8,27,50
493417698,Justified Podcast,2,2,0,1,63,68
493544867,MLW Radio: The Flagship,22,6,6,7,162,203
493572872,The Ave Maria Hour Radio Show,0,0,0,0,4,4
493840697,War Rocket Ajax,5,4,2,3,154,168
494316084,Ultimately with R.C. Sproul,0,1,0,1,44,46
494450563,The Assembly Call IU Basketball Podcast and Postgame Show,2,1,0,1,57,61
494517111,HARDtalk,6,1,2,2,11,22
494747654,The DGDC - Deeply Graphic Designcast,4,4,5,12,153,178
495068100,A word from God,0,0,0,0,1,1
495504655,The Religious Studies Project,1,1,0,1,7,10
495880326,The Inside BJJ Podcast,5,2,6,12,242,267
496019927,The tastytrade network,2,0,0,1,17,20
496189056,The Exchange,18,10,5,8,20,61
496335552,TruSouL Radio,0,0,0,0,8,8
496797178,The Smoking Tire,12,8,2,3,25,50
496893300,All JavaScript Podcasts by Devchat.tv,1,3,3,5,38,50
496929276,Studio Break,0,0,0,0,6,6
497208674,State Of The Game,0,0,1,0,11,12
497227384,This Is Actually Happening,41,21,21,25,391,499
497318073,Talk Ultra,3,0,1,0,18,22
498016458,Federal Tax Update Podcast,0,0,0,0,1,1
498130432,Watch What Crappens,29,8,13,10,440,500
498211240,Dog Cancer Answers,0,0,0,1,5,6
498897343,The Lawfare Podcast,21,11,16,26,426,500
498978442,"New Books in Science, Technology, and Society",0,0,1,0,0,1
499238715,Admissions Straight Talk,0,1,0,0,9,10
499398411,True Story,5,6,5,7,32,55
499568965,The Kitchen Cabinet,0,0,0,0,3,3
499637041,C Tolle Run,0,1,4,4,117,126
499682376,The Yarniacs: A Knitting Podcast,0,1,2,3,44,50
499844469,Social Pros Podcast,1,1,2,1,45,50
499883130,Clinical Chemistry Podcast,0,0,0,0,1,1
500528514,SAF's Polite Society Podcast,2,0,1,5,29,37
500549470,Podcast Francais Authentique,0,0,0,0,22,22
500673866,Lexicon Valley,4,3,3,6,34,50
500772624,Tribulation-Now,3,1,1,0,13,18
500883402,Place to Be Wrestling Network,2,0,1,1,30,34
501055351,Psych 406: Psychology of Perception,1,0,1,0,0,2
501373557,"Animation Addicts Podcast - Disney, Pixar, & Animated Movie Reviews & Interviews | Rotoscopers",0,4,3,10,123,140
501572453,Diabetes Core Update,0,0,0,0,4,4
501575043,"The Fat-Burning Man Show with Abel James: Real Food, Real Results",5,4,2,3,36,50
502304410,The Truth,2,3,3,0,42,50
502334416,Half Size Me,2,0,1,1,46,50
502349432,Modern Woodworkers Association Podcast - Conversations Among Woodworkers,0,2,3,4,21,30
502689992,All the Kings Men | LA Kings,4,0,1,4,84,93
502854960,Data Stories,1,0,0,2,26,29
503308704,Hot Stove Radio,0,0,2,1,8,11
503341322,Adventures In Design,5,7,3,6,103,124
503482646,Your Mom's House with Christina P. and Tom Segura,63,17,11,21,387,499
503494956,The CultCast,27,15,14,13,431,500
503735821,Friday's | Hot Passionate Sex Stories to Heat Up Your Nights,0,0,1,1,1,3
503752876,Flower Mound Women's Bible Study,0,1,2,2,83,88
504413684,The WODcast Podcast,2,4,2,0,42,50
504433519,Shani Mantra,0,0,0,1,0,1
505246808,Physician Assistant Exam Review,1,2,5,14,318,340
505516789,The Besties,0,0,0,0,50,50
505756741,The RC Newb Podcast,0,0,0,2,5,7
505824976,Bloggingheads.tv: The Glenn Show,2,1,2,2,43,50
505854388,Inspirational Comedy with Dr. Michael Smalley,1,2,1,3,125,132
506354054,Jentezen Franklin Podcast,0,0,0,0,74,74
506491183,Daily Tanya (Audio) - by Manis Friedman,0,0,0,0,4,4
506491536,Rambam - 1 Chapter a Day (Audio),0,0,0,0,2,2
506779862,Lectures in History,2,2,2,3,19,28
506942068,Commuter Knitter Podcast,0,0,0,0,36,36
507135865,Legion of Skanks Podcast,0,1,0,0,49,50
507523105,The JV Club with Janet Varney,0,0,0,2,48,50
507888150,Techno Music - Techno Live Sets Podcast,4,0,3,1,42,50
507938401,"Good Job, Brain!",1,0,1,4,44,50
507987292,The Empire Film Podcast,0,6,0,7,52,65
508376907,Babbage from Economist Radio,0,0,1,1,33,35
508618820,Om Nama Shivaya - Shiva Mantra Chants recited by Sandeep Khurana,0,0,0,0,2,2
508647267,Game of Thrones The Podcast,124,36,27,16,297,500
508921276,Women Amplified,0,1,0,0,6,7
508943027,Shop Talk Live - Fine Woodworking,3,3,1,0,43,50
509093902,DFB Podcast,1,1,3,8,108,121
509309981,Chris Spangle Show - We Are Libertarians Podcast Network,11,9,6,5,109,140
509894624,Criterion Cast: Main Episodes,0,0,0,1,5,6
509929387,Down Cellar Studio Podcast,0,0,0,1,49,50
509969439,Barbell Shrugged,8,8,13,6,15,50
510036484,Ask Science,6,2,1,3,12,24
510098639,Razzball Fantasy Baseball,7,4,7,3,92,113
510160837,The Week in Doubt Podcast,3,0,1,4,20,28
510327102,The LRB Podcast,0,0,0,0,5,5
510761000,A Course in Miracles,1,1,1,3,93,99
511125340,American Journal of Gastroenterology Author Podcasts,0,0,0,2,2,4
511265415,Deep Energy Podcast,21,4,8,7,66,106
511550233,Satsang with Sitar,0,0,0,0,4,4
511745722,Troubled Waters,0,0,2,2,46,50
512223214,Photofocus Podcast,4,8,5,5,19,41
512750020,Gun Guy Radio,3,3,8,12,320,346
513002950,Mad Men Happy Hour,14,10,5,21,198,248
513367539,Your Success At Last DNA | Daily Motivation | Goal Setting,0,0,0,0,1,1
513506131,How to Think Like a Psychologist,4,2,2,2,7,17
513507273,The Star Spot,1,0,0,0,9,10
513611341,The Cleansed: A Post-Apocalyptic Saga,27,12,3,4,4,50
513808150,Ottoman History Podcast,1,1,2,2,19,25
514144367,Options Boot Camp,2,1,4,1,7,15
514253822,The Public Philosopher,0,0,0,0,2,2
514431958,Powertools Mixshow,1,0,0,1,28,30
514748675,Our Fair City,2,1,1,4,42,50
515547619,Hindu Mantras,1,0,1,0,3,5
515946405,Early Middle Ages,2,1,2,2,12,19
517589332,The Ancient World,0,2,0,2,46,50
518190148,Going Off Track,1,0,0,0,49,50
518321143,West Virginia Morning,0,0,0,0,4,4
518366323,Ram Dass Here And Now,0,2,7,13,116,138
518726837,Alvin and the Chipmunks,4,0,0,1,8,13
519376909,Scandal Reviews and After Show - AfterBuzz TV,14,16,28,26,251,335
519555196,Got Clutter? Get Organized! with Janet,0,0,0,0,7,7
519582740,Infectious Diseases Society of America,0,0,0,0,2,2
520032933,Intuitive Awareness by Ajahn Sumedho,0,0,0,0,1,1
521594713,You Are Not So Smart,7,6,10,26,146,195
521692586,Gold Derby: Predict Hollywood Races - GoldDerby,0,2,0,1,2,5
521811037,Fitness Confidential with Vinnie Tortorich,6,3,6,0,35,50
521840357,The Collected Teachings of Ajahn Chah - Audiobook,0,0,0,0,7,7
522504024,The Ars Technicast,1,8,3,2,3,17
523121474,TED Radio Hour,92,56,34,4,102,288
523132467,Winged Nation,0,0,0,0,11,11
523651655,Tales of a Red Clay Rambler: A pottery and ceramic art podcast,0,0,0,0,64,64
523996362,The Beerists Craft Beer Podcast,5,1,3,1,190,200
524002915,IELTS Podcast,0,0,0,3,8,11
524346751,Philosophy of Religion,0,0,1,0,2,3
524721137,Bad Dog Agility Podcast,0,1,0,0,17,18
524835071,The Broad Experience,1,1,1,6,191,200
524978407,Ask Me Another,1,1,2,2,44,50
525309549,Build My Online Store Podcast,0,1,2,3,44,50
525807840,Minnesota Today,1,1,0,1,5,8
527187069,"Naked Genetics, from the Naked Scientists",0,0,0,1,7,8
527237888,Words and Their Stories - VOA Learning English,0,0,0,0,2,2
527328503,Weird Medicine: The Podcast,3,1,0,0,46,50
527446250,The HoneyDew with Ryan Sickler,0,1,0,2,47,50
527579475,The History of Byzantium,1,0,1,1,47,50
527614348,Radio Ambulante,3,1,2,9,343,358
528201226,StoryCub - PRESCHOOL VIDEO STORYTIME! BUILT FOR KIDS 2-6.,1,4,1,2,21,29
528427969,Sex Out Loud with Tristan Taormino,0,0,4,1,30,35
528458508,The Talk Show With John Gruber,64,19,26,49,342,500
528732255,kiwimana Buzz Beekeeping Show - A Beekeeping Podcast/Show,0,0,0,0,21,21
529018781,Afterlife TV with Bob Olson,1,0,0,0,25,26
529742666,Xtended,0,0,1,1,6,8
529889126,Chef's Story,0,2,2,1,4,9
529919021,The Co-Main Event MMA Podcast,7,1,1,3,131,143
530971441,The Tennis Podcast,5,9,9,7,130,160
531754457,Andante: beginners' Italian - Audio,2,0,1,1,1,5
532661418,Fat Man Beyond,12,5,4,2,27,50
532824960,The Trail Show,2,2,1,4,173,182
533058860,The Full Feed - All of the Packet Pushers Podcasts,0,0,1,1,38,40
533465123,Intuitive Astrology  with Molly McCord,0,1,0,0,34,35
533583161,Manager Tools Basics,0,0,0,0,16,16
533673516,Transform Your Workplace,0,0,0,1,49,50
535203893,Run to the Top Podcast | The Ultimate Guide to Running,0,1,0,2,47,50
535703640,Learn Norwegian | NorwegianClass101.com,0,0,0,1,5,6
535704693,Learn Turkish | TurkishClass101.com,5,0,0,1,2,8
536209167,KFC Radio,2,0,0,0,48,50
536258179,Welcome to Night Vale,2,1,0,2,45,50
536781652,The Free Zone w/ Freeman Fly,12,4,2,4,51,73
537110554,Average Swingers,3,4,3,0,40,50
538198227,Dom Irrera Live from the Laugh Factory,3,0,1,7,39,50
538210866,I'll Drink to That! Wine Talk,2,0,2,0,196,200
538401206,The Potter's Touch,1,2,1,1,15,20
538608536,The History of English Podcast,1,1,1,1,42,46
539359582,Go Creative Show,1,1,0,1,66,69
539511222,Main Street Vegan,0,0,2,2,46,50
540187826,iPhone Ringtone Videos,1,0,0,1,0,2
540588894,The Hey My Man Podcast,0,1,0,0,38,39
540593710,Financial Independence Podcast,1,0,1,4,194,200
541401108,The Astrology Podcast,8,3,9,7,89,116
541481026,The Generation Why Podcast,89,34,54,29,290,496
541752791,Hospital and Internal Medicine Podcast,1,0,0,3,46,50
542037394,Inside the Great Outdoors,0,0,0,0,4,4
542396314,NASCAR Live,3,1,1,1,3,9
543622289,108 Talks by Ajahn Sumedho,0,0,1,0,4,5
544473518,Aviation Careers Podcast,2,0,1,1,20,24
545365634,Space Talk,0,0,1,0,0,1
545485117,Autonomy 🤸‍♂️🍔✊ GMB Fitness,2,0,0,1,29,32
545919715,Effectively Wild: A FanGraphs Baseball Podcast,11,14,17,13,445,500
546392540,Dice Tower Now,2,2,1,2,16,23
547986680,Improv Nerd With Jimmy Carrane,0,0,0,2,45,47
548055526,Runner Girls,1,3,1,4,46,55
548172803,Horror 101 Podcast,0,0,0,0,16,16
548391172,Tech News Weekly (Video),5,2,0,0,9,16
548404303,The Shinybees Knitting and Yarn Podcast,1,1,0,2,29,33
548674350,House Planning Help Podcast,0,0,0,0,14,14
548883685,"XR-U : The BDSM, Sex, and Fetish Show",1,0,0,0,11,12
549003189,Colleen & Bradley,0,0,1,1,6,8
549057901,The MovieFilm Podcast,0,0,0,1,60,61
549804953,NHS Strength and Flexibility,0,0,0,1,4,5
549826354,NHS Couch to 5K+,0,0,0,4,11,15
549899114,Social Media Marketing Podcast,0,0,0,0,3,3
550041325,Last Exit to Brooklyn,1,0,0,1,39,41
550845018,I've Got a Beatles Podcast!,1,3,1,2,16,23
551513897,SimpleFlight Radio,0,0,0,1,12,13
551719271,Mission Log: A Roddenberry Star Trek Podcast,14,9,8,16,169,216
551929117,Nehora School presents the Kabbalah of Rabbi Ashlag,0,0,0,0,1,1
551974504,Geology Rocks: Exploring the Earth Sciences,0,0,0,0,2,2
552106359,FroKnowsPhoto Photography Podcasts,21,6,9,9,130,175
552276825,"Surviving Divorce Podcast: Hope, Healing, Recovery, Personal Finance, Co-Parenting",1,0,0,2,47,50
552883315,Ken and Robin Talk About Stuff,1,0,0,0,31,32
553228314,Advice Worth Keeping,0,0,1,0,1,2
553604212,MacBreak Weekly (Video),7,4,6,1,13,31
553611167,iOS Today (Video),3,1,2,5,22,33
553710453,The Whole View,1,2,1,0,46,50
554734474,Beyond the To-Do List,2,3,5,8,182,200
556373664,Sex Afflictions & Porn Addictions,1,3,1,1,5,11
556959673,Palaeocast,1,0,0,0,18,19
557975157,Very Bad Wizards,15,3,5,9,423,455
558364221,Uncle Joey's Joint,7,1,1,0,41,50
558494752,ELECTRONYK PODCAST,0,1,1,1,29,32
558509322,"jewish, judaism, spirituality, torah,",1,1,1,1,11,15
558995745,Soul Music,1,0,0,0,17,18
559788668,Hardwell On Air Official Podcast,19,8,4,7,135,173
560588096,ESV Old Testament (Dramatized) - English Standard Version Bible,1,3,1,2,12,19
560923828,Relatively Prime: Stories from the Mathematical Domain,1,1,0,2,39,43
561124694,Protocol Radio,2,1,0,4,28,35
561470997,Note to Self,18,8,14,20,440,500
561496898,Tabula Rasa audio drama,1,0,1,2,3,7
561510696,Blurry Photos,16,6,11,7,332,372
561715706,The Moby-Dick Big Read,0,1,2,3,17,23
561769983,Things We Said Today Beatles Radio Show,3,0,4,5,4,16
562172725,The Grey's Anatomy After Show Podcast,8,7,3,9,41,68
562213126,Jayhawk Talk Podcast,1,1,0,3,92,97
562603085,The Pipes Magazine Radio Show Podcast,2,0,0,0,48,50
562626393,First Rounders,1,0,0,0,6,7
563127951,"Law Talk With Epstein, Yoo & Senik",4,2,0,1,47,54
563128177,London Calling,2,3,0,1,28,34
563327521,NCUSCR Events,1,0,0,1,1,3
563646790,Baby Geniuses,3,0,1,1,45,50
564001633,Entrepreneurs on Fire,10,0,6,5,179,200
564022874,Klezmer Podcast,0,0,0,0,1,1
564093021,Gambling Podcast: You Can Bet on That,0,0,0,1,49,50
564288259,Thinking Poker,1,0,0,2,47,50
564425626,Here Be Monsters,9,7,4,14,279,313
564634644,Daily Gemara Podcast - Daf Yomi By Rabbi Eli J. Mansour,0,0,0,0,8,8
564704022,The Homeland Podcast,7,12,7,11,29,66
566908883,Tangentially Speaking with Christopher Ryan,5,4,2,8,181,200
567051894,History of the Crusades,8,2,2,1,37,50
567144989,Nightmare Magazine - Horror and Dark Fantasy Story Podcast (Audiobook | Short Stories),7,3,2,3,35,50
567201505,Daily Daf Differently,0,0,1,0,1,2
567232410,The Drunken Taoist Podcast,9,3,3,7,282,304
567854829,#StudioInter,0,0,0,0,7,7
568409161,Curious City,1,2,0,1,37,41
568456106,PragerU: Five-Minute Videos,13,1,0,0,36,50
569410141,Ruby Ryder's Pegging Paradise,0,0,0,0,17,17
569462639,Islamic Finance Podcast with Almir Colan,0,0,0,0,4,4
569604769,Playing On Air: A Theater Podcast,0,0,0,0,20,20
570256898,The Pete and Sebastian Show,5,0,3,4,38,50
570322292,Heffron and Reep Show,0,0,0,0,42,42
571041508,Frisky Friday | Sexy Stories to Heat Up Your Nights,0,0,0,0,1,1
571304212,DJ Private Ryan's Podcast,1,1,0,1,49,52
573731398,Talking Flight,0,0,0,1,11,12
574192620,Dungeons & Randomness: A D&D Podcast,1,1,0,0,48,50
574228461,Dilettante Ball,0,0,0,0,50,50
574289538,Growth Marriage,0,0,0,1,42,43
574484932,Get Fit with Jodelle,0,0,0,1,35,36
575308520,AOKI'S HOUSE,1,1,2,3,33,40
575358022,Master Photography,7,2,4,0,87,100
575567448,Death and Dying Retreat by Ajahn Amaro,0,0,0,0,1,1
575660278,The Lords Hour,0,0,0,0,3,3
575912069,The Fighting Cock (Tottenham Hotspur Podcast),1,1,1,1,111,115
576266746,Hip to be a Square Quilting Podcast,1,0,0,0,45,46
577009557,Extreme Health Radio,1,2,2,2,43,50
577192220,CiRCE Institute Podcast Network,1,0,0,1,48,50
577245086,Tin Foil Hat With Sam Tripoli,11,3,5,1,30,50
578641256,The Game Design Round Table,0,0,1,5,42,48
578704049,Radar Contact,0,0,0,0,2,2
578706812,Lady to Lady,12,4,4,1,29,50
579402864,Strange Fruit,0,0,0,0,19,19
579581282,Hayward Sanitarium » Hayward Sanitarium Podcasts,3,1,2,3,5,14
579999452,The Civil War (1861-1865): A History Podcast,1,2,0,4,43,50
580050123,Deep Cuts Radio - Signal 7,0,0,0,0,3,3
580501108,The Bubble Hour,1,3,2,1,43,50
580709168,Magic: The Gathering Drive to Work Podcast,3,2,3,3,39,50
580874786,Thru the Bible on Oneplace.com,0,0,0,0,39,39
581324591,Greetings Adventurers - Dungeons and Dragons 5e Actual Play,2,0,0,0,48,50
582272991,The Rich Roll Podcast,4,8,8,8,632,660
582330874,French for Beginners,3,2,2,2,8,17
582573564,Nerd Poker,1,0,1,1,47,50
582585399,NL Hafta,11,3,0,2,31,47
582614834,The Gary Neville Podcast,4,2,4,0,20,30
582995201,Stuff Jews Should Know,0,0,1,2,62,65
583552127,No Challenges Remaining,8,2,7,5,90,112
583666188,All Work No Play,0,0,1,0,32,33
583758126,Discovering Truth with Dan Duval,1,1,0,2,21,25
584092091,Gita For Daily Living,3,6,6,7,57,79
584399167,Hawaii Travel Podcast,0,0,0,0,13,13
584543823,The Adam and Dr. Drew Show,10,7,10,0,23,50
584913682,The Wow! Signal Podcast,0,0,1,2,7,10
585042364,Inside The Ropes,2,1,0,0,19,22
585103759,Bertcast's podcast,9,5,2,1,33,50
585510701,AR-15 Podcast - Modern Sporting Rifle Radio,8,4,5,24,459,500
585914973,"Defensive Security Podcast - Malware, Hacking, Cyber Security & Infosec",1,1,2,2,94,100
586646296,Three Sides of the Coin – A KISS Podcast and Radio Show,20,10,10,14,181,235
586730504,Still Untitled: The Adam Savage Project,4,9,6,24,432,475
587014390,DTV Audio,0,0,0,0,3,3
587166784,Dharma Ocean,0,0,0,0,5,5
587347784,The Guardian's Audio Long Reads,12,4,10,22,54,102
588065833,"The Physician Assistant Life - Everything Physician Assistant. A Podcast for Practicing PAs, Pre-Phy...",0,0,0,0,1,1
588987926,Business of Architecture Podcast,0,2,1,1,61,65
589273985,Aarti - Sant Shri Asharamji Bapu Aarti,0,0,0,0,1,1
589864479,The John Batchelor Show,4,5,5,6,30,50
590043753,Youpreneur FM Podcast,1,0,1,1,147,150
590065800,Highway Diary with Eric Hollerbach,0,0,0,0,4,4
590067714,"Sips, Suds, & Smokes",3,1,0,1,59,64
590068000,This Week in Guns,12,5,11,4,98,130
590968693,History of the Papacy Podcast,3,2,1,4,40,50
591157388,The Holy Post,24,14,9,18,348,413
591298306,MyNDTALK with Dr. Pamela Brewer,0,0,0,0,2,2
591460709,The Recovery Show » Finding serenity through 12 step recovery in Al-Anon – a podcast,0,0,1,0,49,50
591591369,Revelations Radio News,0,0,1,0,15,16
592027675,Good Luck High Five,3,1,0,1,45,50
592110281,The eLearning Coach Podcast,0,0,0,1,17,18
592284993,The Dr. Drew Podcast,24,1,1,1,23,50
592337578,All About Android (Video),0,0,0,0,5,5
592385155,Sean and Robot's Comedy Circuit,22,5,3,1,19,50
592596408,Muscle Maven Radio,1,0,1,0,48,50
592746186,Mufti Menk,0,0,0,1,26,27
592955441,PEM Currents: The Pediatric Emergency Medicine Podcast,0,0,0,0,6,6
593007235,Pat Mayo Experience,2,0,2,5,490,499
593053325,Security Now (Video),0,1,1,1,5,8
593054580,Windows Weekly (Video),0,0,0,0,2,2
593303704,EntreArchitect Podcast with Mark R. LePage,0,0,0,6,59,65
593308372,Bald Move Pulp,5,1,2,13,91,112
593354706,Bonfireside Chat - A Dark Souls and Bloodborne Podcast,8,2,9,1,30,50
593355728,Rebel Force Radio: Star Wars Podcast,82,19,8,9,382,500
593369492,TWiT News (Video),1,1,0,0,1,3
593432991,Nouman Ali Khan,2,0,0,0,32,34
593535863,Global Dispatches -- World News That Matters,0,0,0,2,76,78
593635076,HelixTalk - Rosalind Franklin University's College of Pharmacy Podcast,1,0,0,1,48,50
593751261,The None to Run Podcast,0,0,0,0,5,5
593872749,New Books in Critical Theory,1,3,0,1,3,8
594057644,This Jewish Life - With Rabbi Yaakov Wolbe,0,1,0,0,12,13
594376523,Hardcore Gaming 101,5,3,1,2,174,185
594419649,BiggerPockets Real Estate Podcast,10,10,12,10,234,276
594424283,The Vanderpump Rules After Show Podcast,30,6,10,2,70,118
594480867,Historical Astronomy,1,0,0,0,0,1
594703545,Online Marketing Made Easy with Amy Porterfield,3,0,0,0,197,200
594960922,EY Cross-Border Taxation Alerts,0,0,1,0,0,1
595147712,The FlightBridgeED Podcast,0,0,0,1,28,29
595156391,Simple Suttas,0,0,0,0,2,2
595225514,The Wicked Library,3,2,4,0,41,50
595299041,"Pixar Post Podcast: Animation News, Interviews & Reviews",0,0,0,1,17,18
595386313,"Naked Neuroscience, from the Naked Scientists",0,0,0,0,7,7
595399272,Coffee Break German,1,0,3,2,44,50
595566999,Dose of Leadership with Richard Rierson | Authentic & Courageous Leadership Development,1,0,0,4,95,100
595892633,The Heart,5,3,6,1,35,50
596024360,Private Jet Podcast,0,0,0,1,5,6
596047499,The School of Greatness,77,28,84,42,3360,3591
597224844,Italian Podcast,3,0,0,1,8,12
597244027,Heroes and Villains podcast,1,1,0,2,67,71
597316507,Where Did the Road Go?,4,3,1,1,49,58
597435570,Be Reasonable,0,1,0,0,32,33
597512861,Mat Men Pro Wrestling Podcast,1,0,0,0,38,39
597583061,Statistics for the Social Sciences,0,0,0,1,17,18
597735438,"The Practice of the Practice Podcast | Innovative Ideas to Start, Grow, and Scale a Private Practice",1,1,2,2,101,107
597919007,The Young Turks,199,28,10,14,216,467
598146807,Survivor: Winners at War - Recaps from Rob has a Podcast | RHAP,3,1,5,2,118,129
598525381,The Inforium,4,1,1,0,44,50
598559251,Abdul Basit,0,0,0,0,2,2
599326719,Practice Portuguese,0,0,0,0,28,28
599491778,Archispeak,1,0,1,3,39,44
599740073,Down to Dunk OKC Thunder Podcast,5,0,1,2,381,389
599849932,The Church of Eleven22,0,0,0,0,9,9
600020121,Mad About Movies,61,38,23,13,323,458
600083895,ResortLoop.com - A Walt Disney World Podcast!,1,0,2,5,147,155
600106614,Consulting Success Podcast,0,0,0,1,35,36
600128442,The RealLife English Podcast,2,0,2,2,30,36
600138148,Abhayagiri Talks,0,0,0,0,1,1
600353928,Vidjagame Apocalypse,14,4,10,4,264,296
601163439,Mindful Meditation at the Hammer,2,1,2,1,11,17
601686658,Trial Lawyer Confidential,1,1,1,3,44,50
602003021,Overdue,22,14,4,4,156,200
602578156,Buddha at the Gas Pump,2,3,3,2,67,77
602924652,Cantina Cast,7,6,6,6,136,161
603046539,"Space Boffins, from the Naked Scientists",0,0,0,1,1,2
603173915,Footnoting History,1,2,6,6,35,50
603707723,The Dale Jr. Download - Dirty Mo Media,5,1,12,10,472,500
604656349,Sasquatch Chronicles,18,10,12,20,440,500
604757029,Wine for Sophisticated Homies podcast,10,2,5,1,126,144
604880888,Yasir Qadhi,0,0,0,0,20,20
605044861,Speech and Language Kids Podcast,1,0,1,7,41,50
605769651,Gardening with the RHS,0,0,0,0,1,1
605877206,The Chase Down: A Cleveland Cavaliers Pod,0,0,0,1,147,148
606100490,Dates & Mates with Damona Hoffman,0,1,3,1,50,55
606143097,The Wings Over New Zealand Show,0,0,0,0,3,3
606186284,Dynasty Fantasy Football - Under The Helmet,17,8,11,5,121,162
606662761,Breaking Bread with Tom Papa,1,0,3,4,130,138
607070725,Big Brother All-Stars Recaps & BB22 Live Feed Updates from Rob Has a Podcast,8,4,7,13,106,138
607714950,Punks in Parkas,0,0,0,0,3,3
608035917,Firearms Radio Network (All Shows),3,0,1,3,46,53
608676657,The Gay Man's Guide,0,0,0,0,5,5
608950806,MOOC Podcast: Intro to Anatomy and Physiology with Doc C,0,0,0,0,4,4
611229475,Out of Bounds with Bo Bounds,0,1,1,1,5,8
611239356,Pathway to Victory on Oneplace.com,2,0,0,0,22,24
613437137,CBS Evening News,46,12,17,7,12,94
615394067,New Books in Mathematics,0,0,0,1,0,1
615401490,Hooniverse,1,1,2,4,42,50
615562998,"Soil, Stones, & Rocks",0,0,0,0,1,1
616030916,Animals,0,0,0,0,3,3
617028866,La Corneta,1,0,1,2,46,50
617259940,Khalid Yasin,1,0,0,0,2,3
617261266,Yusuf Estes,0,0,0,0,1,1
617416468,Accidental Tech Podcast,56,30,28,26,330,470
617721679,Law of Attraction Radio Network,3,0,0,1,2,6
617722736,Student of the Gun Radio,29,13,10,3,285,340
618132843,Ask Pastor John,4,2,3,2,137,148
618424258,Aloha Bible Prophecy,0,0,0,0,16,16
619369512,The Read,0,1,0,2,47,50
620040765,BASS TALK LIVE,0,1,3,7,487,498
620967489,The Glenn Beck Program,22,6,8,4,242,282
621931754,The Land O'Lakers Podcast by the Kamenetzky Brothers,2,1,1,1,10,15
622413963,Fit Womens Weekly Podcast,1,2,1,2,44,50
622424087,Law Abiding Biker | Street Biker Motorcycle Podcast,7,2,0,2,39,50
623204092,The Touch MBA Admissions Podcast,0,0,0,0,34,34
623520420,Power Athlete Radio,1,0,0,2,47,50
623540261,Fitness Mentor- with Tommy Caldwell,0,0,0,1,4,5
623732043,Beginner Spanish with Spanish Obsessed,1,0,3,1,27,32
623734477,Intermediate Spanish - Spanish Obsessed,0,0,0,3,46,49
623735583,Advanced Spanish with Spanish Obsessed,0,0,0,1,21,22
624127071,The Property Podcast,2,3,2,5,488,500
624693800,Who Shot Ya?,13,3,6,13,369,404
625276860,Speaking of Sex with The Pleasure Mechanics,1,1,1,0,47,50
625975033,Mishary Rashid Alafasy,0,0,0,0,6,6
626129639,The History of Egypt Podcast,1,0,0,1,48,50
626248383,Subconscious Mind Mastery Podcast,3,0,0,2,83,88
626299586,Kyle Kingsbury Podcast,5,0,2,0,43,50
626605826,The Urban Chicken Podcast  - The Urbanite's Podcast Resource for Keeping Backyard Chickens,0,0,0,0,34,34
628019387,Saad al-Ghamdi,0,0,0,0,4,4
628289845,The Omniplex,1,0,0,0,2,3
628455920,Climate Cast,0,0,0,0,4,4
628537309,Three Sides of the Coin Video,3,0,2,2,27,34
628673204,"Bliss Bringers - Sex, Swinging & Kink Podcast",0,0,0,1,11,12
630200082,The Steve Austin Show,27,7,12,17,436,499
630839767,Talking Cars (HQ),2,6,0,2,12,22
631094342,Pastor Rick's Daily Hope,0,0,0,0,5,5
631558915,Hagmann Report,5,1,1,2,41,50
632094862,Just Plane Radio,0,0,0,0,4,4
632683666,W.B. Walker's Old Soul Radio Show,1,1,0,1,152,155
633108165,Shoot the Defence,0,0,0,0,2,2
634849197,The History Hour,4,1,0,1,21,27
634849863,The Science Hour,1,3,1,2,9,16
634857768,What's Wrong With Wrestling? WWE Recap Show,14,2,2,2,203,223
635045292,The Michael Savage Show,90,13,13,20,364,500
635150937,Beginners – Lightspeed Spanish,0,0,0,0,3,3
635706587,Life Lessons: The Gintama Manga Cast,0,0,0,0,2,2
635736811,History of Japan,1,2,1,4,42,50
636421255,Early Intermediate – Lightspeed Spanish,0,0,0,0,3,3
636610530,Daily Buddhism,0,0,0,0,4,4
637433286,AFL Exchange,15,12,5,8,54,94
638325751,The Most Accurate Podcast,5,1,5,16,191,218
638494223,RotoGraphs Fantasy Baseball,16,7,16,24,399,462
639433875,Amy Myers MD,0,1,1,1,12,15
639900889,Por el Placer de Vivir,0,0,0,1,14,15
640246578,The Model Health Show,3,0,0,0,47,50
640581455,The Let's Talk Bitcoin Network,8,3,2,4,46,63
641130629,Miette's Bedtime Story Podcast,0,0,0,0,13,13
641171423,Extra Pack of Peanuts Travel Podcast,6,5,11,16,275,313
641742791,The Confidence Podcast,0,0,0,0,50,50
641836403,9to5Mac Happy Hour,28,16,16,6,104,170
642198704,Down These Mean Streets (Old Time Radio Detectives),0,0,1,6,56,63
642215846,Your Kick Ass Life Podcast,3,0,0,3,44,50
642268648,"Hypnosis and NLP with Donald Currie, Registered Psychotherapist",0,0,0,1,15,16
642483864,Off Camera with Sam Jones,4,3,4,2,168,181
642557771,Houston Matters,4,0,3,0,5,12
642742958,Doggy Dan Podcast Show,3,1,0,1,8,13
643055307,The Dollop with Dave Anthony and Gareth Reynolds,6,5,5,1,33,50
643687501,Fish Nerds Fishing Podcast,1,2,0,3,95,101
643885946,Craft Industry Alliance,1,1,0,1,43,46
644335253,Dei Musicale | The Musical Gods,0,0,0,0,7,7
645390744,The Avid Woodworker,0,0,1,0,22,23
647377868,Weekly Shonen Jump Podcast,1,2,1,5,14,23
647720354,Book Riot - The Podcast,19,16,18,10,137,200
647745591,"Coffee With Kenobi: Star Wars Discussion, Analysis, and Rhetoric",9,0,6,4,154,173
647826736,Good Life Project,3,0,1,5,41,50
650045209,The Stacking Benjamins Show,11,9,9,6,165,200
650657153,El Podcast de Marco Antonio Regil,0,0,0,0,50,50
651219242,Ask Women Podcast: What Women Want,6,6,7,2,29,50
652113830,The MetalSucks Podcast,6,3,0,2,39,50
652457835,Classical Classroom,0,0,3,0,117,120
652522142,Kreative Kontrol,0,1,1,1,17,20
653016185,Dave & Chuck the Freak Podcast,11,1,1,2,35,50
653314424,The Grimerica Show,8,4,2,4,250,268
654789361,ROCK AND/OR ROLL,2,0,0,2,57,61
654839144,AMMO NYC,0,0,0,0,32,32
654839631,Restoring Human Movement,0,0,0,0,30,30
655135292,The Side Hustle Show,4,0,3,2,191,200
655723905,Temple of Witchcraft,0,0,0,0,1,1
655772067,Skyrim Addict: An Elder Scrolls podcast,0,0,0,0,31,31
655880335,Laura Erickson's For the Birds,0,0,2,0,9,11
656270845,Star Wars Minute,11,3,7,7,334,362
656868743,The Retirement and IRA Show,0,0,1,0,7,8
657184487,Horsemanship Radio,0,0,0,0,7,7
657476401,Tiny Desk Concerts - Audio,0,0,0,0,2,2
657562891,Landmark Theatres Q&A Podcast,0,0,0,0,1,1
657572211,"Sex Is Medicine ~ Intimate conversations about sexuality, spirituality, PLEASURE, and personal growt...",1,0,0,1,13,15
657606528,Taking Back Birth,4,0,1,2,43,50
658291823,Talking Tech,3,3,2,1,24,33
659155419,Philosophize This!,0,1,0,0,30,31
659865433,The Peace Revolution Podcast,0,0,0,1,13,14
660921339,Kim Komando Explains,2,1,1,1,51,56
661990239,The Kings Herald Show | A Sacramento Kings podcast featuring Jerry Reynolds,0,0,2,1,24,27
662052408,Torah Means Teacher: Lessons from the First Five Books of the Bible: Dr. Nahum Roman Footnick ~ Insp...,0,0,1,1,8,10
662093445,CYB3RPVNK Radio,0,0,0,1,14,15
662511611,Bhagavadgita Discourse,0,0,0,0,5,5
663123431,The What Cast,2,1,5,4,51,63
663379413,The Energy Gang,1,3,2,4,190,200
663571407,Apex Magazine Podcast,1,0,1,0,2,4
663593797,ANTIC The Atari 8-bit Podcast,0,0,0,1,45,46
663607202,The Go Diaper Free Podcast,0,0,0,1,29,30
663872027,Hillsdale Dialogues Podcast,6,2,2,5,28,43
663933566,The Marketing Companion,1,0,1,0,43,45
663939885,Latin American Spanish,1,3,2,2,14,22
664503146,The Alton Browncast,7,3,3,6,31,50
664563082,The Good Friends of Jackson Elias,0,0,0,1,39,40
664663777,Rumble Strip,0,1,1,5,145,152
665149280,Sawbones: A Marital Tour of Misguided Medicine,9,1,1,3,36,50
666811479,Vegetarian Zen,0,0,0,0,50,50
666897455,The Ensemblist,0,0,0,1,26,27
668174671,ADHD Experts Podcast,3,5,6,10,26,50
668386075,The Making Agents Rich Show with Darin Persinger & Jonathan Rivera,1,0,0,0,115,116
668541939,The 5 AM Miracle with Jeff Sanders,1,0,0,1,48,50
669085889,Canning Season®,0,0,0,6,93,99
669216566,LET IT OUT,3,4,7,4,365,383
669499379,"Tennis Quick Tips | Fun, Fast and Easy Tennis - No Lessons Required",0,0,0,1,20,21
670145385,"Blue Peg, Pink Peg",6,1,1,4,38,50
670199157,BBC Inside Science,3,3,1,0,18,25
670518089,"Project Management Podcast: Project Management for the Masses with Cesar Abeid, PMP",0,1,1,0,30,32
670630852,"The Agents of Change: SEO, Social Media, and Mobile Marketing for Small Business",0,0,0,0,50,50
670771965,AI in Business,4,0,2,3,22,31
670956932,C4 Canucks Hockey Podcast,0,0,0,0,6,6
670966237,The Torch: The Great Courses Podcast,0,1,0,1,7,9
671863400,Muscle for Life with Mike Matthews,1,0,0,2,47,50
672122575,HiPPiE WiTCH : Magick For A New Age,1,1,1,5,128,136
672249013,The JTrain Podcast,2,0,4,6,38,50
672857593,Retronauts,10,3,2,2,33,50
673008486,Razha va Niazha,2,0,0,1,6,9
673108764,News in Slow Japanese / The Podcast,0,0,0,0,3,3
673595597,The Poundcast,1,1,4,0,44,50
673883284,Read to Lead Podcast,0,0,4,6,189,199
674095278,David Sedaris: Meet the Author,0,0,0,1,1,2
675746526,Obstacle Racing Media Podcast,3,0,3,1,96,103
676135884,Yasmin Mogahed,1,0,1,0,6,8
676866176,Rolling Dice & Taking Names Gaming Podcast,0,2,1,3,44,50
676930917,Farm Land,2,2,0,2,97,103
677269882,Bitch Talk,0,0,0,0,4,4
677522835,The Handgun Radio Show,3,3,3,4,94,107
677542913,Pioneering Today with Melissa K. Norris,0,1,0,3,46,50
677568406,30 Minute Italian,3,2,0,1,19,25
677929014,Surf Splendor,4,0,6,2,136,148
678053501,Dr. Stu's Podcast,0,1,0,0,28,29
678096907,SLOW FLOWERS with Debra Prinzing,0,2,3,2,39,46
678411082,Reel Spoilers,3,0,4,4,129,140
679570743,eCommerce Fuel,0,0,0,1,93,94
679651984,"Sixers Beat: a Philadelphia 76ers, NBA Podcast",3,2,3,8,136,152
680647063,Strange Horizons,0,1,0,1,3,5
680768069,Dharmapunx NYC,0,0,1,1,27,29
680884572,The Save The Marriage Podcast,0,1,0,0,40,41
680904259,Around the NFL,51,13,12,8,416,500
681477236,F*ck Silence with Joe Walsh,10,1,1,4,34,50
682478916,War on the Rocks,3,2,4,2,39,50
682755715,Extra Hot Great: This Week In TV,10,2,2,7,130,151
684370851,5 Minutes in Church History with Stephen Nichols,0,2,1,2,66,71
685427740,Royal Caribbean Blog Podcast,1,0,1,2,130,134
685821493,Learning Spanish for Beginners Podcast,1,1,1,3,12,18
685957626,The PCOS Diet Support Podcast,0,0,0,0,3,3
686025258,Top Coach Podcast,1,0,1,1,9,12
686065962,Sea Hawkers Podcast: for Seattle Seahawks fans,5,2,2,8,206,223
686650921,Let's Go Tribe: for Cleveland Indians fans,3,1,3,2,11,20
686784798,Afrojack - JACKED Radio (Official Podcast),1,0,0,0,18,19
687089187,The Old Paths Broadcast,2,0,0,0,0,2
687141143,Joe & Charlie “Big Book Comes Alive”,0,0,1,0,11,12
687238388,Salah Bukhatir,0,0,0,0,1,1
687516909,Motorcycles & Misfits,2,0,1,1,46,50
687598126,LINUX Unplugged,5,0,1,1,28,35
687671367,The Spanish Football Podcast,2,2,1,11,156,172
687803579,Country Squire Radio,0,1,0,0,49,50
688091468,Let's Master English! An English podcast for English learners,2,1,0,0,39,42
688242106,One Shot,0,2,4,1,43,50
688328731,Let's Talk New Mexico,0,0,0,0,1,1
688649759,Castle Super Beast,9,1,1,3,36,50
689011035,The Golf Podcast Presented by Golficity,2,1,2,1,105,111
689117182,podcasts – Yarns at Yin Hoo,0,1,1,1,47,50
689372004,Veterinary Clinical Podcasts,0,0,1,1,48,50
689871918,Dr Taylor Marshall Catholic Show,39,6,10,14,431,500
689900475,The Cracked Podcast,28,3,4,2,13,50
690389135,Cricket Unfiltered,6,0,0,0,18,24
690393853,Gaming illuminaughty,3,0,1,0,46,50
690938876,Casual Fridays Podcast,2,0,0,2,46,50
693140131,The UAV Digest,0,0,1,0,38,39
694755269,Run Talk Run,0,0,0,0,7,7
694915280,FOREVER MIDNIGHT - Horror Movie Podcast.,5,3,0,0,82,90
695108281,Tricycle Talks,0,0,0,0,7,7
695137938,Bilal Assad,0,0,0,0,9,9
695139619,Saad Tasleem,0,0,0,0,1,1
695139640,Said Rageah,0,0,0,0,3,3
695268752,The Survivalist Prepper Podcast,9,3,5,1,32,50
695405811,Cyborgs: A Bionic Podcast,1,0,1,0,11,13
696010741,IKAR Los Angeles,0,0,0,0,8,8
697097422,TalentCulture #WorkTrends,0,0,0,0,8,8
698298930,The Mexican Soccer Show,0,1,0,2,31,34
698333828,Fireside Tattoo Podcast,0,0,0,0,18,18
698727774,Flite Test: Aviation - RC Planes - Multirotors,1,0,1,2,46,50
698940315,Beginner's Shiva Puja,0,0,0,0,1,1
699000974,Athlon Sports Cover 2 College Football Podcast,23,10,4,9,61,107
699723863,Ricochet Podcast,2,4,1,3,40,50
700326661,Bitesize Irish Podcast,0,0,0,1,56,57
700328970,Double Loop Podcast,1,0,0,0,4,5
700512884,Food Psych Podcast with Christy Harrison,9,4,3,0,34,50
701045710,BSD Now,0,0,0,0,11,11
702001620,Board Gamers Anonymous,0,1,0,4,18,23
702896920,Aspen Ideas to Go,3,0,1,1,16,21
703611884,The EggChasers Rugby Podcast,3,2,2,0,40,47
703720000,A Slob Comes Clean,0,1,1,0,48,50
703720228,Brains On! Science podcast for kids,1,0,1,3,45,50
703796765,Bawdy Storytelling,2,3,2,1,118,126
703889772,Revolutions,8,16,12,8,656,700
704434205,Streetwise Hebrew,0,0,0,0,50,50
704780925,We Like Shooting,8,3,7,4,426,448
705029632,Outkick The Show with Clay Travis,43,8,5,3,222,281
705355841,Completely Unnecessary Podcast,10,3,6,2,29,50
705474769,Tuesdays with Stories!,6,1,1,1,41,50
705934263,Speaking of Psychology,3,1,2,2,18,26
706061933,Lions of Liberty,3,0,3,3,179,188
706421907,The Fighter & The Kid,325,21,18,18,118,500
706518211,Expanded Perspectives,32,6,4,13,444,499
708371900,Intelligence Squared,12,5,6,5,25,53
710541646,50% Facts with Silent Mike & Jim McD,1,1,0,1,47,50
711119555,The Once And Future Nerd,1,2,1,5,41,50
711410636,On the Wind Sailing,0,2,4,4,114,124
711463982,The Stem Cell Podcast,0,0,1,0,22,23
711675943,Inquiring Minds,8,8,5,20,106,147
712266381,Alex Barker,0,0,0,1,92,93
712316884,The Popcast With Knox and Jamie,22,9,5,2,462,500
713657884,The Ripple Effect Podcast,6,1,3,2,35,47
713976627,Sea Control - CIMSEC,0,0,1,1,18,20
714087470,Bless You Boys: for Detroit Tigers fans,1,2,4,3,17,27
714341248,The Motorcycle Mentor Podcast,0,0,0,4,46,50
715483879,"The Naked Vocalist | Advice and Lessons on Singing Technique, Voice Care and Style - Chris Johnson a...",0,1,1,2,25,29
716825890,The Tom Woods Show,3,4,1,9,313,330
716831470,The Source,0,0,0,0,1,1
716979718,Mindful Mama - Parenting with Mindfulness,0,2,0,1,47,50
717070886,The History of the Early Church,1,3,4,3,25,36
717083799,Parenthood Reviews and After Show - AfterBuzz TV,0,0,1,1,11,13
717265500,The Brookings Cafeteria,1,0,1,3,12,17
717370197,Ultimate Homeschool Radio Show,0,0,0,0,1,1
717384167,Current Issues and The Constitution,0,0,0,1,1,2
717384766,The Homeschool Sanity Show,1,1,1,1,16,20
717402509,Vintage Homeschool Moms,0,0,0,0,7,7
717407884,Ear Biscuits,10,3,1,1,35,50
717428711,Industry Focus,8,9,7,9,121,154
717653288,Happen To Your Career,0,1,0,0,125,126
718158767,The Weekly Planet,6,4,2,1,487,500
718175915,Brown Vegan,2,0,0,0,46,48
718416620,Wealth Formula by Buck Joffrey,3,0,0,0,47,50
719168892,Stories for Grown-Ups,0,0,0,0,7,7
719585944,Story Pirates,1,0,0,4,45,50
720291560,Pop Shop Podcast,0,1,2,3,29,35
720796412,The eLife Podcast,0,0,0,0,2,2
721006934,Dr. Laura Call of the Day,18,1,4,0,27,50
721048994,CANADALAND,2,1,2,0,10,15
721987947,Capitalism.com with Ryan Daniel Moran,5,0,0,2,43,50
722136827,Learn Polish: Kids & Beginner's Guide for How to Speak Polish,2,0,1,0,1,4
723921422,Summit Life with J.D. Greear,1,0,0,0,31,32
724294998,Pride and Prejudice by Jane Austen,0,0,0,0,15,15
724557617,KUT Weekend,1,0,0,0,15,16
724741688,The Angry Chicken: A Hearthstone & Battlegrounds Podcast,15,7,5,7,466,500
725309051,Reiki Radio Podcast,0,1,0,0,26,27
725506148,Keeping Karlsson Fantasy Hockey Podcast,0,0,2,0,127,129
725700990,"""Walking The Floor"" with Chris Shiflett",4,1,1,4,40,50
727405149,The Adventures of Sherlock Holmes by Sir Arthur Conan Doyle,0,1,0,1,3,5
727850235,Dollars & Sense,0,0,0,0,2,2
728181536,The Return of Sherlock Holmes by Sir Arthur Conan Doyle,0,0,1,0,1,2
728293743,Curious Handmade with Helen Stewart,0,0,1,1,48,50
728393810,Free Thoughts,5,2,2,2,45,56
729136611,Miscellaneous Adventures from the World of Mike Carano,2,0,2,1,45,50
730106108,John Dalton - gently does it . . .,0,0,0,0,20,20
730231271,The Great Detectives Present Nick Carter,0,0,0,0,1,1
730239274,"Across the Pond, a Premier League Podcast",2,0,0,1,55,58
730239508,Brain Matters,0,0,0,0,33,33
730254722,Jalen & Jacoby,29,12,9,20,430,500
730331160,Ranger Danger: A Power Rangers Podcast,3,0,0,5,37,45
731738426,Blow Your Mind (season 01),0,0,2,1,8,11
732617888,"Good Day, Sir! Show, a Salesforce Podcast",1,0,0,2,35,38
732703831,The Game Design Dojo Podcast,0,0,0,4,45,49
732915228,Stuff They Don't Want You To Know,96,20,16,10,148,290
733096992,Grimms' Fairy Tales by Jacob & Wilhelm Grimm,0,1,0,2,18,21
733163012,Making Sense with Sam Harris,80,15,25,20,725,865
733196976,Houston Zen Center Dharma Talks,0,0,0,0,1,1
733300242,The Beauty Brains,4,7,5,14,170,200
733644928,Medgeeks Clinical Review Podcast,0,0,0,4,46,50
734238529,The Tariq Elite Radio Show,15,2,3,4,111,135
736102938,Art + Music + Technology,0,0,1,0,10,11
736560849,Politics by Aristotle,0,0,0,0,2,2
736701234,Mindfulness Man,0,0,0,0,2,2
737257892,"Intelligent Science, Intelligent Design",1,0,0,0,0,1
737480499,Drummer's Resource,1,0,0,1,48,50
737519403,It's All Dead - Music Podcast,0,0,0,0,5,5
738323123,China in the World,3,1,1,1,11,17
738603722,Bros Watch PLL Too - A Pretty Little Liars podcast,5,0,1,3,315,324
738786918,Bonita Radio,0,0,0,0,4,4
739369066,Plane Talking UK's Podcast,0,0,0,1,5,6
740146895,OPB's State of Wonder,1,0,0,0,0,1
740234896,TubeTalk: Your YouTube How-To Guide,0,0,0,1,12,13
740675898,Sleep With Me,132,24,26,32,784,998
741606139,The History of China,3,1,2,1,43,50
741742885,Don't Mom Alone Podcast,0,2,0,0,48,50
742393907,Modern Sewciety Podcast,0,1,0,4,95,100
742654046,Your Teen with Sue and Steph,2,0,0,0,34,36
743537890,The Overwhelmed Brain,0,1,2,2,45,50
743822914,The Dough Roller Money Podcast,1,1,2,6,90,100
744019885,The Matt Beck Podcast,0,0,0,0,8,8
744156889,"The SAP - Comedians Talk Motivation, Dating and Relationships",0,1,1,0,48,50
751574016,All Ears English Podcast,5,1,0,2,42,50
753641885,Low Pressure Podcast: The Podcast for Skiers,0,0,0,0,19,19
754700884,Sky Sports Cricket Podcast,6,1,4,1,27,39
755405884,The Art of Composing Podcast,1,0,0,1,20,22
755649884,GRE SAT Advanced English Vocabulary Podcast!,0,0,1,4,45,50
756834048,Daily Strides Podcast for Equestrians,0,0,1,0,28,29
757346885,The PosCast with Joe Posnanski & Michael Schur,1,2,2,3,76,84
757953988,The Proverbs 31 Ministries Podcast,0,0,0,1,2,3
758519884,Hemmings Collector-Car Radio,0,0,0,0,1,1
762790918,The Logo Geek Podcast,0,0,0,1,37,38
762922035,Fighting In The War Room: A Movies And Pop Culture Podcast,10,8,11,27,444,500
763557132,The Disney Story Origins Podcast,1,1,5,8,185,200
763839191,The Millionaire Matchmaker Love Report with Patti Stanger,0,0,0,1,2,3
765048884,DaZPod | German as a Second Language | Learning German - language and culture,0,0,1,0,15,16
767016946,Talk Is Jericho,70,8,15,14,392,499
767626637,Psychology In Seattle Podcast,8,1,2,4,35,50
768142013,The Promised Podcast,1,1,2,4,100,108
769189585,Coding Blocks,1,2,1,7,479,490
772127662,The Pulse,0,0,3,5,37,45
773888088,Arrested DevOps,1,0,0,0,24,25
774383607,Mom and Dad Are Fighting | Slate's parenting show,4,5,11,7,23,50
775143271,Talking Headways: A Streetsblog Podcast,1,0,2,0,20,23
775943089,The Same 24 Hours,1,1,0,2,46,50
778246137,The Prog Report,0,0,0,0,4,4
778339885,Zero To Travel Podcast,3,9,2,8,173,195
778731204,"FoodTruckr School - How to Start, Run and Grow a Successful Food Truck Business",0,0,0,1,28,29
779048354,Cheap Heat with Peter Rosenberg,63,17,9,9,401,499
780628152,Compleatly Beatles,2,2,7,6,33,50
782571888,Strictly Anonymous,7,6,3,3,31,50
783201244,Can't Bowl Can't Throw Cricket Show,0,0,0,1,7,8
784600888,The New Yorker: Poetry,1,0,1,2,19,23
784889506,The BOB & TOM Show Free Podcast,4,1,4,3,38,50
785523907,The Lucid Dreaming Podcast,1,1,0,0,12,14
787295030,Super Agents Live- Selling Real Estate,2,1,1,1,10,15
788038884,Oral Argument,1,1,0,1,16,19
788236947,Song Exploder,3,3,4,21,469,500
788777254,"Hank Watson's Garage Hour - Cars, Trucks, Beers & Guns",0,0,0,0,3,3
788816283,Binge Dieting   Learn how to change your relationship with Eating,0,0,0,0,50,50
788893946,"A History of Europe, Key Battles",2,0,1,5,42,50
789935889,Primal Blueprint Podcast,6,3,9,8,24,50
790315802,Anthony Metivier's Magnetic Memory Method Podcast,3,0,1,9,37,50
790487079,Sword and Scale,207,63,57,36,354,717
790864884,Daily Tech News Show,5,4,5,5,463,482
791126682,Wellpreneur,0,0,0,0,63,63
791316884,Real Estate Investing for Cash Flow with Kevin Bupp,0,0,0,2,98,100
792338939,"Epicenter - Learn about Crypto, Blockchain, Ethereum, Bitcoin and Distributed Technologies",2,1,0,6,63,72
792424937,House of #EdTech,0,0,1,0,49,50
792508884,Conspiracy Theories & Unpopular Culture,54,12,16,22,396,500
792555885,The One You Feed,4,4,1,2,39,50
792748965,Theater People,1,0,2,5,142,150
793318279,Supernatural: The Crossroads,0,1,0,6,35,42
793330058,Personality Hacker Podcast,2,1,1,0,46,50
793853822,Beekeeping,0,0,0,0,1,1
794030859,The James Altucher Show,2,0,0,1,47,50
794058155,Universe Today podcasts with Fraser Cain,0,0,0,0,11,11
794200252,My Favorite Album with Jeremy Dylan,0,0,1,2,25,28
794234509,DLC,9,1,3,2,35,50
794859541,88 Miles Per Hour Podcast,1,0,0,0,23,24
795456691,Modern Life Insurance Selling Podcast,0,0,0,0,25,25
795842083,Making Biblical Family Life Practical,0,0,0,0,19,19
796183168,The Office of Rabbi Sacks,0,0,0,1,18,19
796333191,Abdul Nasir Jangda,0,0,0,0,1,1
796432735,Psychiatry,0,0,1,1,0,2
796478792,Bucknuts Morning 5,8,3,7,7,253,278
796512132,Fedde Le Grand - Darklight Sessions,1,0,0,0,6,7
797055444,The Plant Report- Every Plant Has A Story,0,2,0,0,5,7
797248294,Off The Bench with Heidi St. John,13,3,2,0,482,500
798960436,Why Are People Into That?!,2,1,3,1,26,33
799131292,Brakeing Down Security Podcast,1,0,0,1,22,24
799239198,AviatorCast: Flight Training & Aviation Podcast,0,1,1,1,47,50
800198898,Wrestling Compadres,9,3,1,3,211,227
801493885,Swim Coaches Base,0,1,0,2,7,10
802103884,The Geology Flannelcast,2,1,2,0,36,41
803955629,The Muslim Life Hackers Podcast: Personal Growth | Leadership | Legacy Building | Life Hacks | Islam,0,0,0,1,7,8
803978236,The Savvy Psychologist's Quick and Dirty Tips for Better Mental Health,3,6,2,5,34,50
804287380,True Blue LA: for Los Angeles Dodgers fans,1,0,0,1,4,6
804926728,Coding 101 (Audio),0,0,0,0,3,3
806349794,The Creative Writer's Toolbelt,0,0,0,2,22,24
807794527,Tales of Tamriel | An Elder Scrolls Online Podcast,1,1,3,3,122,130
808014240,Rocketship.fm,0,0,0,0,86,86
808235697,"10,000 HOURS",0,1,1,0,17,19
808419858,The Painting Experience Podcast,0,0,0,1,1,2
808511892,The Girl Next Door Podcast,1,1,2,1,179,184
808792827,History of the Earth,0,0,0,0,18,18
809264944,Criminal,148,60,52,72,1548,1880
809912920,NJ 101.5 News,1,1,1,0,2,5
810268320,The KYLO Show,0,0,0,0,17,17
811010016,Me & Paranormal You with Ryan Singer,3,1,2,6,99,111
811105481,The BizChix Podcast:  Female Entrepreneurs | Women Small Business | Biz Chix,0,1,1,0,48,50
812719884,The Mexico Podcast: History & Present,3,0,0,0,23,26
813620752,Good Show,0,0,1,0,6,7
814025804,Sex Gets Real with Dawn Serra,8,2,3,2,35,50
814067846,The Kitchen Sisters Present,1,4,3,4,67,79
814550071,The Moment with Brian Koppelman,21,10,13,21,215,280
814564469,Park Avenue Podcast,0,0,0,0,4,4
814715884,Girl Boner Radio,0,0,0,0,50,50
815118471,The Nursing Crash Cart,0,0,1,0,14,15
815214539,The KrisAnne Hall Show,3,2,1,0,35,41
815582351,The Lively Show,18,15,13,6,414,466
816329544,Post Show Recaps: TV & Movie Podcasts from Josh Wigler and Friends,7,4,4,5,125,145
816803613,Geek History Lesson,14,16,15,17,420,482
817315462,Saud Al-Shuraim,0,0,0,0,1,1
817422023,Locked On Fantasy Basketball – Daily NBA Fantasy Basketball Podcast,9,2,2,7,480,500
817756935,The Children's Book Podcast,0,0,1,1,48,50
818198322,FoundMyFitness,3,2,6,1,38,50
818477885,Whiskey Knife Fight,2,0,1,1,17,21
818817570,Total Party Kill,1,0,2,0,39,42
818930816,ELISE GETS CRAFTY,0,0,4,5,61,70
820806390,Future Thinkers,2,2,0,1,57,62
820889267,Achieve Your Goals with Hal Elrod,2,1,1,3,43,50
821720737,PodCraft | Learn the Art of Podcasting in Focussed Seasons,1,0,1,0,17,19
821746377,THE BRENDON SHOW,0,0,0,1,49,50
822327403,League Rundown - A League of Legends Esports Podcast,6,6,2,3,34,51
822334245,Good Beer Hunting,1,1,3,4,43,52
823604747,Yasser Al Dossari,0,0,0,0,1,1
824470090,Unauthorized Disclosure,2,6,0,0,21,29
825614458,The Cardone Zone,13,6,4,3,174,200
825708806,The World Crypto Network Podcast,5,0,0,0,11,16
826194407,Decades of Horror | Movie Reviews of 1970s Classic Horror Films,0,0,1,2,11,14
826420969,Exponent,10,8,5,7,70,100
827255972,Sailor Moon News Roundup,0,0,0,0,6,6
827471484,Front End Chatter,0,0,0,0,26,26
827905050,Happy Sad Confused,12,5,4,10,97,128
827972274,Join Us in France Travel Podcast,2,1,0,6,147,156
828454298,Short Time Wrestling Podcast,0,1,0,2,47,50
828553605,Classic Movie Reviews,0,2,0,2,9,13
828811790,Brand You Personal Branding,0,0,0,0,50,50
829017352,Teamsters,0,0,0,1,3,4
829924939,Coach Glass Podcast,0,3,0,0,47,50
830593115,The Cyberlaw Podcast,4,2,1,3,41,51
830803893,Critical Care Practitioner,0,0,0,0,1,1
831100527,SAYER,3,0,1,2,44,50
831310808,Couple Friends,1,1,1,0,47,50
832350989,Talk Nerdy with Cara Santa Maria,7,7,3,4,182,203
832481615,CFO THOUGHT LEADER,2,1,2,2,51,58
832885584,Real Estate Rockstars,12,6,8,12,162,200
833706616,Part Of The Problem,5,0,3,2,40,50
834173190,Revision Path,0,0,0,5,78,83
834314596,Retirement Answer Man,2,1,1,2,194,200
834368356,Restaurant Unstoppable with Eric Cacciatore,1,0,1,1,47,50
834515877,Guided Sleep Meditations,2,1,2,5,40,50
834629128,Savvy Painter Podcast with Antrese Wood,0,1,1,2,196,200
834735077,The Legendarium,2,4,2,3,71,82
837829637,Pop Fashion,3,0,0,1,89,93
838315493,RotoWire Fantasy Baseball Podcast,4,8,11,15,164,202
839754350,The Erasable Podcast,0,0,1,1,23,25
840193021,"Wealth, Power & Influence with Jason Stapleton",28,8,8,2,104,150
840242536,Going Beyond Ministries with Priscilla Shirer,0,0,0,3,38,41
840308131,Aviation Week's Check 6 Podcast,16,10,16,6,4,52
840534227,Relationship Advice,3,3,4,2,38,50
840848785,Gnostic Teachings Podcast,1,0,0,0,26,27
840986946,No Such Thing As A Fish,8,4,8,24,592,636
841758860,Sex with Strangers,0,0,1,1,48,50
841981906,The Bunker,6,1,1,2,40,50
842121985,Power Your Parenting: Moms With Teens,0,0,1,2,30,33
842419860,AFL Fantasy with The Traders,4,0,2,3,79,88
842593579,Futility Closet,3,5,4,2,36,50
843566797,YouTube Creators Hub,0,1,1,2,46,50
844102142,"The Secret To Success with CJ, Karl, Jemal & Eric Thomas",0,0,0,1,14,15
844136560,Business of Photography Podcast,0,0,0,1,20,21
844386407,Dynasty Nerds Podcast | Dynasty Fantasy Football,14,10,8,6,462,500
845287058,KUT » Two Guys on Your Head,2,0,1,0,21,24
847236521,XoneBros: A Positive Gaming & Xbox Series X Community,2,1,4,1,42,50
847606288,JUMP with Traveling Jackie,2,1,2,2,125,132
847612214,Wheeler Dealer Radio - A Ridiculous Tottenham Hotspur Podcast,6,2,2,0,31,41
848693430,Apartment Building Investing with Michael Blank Podcast,0,0,1,1,91,93
848794591,"The Performance Podcast | Strength Training, Olympic Weightlifting, Performance, Fitness, Speed  | W...",1,0,0,0,49,50
849145968,Thinking about It,0,0,0,0,1,1
849326609,ESPN FC,55,32,31,32,143,293
849365903,"Dating Tips, Attracting Women & Dating Advice For Men Podcast! | Win The Woman",2,0,0,0,3,5
849400337,ADHD reWired,2,0,0,1,47,50
849766419,The Slow Ride: A Cycling Podcast,2,3,3,11,174,193
849772346,Real Estate Coaching Radio,5,10,6,1,28,50
849992269,Plane Safety Podcast - Safety from the flightdeck,0,0,0,0,12,12
850054474,FutureSox Podcast,1,0,0,0,3,4
850148806,Emperors of Rome,0,1,1,2,46,50
850161954,Azeroth Roundtable: A World of Warcraft Podcast,12,1,0,0,37,50
852235014,Podigious: A Digimon Adventure 2020 Podcast,0,0,1,1,38,40
852332047,Wired To Hunt Podcast,6,2,6,9,477,500
852374699,The Secrets of Mathematics,0,0,0,0,2,2
852714222,Submarine Sea Stories | Ever wonder what it's like to spend the cold war under water with 100 other ...,0,0,0,1,106,107
853118658,What's Up Fool? Podcast,1,0,0,1,48,50
853868332,"FREE Ringtones, Funny Ringtones by Ringtone Mafia",4,0,0,0,6,10
853941025,Renegade Radio with Jay Ferruggia: Fitness | Nutrition | Lifestyle | Strength Training | Self Help |...,0,0,0,0,50,50
854094289,Random Thoughts,0,0,0,0,19,19
854521079,Into the Nexus: The Heroes of the Storm Podcast,3,6,4,4,287,304
854634399,Daf Yomi Shiur by Rabbi Shalom Rosner,0,0,0,1,5,6
854667212,Hamza Tzortzis,0,0,0,0,1,1
854873991,BlizzPro's Westmarch Workshop - A Diablo 3 Podcast,0,0,0,1,44,45
855749951,RuPaul: What's The Tee with Michelle Visage,10,1,0,2,37,50
857094979,The Dealer Playbook,1,1,0,2,58,62
857888327,Sigma Nutrition Radio,3,2,1,0,44,50
858218890,"People Behind the Science Podcast - Stories from Scientists about Science, Life, Research, and Scien...",0,0,1,0,190,191
858730207,The Daily Evolver,0,0,0,0,12,12
858864457,"The Love, Happiness and Success Podcast With Dr. Lisa Marie Bobby",1,3,0,0,65,69
858972561,The My Wife Quit Her Job Podcast With Steve Chou,1,0,0,1,48,50
859302318,Westerns OTR,0,0,0,0,1,1
859529852,"The Turkey Hunter Podcast with Andy Gagliano | Turkey Hunting Tips, Strategies, and Stories",14,4,1,1,30,50
860053842,KUT » In Black America,3,0,0,2,6,11
860230908,Kevin Hates Hip-Hop,0,0,0,0,45,45
860504144,Geekin' On WDW Podcast | A Family Friendly Community of Walt Disney World Fans | Travel tips on reso...,3,1,1,3,166,174
861578148,Fargo - An Unofficial Podcast,8,5,2,2,79,96
861902852,In Penny Stock | Stock Trader & Teacher / How To Trade Stocks / Stock Market / Bitcoin & Crypto,4,2,4,3,30,43
862258051,Jay & Miles X-Plain the X-Men,9,10,11,4,166,200
862312494,Cosmic Gate: WYM Radio,0,0,0,0,8,8
862717788,The Brilliant Idiots,10,5,6,2,27,50
863338913,Texas Standard,1,2,2,2,13,20
863405897,Long Riders Radio,0,0,1,0,10,11
863870423,Fargo Reviews and After Show - AfterBuzz TV,5,3,3,1,13,25
863897795,The Tim Ferriss Show,245,119,154,217,3381,4116
864068000,The Manwhore Podcast: A Sex-Positive Quest,1,1,0,3,45,50
864106683,The Psychedelic Secret,1,0,0,0,2,3
866031519,Mind Body Musings,5,1,1,4,233,244
866415483,Meditations by Marcus Aurelius,0,0,0,0,1,1
866426666,The Critique of Pure Reason by Immanuel Kant,1,0,0,0,0,1
866573022,Research Perch,0,0,0,0,2,2
866633946,Kabbalah for Everyone,0,0,1,1,1,3
867199020,Amazing Spider-Talk: A Spider-Man Podcast,0,0,0,1,31,32
867219182,MtnMeister,1,1,0,1,109,112
867430953,Walkabout the Galaxy,1,0,2,1,17,21
867434072,CLO Level 1 Lessons,0,0,2,1,3,6
867690885,"Star Singer; Voice Lessons, Singing Lessons and Tips About Singing",1,0,1,1,29,32
867746901,Bare Naked Agent- Selling Homes Today- Timely Topics!!!,0,0,0,0,19,19
868068396,The TLS Podcast,0,0,2,1,32,35
868119061,The DIS Unplugged: Universal Edition - A Weekly Discussion About All Things Universal Orlando,8,3,5,7,111,134
868388885,The Woody Show,6,2,1,0,41,50
868397885,All TWiT.tv Shows (Video),0,0,0,0,3,3
869190025,"Right to R.E.A.L. Love: Advice for Christians on Dating, Relationships, Faith and Sex",1,1,2,2,304,310
869377733,Around the House with Eric G®,1,0,0,0,6,7
869415596,Do You Need A Ride?,1,0,0,0,49,50
869421445,Leading Saints Podcast,0,1,2,2,73,78
869428407,LifeSpa: Ayurveda Meets Modern Science,0,1,0,1,10,12
869539792,The Potters Cast | Pottery | Ceramics | Art | Craft,0,0,0,0,100,100
870065983,Bald Move Prestige,16,8,2,1,58,85
870077774,The Masonic Roundtable - Freemasonry Today for Today's Freemasons,2,0,0,1,23,26
870095971,God Centered Success With Mia Rene,5,1,1,3,190,200
870178510,Read-Aloud Revival,0,0,3,1,46,50
870239631,The Life Coach School Podcast,15,3,5,2,175,200
870316544,The Trucking Podcast,3,0,1,1,25,30
870332340,Be Wealthy & Smart,0,0,1,0,49,50
870632288,Pencil Kings | Inspiring Artist Interviews with Today's Best Artists,0,0,1,2,39,42
870688022,"Death, Sex & Money",25,17,14,20,424,500
870958144,"Legendary Life Podcast: Lose Weight, Fight Disease & Live A Longer, Healthier Life",0,0,0,0,50,50
871125966,SAGE Psychology & Psychiatry,0,0,1,0,0,1
871126157,SAGE Sociology,0,0,0,0,1,1
871227959,Bobby Owsinski's Inner Circle Podcast,0,0,0,1,17,18
871241283,This Anthro Life,0,1,1,0,15,17
871640798,Screw The Nine to Five,0,0,0,0,50,50
871956926,Caught Offside,5,2,3,7,483,500
872329779,Porn Free Radio,0,1,0,0,49,50
874152651,The Audio Guide to Babylon 5,0,6,0,1,14,21
874174278,Regret Labs Podcast: Science | Comedy | Humility,0,0,0,2,13,15
874790107,Ginger Runner LIVE,1,0,0,2,26,29
875159294,Chrystal's Chronicles,0,0,0,6,207,213
875246560,Tips for Lawyers Podcast,0,0,0,0,6,6
876041079,BioTech Nation Radio Podcast,0,0,0,0,2,2
876190753,The RPG Academy,0,0,0,0,50,50
876424161,Radio Cherry Bombe,2,0,1,5,44,52
876523888,Slate Money,25,22,22,28,103,200
877672766,Talkhouse Podcast,1,0,1,1,14,17
878268013,Daily Easy English Expression Podcast,1,1,0,0,48,50
879106372,BNI & The Power of One,0,1,0,0,34,35
879249120,Bhagavad Gita Chapter 01,0,0,0,0,1,1
879249123,Bhagavad Gita Chapter 02,0,0,0,0,1,1
879249179,Bhagavad Gita Chapter 09,0,0,0,0,1,1
879266203,Brhadaranyaka Upanishad,0,0,0,0,1,1
879271196,Katha Upanishad,0,1,0,0,0,1
879281888,FOAMcast -  Emergency Medicine Core Content,0,0,0,1,31,32
879310835,Homesteady - Stories of Living off the Land,1,6,8,8,172,195
879507964,The Anjunadeep Edition,0,0,1,1,48,50
879580306,The Marriage Podcast for Smart People,1,0,4,2,104,111
879629380,Marketing Online,1,0,0,0,26,27
879923939,RunBuzz Running Podcast,2,1,1,0,95,99
880227937,The Mac Observer's Daily Observations,10,5,1,1,16,33
880338171,Jajam Shlomo (Sally) Zaed,0,0,0,0,1,1
880741976,The Happy Hour with Jamie Ivey,5,4,10,7,474,500
880791662,Real Ghost Stories Online,82,45,33,26,314,500
880800097,Reality TV RHAP-ups: Reality TV Podcasts,7,1,3,7,123,141
880800100,Bachelor RHAPups Podcast: A Reality TV RHAPups Podcast,14,12,11,4,86,127
880812994,CarStories,4,2,1,2,32,41
880837011,No Laying Up - Golf Podcast,25,11,15,16,433,500
880847837,Ultima Final Fantasy | The Ultimate Final Fantasy Podcast,7,5,4,8,172,196
880903087,Fix It Home Improvement,3,5,10,2,30,50
880972768,The W. Edwards Deming Institute® Podcast,0,0,0,0,2,2
881260378,Radio Fitness Revolucionario,0,0,0,0,8,8
881373702,Eatweeds Podcast: For People Who Love Plants,0,0,0,0,3,3
881487725,Call Your Girlfriend,31,20,24,24,401,500
881688016,Diego Dreyfus,0,0,0,1,26,27
881874231,The Accidental Wrestling Fan,0,0,0,0,9,9
882018353,Contractor Success Map with Randal DeHart | Contractor Bookkeeping And Accounting Services,0,0,1,1,2,4
882529464,Copeland Coaching Podcast,0,1,0,0,23,24
883011006,Money For the Rest of Us,10,7,5,5,173,200
883308059,Gilbert Gottfried's Amazing Colossal Podcast,5,1,4,6,84,100
883474810,The Reloading Podcast,7,5,3,3,73,91
883679859,I Love Learning Chinese,0,0,0,1,18,19
884196280,Eat the Rudecast - A Podcast about Hannibal Lecter,0,0,0,2,8,10
884362991,The Audible with Stew & Bruce: A show about college football,19,9,10,10,133,181
884385830,Inside EMS,0,1,0,5,10,16
884602488,The Honest Real Estate Agent |  Sales and Marketing Tips for Realtors | And Much More!,0,0,0,1,58,59
884643408,Happy English Podcast,0,0,0,3,21,24
884682903,Meeple Nation Board Game Podcast,0,0,0,1,7,8
885246231,"""We Do Science"" - The Performance Nutrition Podcast",0,1,1,0,13,15
885878586,The State of the Scene (SOTS Podcast),3,1,0,0,27,31
885960517,Guys We F****d,1,0,0,0,49,50
886009669,Reveal,0,0,1,0,49,50
886538772,The Wellness Mama Podcast,1,0,0,0,49,50
886563476,Brilliant Business Moms with Beth Anne Schwamberger,0,1,1,2,96,100
886749092,100 Near Death Experiences,2,2,1,2,2,9
886930049,Thinking LSAT,4,0,1,2,43,50
887026695,American Fashion Podcast,0,2,1,1,22,26
887248233,The Pedalshift Project: Bicycle Touring Podcast,0,0,0,1,65,66
887424539,GFNY Cycling,0,0,0,0,1,1
887541487,The Unschooling Life,0,0,0,0,10,10
887584913,Quantum Physics I,0,0,0,0,3,3
887608347,The Challenge RHAP-up | Rob has a Podcast,14,7,10,8,461,500
887845353,That Sober Guy Podcast,9,2,2,0,37,50
887887351,The Clever Cookstr's Quick and Dirty Tips from the World's Best Cooks,0,3,1,0,2,6
888135469,The Stories of Mahabharata,1,1,8,11,96,117
888637335,Friendly Atheist Podcast,19,6,9,13,235,282
889419878,PleasureTown,1,0,2,9,78,90
889671983,"The SDR Show (Sex, Drugs, & Rock-n-Roll Show) w/Ralph Sutton & Big Jay Oakerson",1,0,0,0,49,50
890164468,Octane Personal Training with Jason Benavides,0,0,0,1,49,50
890348705,Data Skeptic,6,12,9,9,75,111
890660610,REBEL Cast,0,0,0,0,4,4
891079773,The Dental Hacks Podcast,1,1,0,1,47,50
891143708,Sow Edible  Podcast,0,1,1,2,95,99
891802835,"Chasing Tone - Guitar Podcast About Gear, Effects, Amps and Tone",3,2,5,3,37,50
891811868,Halo Podcast Evolved,1,1,0,3,20,25
892082003,Relentless Health Value,0,0,0,0,32,32
892096352,Obstacle Dominator,5,5,5,4,50,69
892129995,Adventure Rider Radio Motorcycle Podcast,0,1,0,0,49,50
892536753,Radio Westeros ASoIaF Podcasts,0,0,1,2,160,163
892815277,NPK Hydroponics Live,0,0,0,0,2,2
892868691,Open Air with Cheri Huber,0,0,0,0,2,2
892964589,True Blood Authority,0,1,0,0,45,46
893003802,Pod Van Dam: A Wrestling Adjacent Podcast,1,0,0,0,15,16
893008309,Ask the Expert,0,0,0,0,3,3
893008561,The Simpsons Show,14,18,8,16,144,200
893023554,Science Fiction Film Podcast (2019),7,5,1,4,164,181
893035230,Teaching in Higher Ed,1,1,0,5,43,50
893412458,Adventure of The Month - Kids and Children,4,0,3,0,11,18
893420106,Legend of the Innkeeper : A Hearthstone Podcast for Casual Players,2,1,0,1,46,50
893659575,Barbell Life,0,0,0,2,27,29
893666386,TG Geeks Webcast,0,0,0,0,5,5
894200695,Move Your DNA with Katy Bowman,0,2,1,1,46,50
894243371,History Of The Great War,0,2,1,3,44,50
894353107,Earbud Theater,0,0,0,0,50,50
894712811,The Mating Grounds Podcast,4,4,2,1,39,50
894816555,TWiT Bits (Audio),0,0,0,0,2,2
894816641,TWiT Bits (Video),0,1,0,0,1,2
895182879,We Do: A Watchmen Podcast,8,6,6,4,150,174
895509175,APA Journals Dialogue,0,0,3,0,0,3
895679186,The Curious Couple,2,1,1,2,33,39
895902493,The Productive Woman,0,1,2,1,46,50
895918183,Help Me Be Me,1,0,0,2,47,50
896153632,Radical Personal Finance,31,14,7,7,141,200
896361045,Seincast: A Seinfeld Podcast,9,4,7,12,393,425
896907322,Jewels from the Crown: for Los Angeles Kings fans,2,0,0,0,0,2
897260941,Big Seance: My Paranormal World,2,0,0,0,72,74
897327904,The Love and Respect Podcast: Relationships | Marriage | Theology | Psychology,1,1,3,4,172,181
897720614,The Eddie Trunk Podcast,10,4,7,3,26,50
897935770,Nora En Pure - Purified Radio,0,0,0,0,44,44
898023861,The Command Zone,0,2,3,0,45,50
898457614,The Audio PANCE and PANRE Physician Assistant Board Review Podcast,0,0,1,1,14,16
898520724,The Mixology Talk Podcast: Better Bartending and Making Great Drinks,0,0,1,1,33,35
898635643,Rock & Metal Combat Podcast,2,0,0,2,46,50
898873166,Ask Iliza Anything,3,0,0,1,45,49
899009517,The Trauma Therapist,1,0,4,2,43,50
899189559,Rotoviz Radio,7,3,2,16,472,500
899369092,DucksNPucks Podcast,4,2,2,1,23,32
899560930,Trust and Believe with Shaun T,0,0,2,1,47,50
899632430,5 Minute Biographies,0,1,0,2,20,23
900015782,The Cult of Pedagogy Podcast,1,0,1,1,47,50
900096241,Dhamma Discourse,0,0,0,0,1,1
900208604,Real Ass Podcast,5,0,0,1,44,50
900763980,Shopify Masters | The ecommerce business and marketing podcast for ambitious entrepreneurs,3,3,4,2,88,100
901453417,Everyday Driver Car Debate,2,0,3,0,45,50
902067712,BYU Sports Nation,5,0,1,2,26,34
902460252,Nourish Balance Thrive,1,0,0,0,49,50
902519462,Arizona Diamondbacks Podcast,0,1,0,0,4,5
902519775,Atlanta Braves Podcast,1,0,1,0,2,4
902521832,Kansas City Royals Podcast,0,0,0,0,3,3
902525259,Phillies Backstage with Brazer and Burgoyne,0,1,1,1,3,6
902679542,Dungeon Master's Block,3,0,0,1,46,50
902792476,United Hour,0,0,0,0,5,5
902813725,X-Men: The Audio Drama,4,0,1,2,33,40
903397136,Detroit Bad Boys: for Detroit Pistons fans,0,0,1,1,10,12
903433534,The Liturgists Podcast,39,18,14,18,369,458
903437872,A History of Philosophy by Dr. Arthur F. Holmes,0,0,0,2,5,7
903505596,The Auto Detailing Podcast,2,0,0,3,45,50
903615429,Brant & Sherri Oddcast,1,0,1,2,258,262
903684889,QSO Today Podcast - Interviews with the leaders in amateur radio,0,0,0,1,16,17
903691746,Rotary Wing Show - Interviews from the Helicopter Industry,0,1,0,0,14,15
903699599,Thus Spake Zarathustra: A Book for All and None by Friedrich Nietzsche,0,0,0,0,1,1
903871206,The Flipping 50 Show,1,1,0,2,42,46
904012068,"The Struggle Bus: Self-Care, Mental Health, and Other Hilarious Stuff",1,2,2,3,42,50
904025246,Best Real Estate Investing Advice Ever,4,2,0,6,188,200
904197267,Home Front,2,1,0,1,10,14
904433031,The Blue Testament: for Sporting KC fans,3,1,1,2,2,9
904482448,Boop,1,0,0,2,16,19
904509526,Case Interview Preparation & Management Consulting | Strategy | Critical Thinking,0,1,0,0,31,32
905054765,The Jeff Nippard Podcast,1,0,0,5,44,50
905138487,WE DON'T DIE® Radio Show with host Sandra Champlain,1,0,2,0,71,74
905145937,Blood Brothers Horror Podcast,0,0,2,0,8,10
905148458,The Burning Couch,0,0,0,0,13,13
905155742,The Jasta Show,3,3,2,1,41,50
905596672,a ModelersLife,1,0,0,0,24,25
905962218,Behind the Steel Curtain: for Pittsburgh Steelers fans,3,3,3,4,44,57
906249753,The Inside Winemaking Podcast with Jim Duane,1,1,1,2,45,50
906357429,Coroner Talk™ | Death Investigation Training | Police and Law Enforcement,6,1,2,1,40,50
906392923,Back To My Garden - Discover Your Passion For Gardening,1,0,1,0,24,26
906463114,From the Front Porch,10,13,7,10,160,200
906522054,Sustainable Dish Podcast,3,0,1,2,22,28
906576942,The Girlfriend Doctor w/ Dr. Anna Cabeca,0,0,0,0,32,32
907106474,BLACK ENTREPRENEUR BLUEPRINT,2,1,1,2,101,107
907109101,Beating The Book with Gill Alexander,7,2,2,3,63,77
907162688,Nature Bats Last,0,0,0,0,3,3
907175322,Marvel Cinematic Universe Podcast: WandaVision,14,5,6,4,311,340
907466068,Outlander Cast: The Outlander Podcast With Mary & Blake,12,8,6,24,398,448
907839868,The Highly Sensitive Person Podcast,0,1,0,1,48,50
907990904,The Future of Work With Jacob Morgan,1,1,0,3,66,71
908092216,Stephen King Cast,5,1,6,12,176,200
908133189,Lead Through Strengths,0,1,0,1,120,122
908151208,The World Wanderers Podcast,23,7,2,4,105,141
908153168,The Anxiety Coaches Podcast,2,2,3,1,42,50
908407811,Men In Blazers,14,8,11,11,306,350
908481520,Analog(ue),2,0,3,2,37,44
908502853,Stock Trading University,1,0,1,2,12,16
908673018,The HP Outdoors Waterfowl Podcast,2,2,1,6,456,467
908806755,Climate Connections,1,0,0,1,5,7
908834698,Celtics Beat,4,3,5,7,270,289
909109652,Connected,9,4,0,2,55,70
909552816,Wolf 359,0,0,0,1,49,50
909682404,The College Prep Podcast,0,0,0,4,46,50
909705390,Jenna & Julien Podcast,0,0,0,0,50,50
909813658,Informed Pregnancy Podcast,5,2,0,2,41,50
909849787,"Scarlet Lovella: BDSM, Fetish and Sexuality",0,0,0,0,12,12
910273945,The Simple Sophisticate - Intelligent Living Paired with Signature Style,2,4,3,3,38,50
910631883,The Official Outlander Podcast,4,11,16,8,76,115
910736663,Dark Winter Nights: True Stories from Alaska,0,0,0,1,2,3
910956515,Outdoor Radio,0,0,0,0,3,3
910990031,Build Your Tribe | Grow Your Business with Social Media,2,1,1,2,194,200
911042029,"The Chalene Show | Diet, Fitness & Life Balance",2,0,0,1,47,50
911502027,Ask The Health Expert,0,1,0,2,47,50
911777602,Clapcast from Claptone,0,0,0,0,22,22
911802605,Film Photography Podcast,1,1,2,1,35,40
911845097,So Wizard Podcast,0,0,0,0,131,131
911904779,The AuburnSports.com Rundown,0,0,0,1,8,9
911911845,Bruins Beat,2,0,1,0,25,28
912158581,Jungianthology Podcast,0,0,0,2,12,14
912159660,Mountain Cloud Zen Podcasts,0,0,0,0,3,3
912190084,The Positive Psychology Podcast - Bringing the Science of Happiness to your Earbuds with Kristen Tru...,0,0,0,4,40,44
912241032,Dogman Encounters Radio,1,2,6,11,51,71
912366443,Boomerang,0,0,0,1,0,1
912753163,The Carey Nieuwhof Leadership Podcast: Lead Like Never Before,1,2,5,10,482,500
912787200,PM Point of View,0,0,0,0,6,6
913403767,Multiamory,0,0,1,4,45,50
913414044,The Productivityist Podcast,1,2,1,2,25,31
913420638,The Functional Medicine Radio Show With Dr. Carri,1,0,0,1,23,25
913491428,Tel Aviv Review,1,1,0,3,37,42
913714358,The PFF NFL Podcast,21,7,12,9,451,500
913805339,StartUp Podcast,32,24,14,13,117,200
913840678,Mastering Marriage:  Marriage Advice & Coaching | Destroying Divorce | Mend Our Marriage,1,0,0,4,45,50
914065708,The Laura Ingraham Show,20,0,3,2,25,50
914088438,The Salesforce Admins Podcast,3,1,1,1,46,52
914145316,The Incomparable Radio Theater,1,0,0,1,14,16
914294478,"It's About Time - A time-travel comedy, modern audio drama",1,1,0,6,42,50
914337302,Evolution Talk,1,1,0,3,50,55
914356499,Economics Detective Radio,2,0,2,0,8,12
914371573,Warrior Life - Modern Combat & Survival | Tactical Firearms | Urban Survival | Close Quarters Combat...,10,7,5,4,66,92
914691565,London Is Blue - Chelsea FC Soccer Podcast,5,2,3,6,484,500
914959979,Clear Your Clutter Inside & Out,3,4,3,1,36,47
915145351,The Contracting Coachcast: Construction Business Improvement,0,0,0,0,11,11
915355770,Organize 365 Podcast,2,2,4,0,42,50
915461096,Secrets of Doctor Who,0,0,0,1,29,30
915544088,NFL: Move the Sticks with Daniel Jeremiah & Bucky Brooks,17,6,5,19,453,500
915782694,PreMarket Prep,2,1,0,0,3,6
916244917,The MMQB NFL Podcast,73,15,18,28,207,341
916273527,Imaginary Worlds,3,3,7,2,185,200
916341600,Earth to Humans!,0,0,0,1,20,21
916375730,The Byron Chronicles –,1,0,0,2,17,20
916418648,Speakeasy - A Boardwalk Empire Podcast,0,0,0,1,22,23
916463101,Money Tree Investing,9,3,1,0,60,73
916567640,Mountain Bike Radio,6,2,6,6,100,120
916682724,Where My Mom's At? w/ Christina P.,5,1,0,1,43,50
916907356,Dentistry Uncensored with Howard Farran,0,1,1,1,39,42
916927819,"The SaaS Podcast - SaaS, Startups, Growth Hacking & Entrepreneurship",0,0,0,0,50,50
917112900,The Kitchen Counter - Home Cooking Tips and Inspiration,0,0,0,2,42,44
917406066,History Goes Bump Podcast,5,1,1,2,41,50
917429748,The Blacklist Exposed,0,0,2,1,80,83
917453719,Fantasy Footballers - Fantasy Football Podcast,13,1,4,3,479,500
917516163,The Poker Coaching Podcast with Jonathan Little,0,3,0,3,44,50
917918570,Serial,670,105,160,145,1205,2285
918152703,Upgrade,11,4,3,2,48,68
918253966,Little Sprigs Podcast,0,0,0,0,25,25
918330871,The MM Cast,7,3,5,6,29,50
918602360,The Unofficial Shopify Podcast,2,0,0,0,48,50
918799139,All About the Gear,0,2,1,2,21,26
918896288,Gastropod,12,6,14,9,159,200
918956025,Phoenix Helix: Autoimmune Health,0,0,0,0,50,50
918963927,The Reboot Podcast,0,0,3,0,55,58
918983997,The 18STRONG Podcast,2,1,0,3,117,123
919219256,CodeNewbie,3,4,4,2,63,76
919266944,Working Class Audio,0,0,0,2,41,43
919579524,Bedside Rounds,0,0,0,0,46,46
919688822,Beyond the Business Suit with Kailei Carr,0,0,0,0,32,32
920323000,The Human Experience Podcast,2,0,1,1,111,115
920642334,The Woolly Thistle podcast,0,0,0,1,29,30
920807796,VOMRadio,0,0,0,0,115,115
920885486,Hypnotherapy and Mental Health by Paula Sweet at Absolute Mind,0,1,1,1,40,43
920897486,Fantasy Team Advice,0,0,0,0,13,13
920898575,Rental Income Podcast With Dan Lane,3,1,3,1,192,200
921345088,The GRID: A Power Rangers Podcast,0,0,1,0,3,4
921359216,Noxious Deejay Podcast,1,0,0,2,33,36
921756215,The Tikvah Podcast,0,0,0,3,38,41
921792544,The RV Atlas Podcast,4,4,4,6,204,222
921854276,The Ultimate Health Podcast,3,0,0,3,44,50
921856054,The Peggy Smedley Show,0,0,0,0,2,2
922310447,The Worst Bestsellers,7,7,4,6,95,119
922323074,C10 Talk,0,0,0,0,50,50
922403150,The Wandering DP Podcast,0,0,0,2,94,96
922993934,Search Engine Journal Show,0,3,2,0,24,29
923017416,Heart Wisdom with Jack Kornfield,1,0,0,1,46,48
923018685,Pilgrim Heart with Krishna Das,2,0,0,0,16,18
923019021,Metta Hour with Sharon Salzberg,0,0,0,0,18,18
923300925,The How To Get Away With Murder Podcast,4,7,3,2,20,36
923527373,Astonishing Legends,41,43,49,32,335,500
923535123,Mat Talk Podcast Network,0,1,0,1,15,17
923544550,Purple Daily - A Minnesota Vikings Podcast,25,7,2,9,87,130
923890441,Out on the Lanai: A Golden Girls Podcast,7,11,10,5,94,127
923957904,Gilmore Guys,8,1,3,7,31,50
924668112,In This League Fantasy Basketball,2,1,1,0,103,107
924940383,"Smart Women, Smart Power",2,0,0,0,8,10
924953354,UNC Hoops Talk Podcast,0,0,0,0,11,11
925021233,BlacksmitHER Radio,0,0,0,0,5,5
925127229,"CannaInsider - Interviews with the Business Leaders of The Legal Cannabis, Marijuana, CBD Industry",1,1,3,1,142,148
925250888,The Criminal Minds Podcast,0,0,3,0,5,8
925326414,BBC Learning English Drama,3,1,0,1,5,10
925676451,Blended Family Podcast,0,0,2,1,47,50
925781328,RV Podcast,5,8,6,14,138,171
925908957,American Horror Story Podcast,13,5,4,3,47,72
925983159,Stories of an Unschooling Family,0,0,0,0,23,23
926193073,Manga Machinations,0,0,0,0,8,8
926642601,The Rich Eisen Show,16,4,10,5,35,70
926900242,Superman and Lois TV Talk,0,0,1,2,60,63
927124413,Twisted Stitches,0,0,0,1,5,6
927205926,Campaign: Skyjacks,0,0,1,3,46,50
927263663,Get Rich Education,2,0,2,0,196,200
928069318,EOS 10,0,0,0,3,47,50
928159684,The GaryVee Audio Experience,1,0,0,0,29,30
928327752,The Walking Dead Talk Through,2,1,1,3,24,31
928350893,Mamamia Out Loud,58,20,32,38,502,650
928730843,Soul of Islam Radio,0,0,0,1,28,29
928739164,The Dog's Way Podcast: Dog Training for Real Life,1,1,0,2,21,25
928790786,"Amicus With Dahlia Lithwick | Law, justice, and the courts",5,5,4,2,34,50
928864628,Two Ewes Fiber Adventures,1,0,0,1,41,43
928933489,We Study Billionaires - The Investor’s Podcast Network,0,0,0,2,38,40
928944045,Speak English With A British Accent,0,0,0,0,1,1
929121341,Louder with Crowder,8,2,0,0,260,270
929388589,Responsa Radio - Hadar Institute,0,0,0,0,6,6
929743897,Creative Pep Talk,1,5,2,4,188,200
929751982,Radical with David Platt,0,0,0,2,64,66
930200652,Tanach Study,0,0,0,0,2,2
930665651,Working,8,4,3,6,29,50
931302188,Fireside Mystery Theatre,3,2,0,3,42,50
931319298,GRE Vocabulary Podcast by VictorPrep,0,0,0,0,50,50
931442125,So Many Damn Books,1,0,0,2,79,82
931714873,Full Stack Radio,0,0,0,2,27,29
931937937,Veterinary ECC Small Talk,0,0,0,2,31,33
932492307,The Option Alpha Podcast,3,1,1,2,193,200
932493456,Marriage More Podcast - Making Your Marriage More - Relationships | Couples | Intimacy | Christian |,4,3,5,3,35,50
932498963,The Food Chain,1,0,1,1,19,22
932630328,The His and Her Money Show,0,0,1,2,47,50
932895321,Hypnobirthing Hub,1,1,0,0,2,4
933048043,Nursing Podcast by NURSING.com (NRSNG) (NCLEX® Prep for Nurses and Nursing Students),1,0,1,1,47,50
933300204,Werewolf Ambulance: A Horror Movie Comedy Podcast,1,0,0,3,139,143
934552872,Switched on Pop,8,2,1,0,39,50
934619356,The Mind Muscle Project,1,1,3,0,45,50
934820588,The Dan Le Batard Show with Stugotz,40,24,12,4,630,710
935002648,MedMaster Show (Nursing Podcast: Pharmacology and Medications for Nurses and Nursing Students) by NU...,1,0,1,1,8,11
935302697,Finding the Missing Peace by Ajahn Amaro,0,0,0,0,3,3
935307095,Ajahn Sumedho Podcast by Amaravati,0,0,0,0,2,2
935345158,Designer Notes,1,0,0,0,13,14
935548315,Retro Disney World Podcast,1,1,2,4,83,91
935794447,Medieval Death Trip,0,1,0,0,42,43
936250143,The Allender Center Podcast,2,1,3,2,45,53
936499739,"MMHMM, GIRL",3,3,5,5,34,50
936653355,Chat 10 Looks 3,2,4,2,7,122,137
937345051,Caalo Xan: A Sci-Fi Audio Drama,0,0,0,1,6,7
937425056,Atomic Moms,0,0,0,1,49,50
937589792,We Gotta Thing - A Swinger Podcast,1,3,1,1,44,50
937685375,Bridechilla- Wedding Planning Podcast,3,0,1,3,181,188
937940719,The Kinda Funny Podcast,25,3,2,0,20,50
938040414,"Alba Salix, Royal Physician",0,1,1,3,45,50
938042914,76ers Podcast Network,1,1,0,2,11,15
938148521,Anjunabeats Worldwide,1,1,1,2,9,14
938456371,Gravy,0,1,0,1,47,49
938873281,"Noob Spearo Podcast | Spearfishing Tips, Stories and Interviews",0,0,0,0,46,46
939020106,Fastbreak Breakfast NBA Podcast,3,0,2,1,139,145
939175693,UI Breakfast: UI/UX Design and Product Strategy,0,1,2,1,18,22
939293583,"Making It With Jimmy Diresta, Bob Clagett and David Picciuto",3,1,1,0,45,50
939310746,Naked Mormonism Podcast,7,1,6,6,115,135
939927416,Go Natural English Podcast | Listening & Speaking Lessons,1,0,1,3,23,28
939966584,Shift and Steer,2,2,2,1,43,50
940156245,The Entrepreneurship Elevated Podcast,0,0,0,4,46,50
940288964,Turned Out A Punk,1,1,2,5,118,127
940299283,Uncovered with Dr. Laura Berman: Highlights,1,0,0,0,9,10
941015904,The YouTube Power Hour Podcast,4,3,0,1,42,50
941219323,Linear Digressions,0,0,0,2,61,63
941313219,State of the Arts,0,0,0,0,13,13
941317634,The Adult Chair,0,0,0,0,50,50
941441148,Economic Rockstar,0,0,0,1,49,50
941744885,SmashBoxxTV's Disc Golf Podcast,0,1,2,2,12,17
941899624,The Pensky Podcast,0,0,0,1,27,28
941907967,Reply All,191,51,31,12,215,500
942052626,Bedtime Stories Podcast Fairytales and Folk Tales from the Lilypad for kids,2,1,5,4,38,50
942230950,Teaching Your Brain to Knit,0,0,0,0,27,27
942404284,French Voices Podcast | Learn French | Interviews with Native French Speakers | French Culture,0,0,0,0,33,33
942696396,Myleik Teele's Podcast,2,0,1,3,194,200
942730377,Golf Talk Live,0,0,1,0,0,1
942777522,The Psychology Podcast with Scott Barry Kaufman,0,0,0,0,6,6
942809988,For The Wild,0,0,1,0,90,91
943279351,Today In Space,0,0,0,0,1,1
943509302,The Nonprofit Exchange: Leadership Tools & Strategies,0,0,0,0,6,6
943705286,The Rental Rookie Podcast,1,1,0,2,46,50
944003980,Libertarian,9,3,1,0,37,50
944329294,Dr. Pompa & Cellular Healing TV,1,0,3,3,33,40
944627155,Foundr Magazine Podcast with Nathan Chan,0,0,0,3,47,50
944720358,Boats & Billfish,0,0,0,0,4,4
944770208,Here We Are,3,0,3,9,408,423
944796307,Muscles by Brussels Radio!,0,2,0,1,40,43
944925529,That Sounds Fun with Annie F. Downs,6,4,3,8,479,500
945146033,Adult Film Star Network,3,2,1,0,32,38
945257319,Totally Deep Backcountry Skiing Podcast,0,1,2,2,49,54
945517541,Managing Madrid: for Real Madrid fans,1,0,0,1,54,56
946171557,Top Level Podcast,0,3,3,4,21,31
946464408,FUN Japanese Listening » podcasts,0,0,0,2,0,2
946696517,Journey With Deanna,0,0,0,0,2,2
946777369,Government Contracting Officer Podcast,0,0,0,0,46,46
946895107,Ben Franklin's World,4,8,7,3,28,50
947128216,The Observatory,1,0,3,1,27,32
947191070,Design Details,2,3,2,8,111,126
947367245,The Columbo Podcast,0,0,0,0,55,55
947440206,The HighExistence Podcast,0,0,0,7,69,76
947753823,Design Review,0,0,0,1,39,40
947899573,The Adventure Zone,7,3,1,3,36,50
948387773,Content Inc with Joe Pulizzi,0,0,0,1,37,38
948913991,Exchanges at Goldman Sachs,6,4,6,7,25,48
948976028,Stories Podcast: A Bedtime Show for Kids of All Ages,31,11,31,47,375,495
949195280,Crime Writers On...True Crime Review,66,23,25,17,369,500
950099189,The Citizen's Guide to the Supreme Court,8,1,2,3,36,50
950249508,MISC on LMC Radio Network,0,0,1,0,1,2
950464429,Dear Sugars,29,21,22,28,382,482
950689657,The Orbital Mechanics Podcast,0,0,1,1,62,64
950871622,The Nail Hub Podcast,0,0,0,0,11,11
951048357,Sky News Daily,1,2,1,0,1,5
951087108,Weekly Manga Recap,0,1,0,1,48,50
951166132,The Taz Show,21,3,7,8,356,395
951238847,Nocturne,8,3,3,3,185,202
951360425,Frightday,8,2,1,1,136,148
951373237,The Paul Kirtley Podcast,0,0,0,0,22,22
951475911,Anchored with April Vokey,4,1,3,1,182,191
951946132,Lawyerist Podcast,0,0,0,0,30,30
952002084,2017 California Driver Audio Handbook,2,1,0,1,7,11
952044185,Mystery Show,15,5,7,16,457,500
952491347,Country-ish,0,0,0,1,49,50
952870930,Spartan Up! - A Spartan Race for the Mind!,5,1,1,2,41,50
952917216,How To Talk To Girls Podcast,5,0,3,3,39,50
952917333,The Storm: A Lost Rewatch Podcast,19,12,10,22,437,500
953290300,Invisibilia,92,37,21,27,323,500
953371091,Fertility Friday Radio | Fertility Awareness for Pregnancy and Hormone-free birth control,2,1,4,4,39,50
953527700,The Safety Pro Podcast,0,0,0,0,50,50
953541032,MAKING CHIPS Podcast for Manufacturing Leaders with Jason Zenger & Jim Carr,0,0,1,2,30,33
953553769,NURSING.com NCLEX® Question of the Day (Nursing Podcast for NCLEX® Prep and Nursing School) by NURSI...,0,0,0,0,5,5
953568438,Straight Chilling: Horror Movie Review,4,3,1,0,38,46
953575150,Shipping & Handling,2,0,0,0,27,29
954052959,Mortgage Lending Mastery,1,1,0,0,62,64
954072332,Motley Fool Answers,9,3,7,6,175,200
954083494,Elite Man Podcast,20,1,2,1,26,50
954100822,Mind Pump: Raw Fitness Truth,0,2,0,1,47,50
954105187,The Joy of Text - Jewish Public Media,2,2,0,0,7,11
954105386,"Lens Shark Photography Podcast - the latest in DSLR, mirrorless, lenses, photo software, tips, trick...",0,0,0,0,9,9
954139712,Angela Watson's Truth for Teachers,0,0,0,0,50,50
954158712,Fashion Is Your Business - a retail technology podcast,0,0,0,0,36,36
954648487,The Benjamin Dixon Show,24,3,3,3,95,128
954892507,New Books in Indian Religions,0,0,1,0,0,1
954964236,Duke Basketball Report,1,3,2,1,35,42
954984769,Primal Potential,0,1,0,0,49,50
955014045,Professional Organizer's Think Tank podcast,1,0,1,0,3,5
955053039,The Inspired Pilot Podcast,0,0,0,0,48,48
955075042,The Productivity Show: Time Management | GTD | Smart Personal Development | Business | Mac,6,2,3,10,108,129
955100693,Sermon of the Day,2,0,0,1,28,31
955147516,Sky Tour Astronomy Podcast,0,0,0,2,17,19
955156631,The Elysium Project,2,1,2,4,23,32
955167611,Super Speeders,2,1,0,0,22,25
955189341,Songcraft: Spotlight on Songwriters,0,1,0,2,34,37
955228473,The Digital Analytics Power Hour,0,0,0,0,31,31
955266263,The Great Albums,5,5,5,1,34,50
955311743,Between Now and Success,0,0,0,1,31,32
955326572,The Art of Online Business,0,0,0,0,50,50
955329085,Doctor Tottenham,0,0,0,0,24,24
955470114,Pop Culture PileDriver,1,0,0,0,17,18
955596067,Developer Tea,0,2,1,4,143,150
955634521,LST's I Am The Law,0,0,0,0,3,3
955637330,The Unbeatable Mind Podcast with Mark Divine,0,1,3,3,43,50
955874270,Catholic Answers Focus,1,0,3,2,55,61
955939085,So Money with Farnoosh Torabi,8,4,8,2,178,200
956037541,12 Tribes of Israel Congregation | 12T.CO,0,0,0,0,1,1
956038761,No Redeeming Qualities,0,0,0,0,14,14
956154836,"1001 Heroes, Legends, Histories & Mysteries Podcast",6,1,3,0,40,50
956270301,Rational Security,2,0,3,2,43,50
956310359,"Being Boss: Mindset, Habits, Tactics, and Lifestyle for Creative Entrepreneurs",3,4,1,0,42,50
956620417,Strength & Scotch: Get Fitter While Enjoying Life,1,0,1,3,45,50
956625850,The Body Serve,0,0,3,2,70,75
956638541,MTGGoldfish Podcast,5,5,4,4,31,49
956639390,Bailey and Southside Podcast,3,1,0,1,10,15
956673263,Dollars to Donuts,0,0,0,0,20,20
956742638,The RobCast,30,8,6,12,431,487
956995247,The Cozy Robot Show (Formerly Ask Science Mike),2,0,1,4,250,257
957018499,In This League Fantasy Baseball,7,2,5,5,166,185
957150947,Special Operations Medical Association,0,0,1,1,6,8
957163760,Millennial Money,8,4,4,6,28,50
957171516,Kinda Funny Gamescast,15,7,3,2,23,50
957216506,Messy Family Podcast : Catholic conversations on marriage and family,0,0,1,0,49,50
957223102,Espresso English Podcast,0,0,0,0,17,17
957244150,The Nurse Keith Show,1,0,0,1,42,44
957265404,Chat With Traders,1,1,0,1,197,200
957276203,Dear Handmade Life,0,1,1,1,78,81
957412093,The Homeschool Snapshots Podcast,0,0,1,1,48,50
957430475,The Allusionist,2,5,3,7,183,200
957592464,So you want to be a photographer: Transform your skills and build a profitable photography business,1,0,1,0,48,50
957863326,The Muscle Car Guy Podcast,0,0,1,1,5,7
957883184,Plant Trainers Podcast - Plant Based Nutrition & Fitness,1,0,0,1,48,50
958179457,Coffee Break Italian,1,0,0,2,47,50
958230465,The Twenty Minute VC: Venture Capital | Startup Funding | The Pitch,2,2,4,1,47,56
958365894,Game Of Thrones,4,1,3,3,160,171
958778095,The Trap Set with Joe Wong,0,1,4,3,106,114
958825741,Ask a Spaceman!,2,2,0,2,101,107
958999703,Slow American English,0,0,0,1,2,3
959129659,Fireteam Chat: IGN's Destiny Podcast,29,17,23,25,259,353
959218378,Accounting Play Podcast: Learn Accounting,0,0,2,0,14,16
959298859,Buddhism Guide,0,1,1,1,30,33
959301807,Photobomb Photography Podcast,1,1,0,1,85,88
959303942,The Police Podcast,1,0,0,0,33,34
959391385,Sustainababble,0,1,0,0,20,21
959437457,"A History of Architecture, the Fundamental Process Podcast",0,0,0,0,10,10
959595228,Pseudo-Archaeology,2,1,5,2,18,28
959621656,D1Baseball,1,0,1,2,20,24
959642856,Golf Strategy School Podcast,0,1,0,0,33,34
959714077,The Bookmonger,0,0,1,2,27,30
959855329,Everyday Zen Podcast,0,0,0,0,1,1
960089084,Kevin Ward's YES Talk | Real Estate Coaching and Success Training for Agents,0,1,0,0,21,22
960272995,Assistive Technology FAQ (ATFAQ) Podcast,0,0,0,0,2,2
960329099,BallSh!t | Ball Python Industry PodCast | EbNMedia.tv,0,0,0,0,15,15
960337205,Ike Live Fishing Talk Show with Mike Iaconelli,3,2,0,3,68,76
960376665,The Realistic Prepper,5,1,0,3,32,41
960806223,Gallup Theme Thursday,0,0,0,0,6,6
960814054,The Ricochet Audio Network Superfeed,6,1,3,1,39,50
960870114,From the Head of the Bed,1,0,0,0,14,15
960902903,The MeatEater Podcast,23,12,12,7,446,500
960924891,Everyday Ayurveda and Yoga at Hale Pule,0,0,0,0,16,16
960976813,I Know Dino: The Big Dinosaur Podcast,1,1,0,3,48,53
961323147,The Dark Place: Conversations About Mental Health | Depression | Anxiety,1,0,0,0,10,11
961350194,Defenders TV Podcast. A WandaVision podcast from TV Podcast Industries,2,0,0,4,25,31
961385822,The Naked Bible Podcast,10,7,1,4,411,433
961407356,Year of Polygamy Podcast,5,1,1,1,42,50
961418092,The Hunting Dog Podcast,6,8,7,14,400,435
961463317,The Marketing Book Podcast,0,0,0,0,50,50
961715033,Talking Dirty with Rebecca Love,1,1,0,0,19,21
961726070,Sick Addictions with Joclyn Stone,0,0,1,1,18,20
961774064,FloWrestling Radio Live,7,2,2,5,73,89
961837133,Rude Alchemy,1,0,0,1,48,50
961859632,ADHD People | The Tom Nardone Show | An Enema of ADHD,3,1,0,0,25,29
961865564,Mastering Business Analysis,0,0,0,0,22,22
962130084,Coffee With a Sign Painter,0,0,2,1,25,28
962188147,Batman: The Long Halloween - Audio Drama,5,0,0,1,19,25
962416631,Juicebox Podcast: Type 1 Diabetes,1,0,0,1,48,50
962472464,Better Cast Saul - Better Call Saul Unofficial Podcast,37,8,5,5,102,157
962601477,Godsfall  | A Dungeons and Dragons Podcast,5,1,1,2,41,50
962617863,TSR Speed Shop RC podcast,0,0,0,0,1,1
962730639,The Pickleball Show with Chris Allen,0,0,0,1,31,32
962733842,JSE Direct with Simon Brown,0,1,0,1,38,40
962887645,GREEN Organic Garden Podcast,0,4,2,1,43,50
962899095,Two Man Power Trip of Wrestling Podcast,2,1,0,4,20,27
962990192,PreAccident Investigation Podcast,0,0,0,0,18,18
962997969,Supergirl Radio,1,0,1,0,55,57
963131164,The Growth Show,0,1,1,3,45,50
963144241,AppleInsider Podcast,28,27,21,13,94,183
963244879,Kind World,4,0,5,3,142,154
963294070,Rock Your Brand Podcast,3,1,1,1,44,50
963330361,Grow Milkweed Plants,0,0,0,0,3,3
963387015,Grief Out Loud,0,0,0,0,21,21
963592988,Scrum Master Toolbox Podcast,0,0,1,0,14,15
963597166,Meditation Minis Podcast,0,0,1,1,48,50
963641617,Swimming Ideas Podast,1,0,0,0,0,1
963794050,The Tolkien Road,6,2,0,0,60,68
963859436,Don Diablo Presents Hexagon Radio,1,0,1,0,31,33
963903899,Multiplier Mindset® with Dan Sullivan,0,0,0,0,13,13
963972595,The Style Success Podcast,3,5,3,4,38,53
963992853,Veterinary Secrets,0,1,0,1,8,10
964191590,Song Talk Radio | Songwriting Tips | Lyrics | Arranging | Live Feedback,1,0,0,0,2,3
964304361,The Contractor Fight with Tom Reber,1,0,1,0,48,50
964305817,Transistor,0,0,0,1,6,7
964347702,Sick,3,6,6,6,109,130
964583650,GSD Mode,0,0,1,0,45,46
964623770,Trivial Warfare Trivia,15,7,4,2,22,50
964702778,Rose Chat Podcast,1,0,1,1,3,6
964902342,The Mortified Podcast,2,7,5,8,151,173
964921299,Political Rewind,3,1,1,1,12,18
965163837,layovers ✈︎ air travel and commercial aviation,0,0,1,0,36,37
965168096,Urbanomic,0,0,0,0,1,1
965293227,The Dan Bongino Show,34,0,4,2,140,180
965417235,Write Now with Sarah Werner,1,1,0,3,98,103
965432874,Arizona Spotlight,0,0,0,1,1,2
965650639,The Everyday Innovator Podcast for Product Managers,0,0,0,0,22,22
965683964,Highly Intuitive People - 7 Steps to Purpose,0,0,0,0,3,3
965689888,Locked On Heat - Daily Podcast On The Miami Heat,5,3,2,5,103,118
965702011,Dishin' Days,0,0,1,0,64,65
965818306,48 Hours,127,79,97,78,78,459
966029848,The Bitch Bible,4,1,1,1,43,50
966280626,Triple Play Performance Podcast,0,0,0,0,37,37
966362392,That's So Retrograde,2,3,5,2,38,50
966381935,NursEM - Nursing in Emergency,0,1,2,0,5,8
966407057,Man Meat BBQ,3,8,0,2,24,37
966578696,PsychCrunch,0,0,0,0,1,1
966591983,The Down & Dirty Radio Show,0,1,0,1,24,26
966608311,30something Movie Podcast,0,0,0,0,8,8
966670774,Gritty Podcast,25,10,6,5,454,500
966696129,Dude Soup,10,7,5,5,308,335
966714421,Getting In: A College Coach Conversation,0,0,0,4,46,50
966769234,Daily Tanya (Audio) - by Yehoshua B. Gordon,0,0,0,0,5,5
966770162,Daily Chumash with Rashi (Audio) - by Yehoshua B. Gordon,0,0,0,0,10,10
966770418,Daily Chumash with Rashi (Video) - by Yehoshua B. Gordon - by Yehoshua B. Gordon,0,0,0,0,1,1
966771060,Rambam - 3 Chapters a Day (Audio) - by Yehoshua B. Gordon,0,0,0,0,3,3
966771430,Rambam - 1 Chapter a Day (Audio) - by Yehoshua B. Gordon,0,0,1,0,0,1
966781846,ACG - The Best Gaming Podcast,1,0,0,1,48,50
967315198,Attack Style Wrestling Podcast,0,0,0,0,2,2
967315845,Zen Community of Oregon Dharma Talks,0,0,0,0,2,2
967352832,Ask Drone U,6,3,5,4,32,50
967473998,Transgender News Center,2,0,1,0,1,4
967654410,True Romance - Dating Advice For Women,13,1,0,1,7,22
967794020,Clutter Free Academy,3,0,0,1,27,31
967884778,"Delight Your Marriage | Sexual Intimacy, Relationship Advice, & Christianity",1,0,0,0,49,50
968091220,On The Mat,0,0,0,0,4,4
968204382,The Archive Project,0,0,0,0,1,1
968245724,The Landscape Architecture Podcast,1,1,1,0,25,28
968365266,Well-Fed Women,0,0,0,0,50,50
968586524,Lets Truck with Kevin Rutherford,2,2,1,2,3,10
968638424,"The Anxious Truth - REAL Help For Panic, Anxiety and Agoraphobia",0,0,0,1,49,50
968673096,The Blizzard,1,2,0,0,35,38
968927571,Adventures Through The Mind,0,0,1,0,26,27
968956607,How We Roll Podcast,0,0,0,1,49,50
969076668,IELTS Energy English Podcast,0,0,1,2,5,8
969120513,The Brass Junkies Podcast - Pedal Note Media,0,1,0,0,100,101
969200480,The Ex Boyfriend Recovery Podcast,2,2,2,2,42,50
969226465,From Founder To CEO,0,0,0,1,95,96
969519520,Happier with Gretchen Rubin,2,2,2,1,43,50
969521988,Trucking with Authority,0,1,1,0,4,6
969524107,Burnt Toast,6,2,4,4,34,50
969659784,Axe of the Blood God: An RPG Podcast,4,0,4,2,40,50
969768868,Winged Wheel Podcast - A Detroit Red Wings Podcast,4,1,4,2,144,155
969802743,Transformation Sequence,0,0,0,0,47,47
969874173,Empowered Relationship Podcast: Your Relationship Resource And Guide,1,0,0,0,42,43
969904333,The Property Couch,3,1,6,4,125,139
970147132,Courtside with Greenberg & Dakich,21,4,6,7,21,59
970694987,Jay Scott Outdoors Western Big Game Hunting and Fishing Podcast,1,4,9,7,292,313
970812456,80 of the 80s Music Podcast,0,1,0,1,6,8
971103078,"Healthy Living With Naturopath Angela Busby - Your Health, Nutrition and Wellness Resource",1,0,0,0,35,36
971122157,Bread4Soul Sessions,0,0,0,0,17,17
971178438,The Food For Fitness Podcast | Nutrition | Training | Lifestyle | Healthy Living,0,0,0,0,19,19
971901464,WSJ Opinion: Potomac Watch,104,34,22,26,104,290
971915289,The CX Cast®,0,0,0,0,3,3
971938401,10K Rinks Radio - A Minnesota Wild Podcast,1,1,0,2,31,35
971949329,We Got This with Mark and Hal,1,2,1,1,45,50
971951176,IT'S TIME w/Bruce Buffer,6,2,0,0,14,22
971959728,Recovery Elevator,4,3,0,1,42,50
972135351,Something Wild,0,1,1,1,5,8
972152176,Blind Abilities,0,0,0,2,4,6
972403908,Adventure Sports Podcast,5,3,4,3,79,94
972414353,Quran For Busy People: Weekly insights into the simple beauty and spiritual depth of Islam – from th...,2,0,0,0,19,21
972528193,The Gardening with Joey & Holly radio show Podcast/Garden talk radio show (heard across the country),2,0,0,0,4,6
972757794,Royals Review: for Kansas City Royals fans,3,0,0,0,5,8
973303969,"""Doctor Mom"" Podcast",0,0,0,0,50,50
973487682,Bats and Balls Podcast,0,0,0,0,14,14
973535723,"Coaching Soccer Weekly: Methods, Trends, Techniques and Tactics from WORLD CLASS COACHING",0,1,0,4,119,124
973579797,Joe DeFranco's Industrial Strength Show,0,0,0,0,50,50
973958702,Page 94: The Private Eye Podcast,1,2,1,6,65,75
974276340,The Dentist Freedom Blueprint,0,0,0,0,27,27
974288930,The Leaf Report: A show about the Toronto Maple Leafs,1,0,1,1,1,4
974299441,Morning Joe,92,56,63,73,216,500
974808977,Working Class Bowhunter,1,0,2,2,182,187
975035526,High Sierra 4×4 Podcast,1,0,1,0,48,50
975078285,Hello From The Magic Tavern,0,0,1,0,49,50
975097372,French Your Way Podcast: Learn French with Jessica | French Grammar | French Vocabulary | French Exp...,1,1,1,2,45,50
975133607,Food As Medicine with Dr. Anh,1,1,1,3,44,50
975284403,This is Product Management,0,1,0,2,16,19
975311694,5 Things,10,6,12,6,45,79
975343556,Trading Stocks Made Easy with Tyrone Jackson,2,0,3,1,44,50
975392298,Bourbon Pursuit,2,3,4,7,171,187
975405360,The Whisky Topic,0,0,0,0,40,40
975413460,Out There,2,0,0,2,89,93
975437148,Down And Nerdy Podcast,0,0,0,0,7,7
975569919,Payne's Politics,13,7,8,8,14,50
975695756,Dining at Disney Podcast,0,1,1,0,8,10
975697894,Book Club Girl Podcast,1,0,0,0,8,9
975868584,The Apple WatchCast Podcast - A podcast dedicated to the Apple Watch,1,0,2,3,128,134
975892739,The Self-ish Latina Podcast,0,0,0,0,14,14
975945542,Photo Field Notes Podcast: Career Advice for Photographers,0,0,0,1,25,26
976204876,"CleanTech Talk — EVs, Solar, Batteries, AI, Tesla",1,0,2,0,8,11
976331027,Above the Law - Thinking Like a Lawyer,14,4,4,9,66,97
976377038,Herbal Radio,1,1,0,0,5,7
976468994,Psychology of Video Games Podcast,0,0,0,1,13,14
976512348,Food Non-Fiction,1,2,5,7,71,86
976599933,Primal Edge Health,0,1,1,0,15,17
976712321,Women Taking the Lead with Jodi Flynn,0,0,0,6,194,200
976729350,Someone Else's Movie,0,0,0,0,6,6
976803232,Section 10 Podcast,20,3,5,10,242,280
977007408,Ten Junk Miles,0,2,1,9,488,500
977015568,The Politics Guys,15,6,4,4,21,50
977021190,The Talent Grow Show: Grow Your Leadership and Communication Skills,0,0,0,0,37,37
977345837,Real English Conversations Podcast - Listen to English Conversation Lessons,0,0,0,0,5,5
977410792,The Bronx Pinstripes Show - Yankees MLB Podcast,6,1,2,3,488,500
977500599,The Power and Speed Podcast,1,0,0,1,36,38
977675513,Donna & Steve,0,0,0,0,6,6
977676980,Another Round,6,1,2,5,486,500
977782429,40 Acres & a Fool,1,0,0,0,9,10
977872565,HuskerOnline Podcast,0,2,0,2,9,13
978046063,Lets Go Blues Radio - St. Louis Blues Hockey Podcast,0,1,2,2,11,16
978052928,Lore,57,54,30,51,825,1017
978187550,The Real Pod,0,0,1,1,74,76
978189040,MLM Nation,3,0,2,5,190,200
978322714,The Martyrmade Podcast,0,0,0,1,49,50
978519992,"Relationship Radio: Marriage, Sex, Limerence & Avoiding Divorce",1,0,0,0,56,57
978562747,Travelers In The Night,0,0,0,0,9,9
978635940,The ATP Project's Podcast,0,0,1,0,22,23
978833445,The LogBook - Aviation Storytelling Podcast,0,0,0,0,10,10
979020229,Talk Python To Me,0,0,0,2,67,69
979118845,Cyrus Says,2,1,2,3,39,47
979228404,The Stock Trading Reality Podcast,1,2,0,2,92,97
979428106,(Podcast) Child Psychology,0,3,1,0,0,4
979444180,Redefining HR,0,0,1,0,19,20
979577413,The Countdown: Movie and TV Reviews,2,0,2,2,115,121
979609843,Theoretical Physics - From Outer Space to Plasma,0,0,1,0,0,1
979752171,Order of Man: Protect | Provide | Preside,9,2,2,2,185,200
980068198,The Ghastly Tales Podcast,0,0,1,0,30,31
980133198,What is Wrong with UX,0,1,1,0,16,18
980461189,The Beauty Biz™ Show,0,0,0,1,49,50
980669909,Tom & Lorenzo's Pop Style Opinionfest,9,4,7,5,74,99
980781096,Photo Taco Podcast,0,0,2,0,81,83
980807211,Pageant Junkies | Hopelessly Addicted to the Miss America Program,0,0,0,0,6,6
980990143,Behind The Knife: The Surgery Podcast,0,0,2,0,48,50
981330533,Blank Check with Griffin & David,21,8,18,19,433,499
981373142,This Glorious Mess,8,9,8,4,116,145
981781015,The Rich Outdoors,22,1,1,5,470,499
981834425,The Python Podcast.__init__,3,1,2,3,15,24
982003188,The WW2 Podcast,1,0,1,5,43,50
982105741,MCU Fan Show - WandaVision and more Marvel Studios commentary,15,2,14,11,182,224
982392078,Golf Unfiltered Podcast,0,0,0,2,37,39
982530565,Sound Bites A Nutrition Podcast,0,0,1,0,49,50
982555930,Origin Stories,0,0,0,2,40,42
982639043,The Right Time with Bomani Jones,18,8,4,10,460,500
982772171,Everyday MBA,0,0,0,1,39,40
982857943,Krishna Temple Talks,0,0,0,0,10,10
982877403,The Poker Life and HSPLO Podcasts,1,0,1,1,23,26
982980293,Mom Is In Control Podcast,0,2,0,1,47,50
983059644,The 2 Robbies,17,9,19,38,294,377
983068456,I Will Teach You A Language,0,0,0,0,50,50
983093988,Sharp Tongue,0,1,1,1,47,50
983093989,The Hot Mess Comedy Hour,1,0,2,1,46,50
983281791,Awakening Now with Lama Surya Das,0,0,1,1,5,7
983365538,What's Cooking with Paula Deen,0,0,2,4,16,22
983386815,"Dr. Ruscio Radio: Health, Nutrition and Functional Medicine",1,3,3,1,42,50
983412776,The Show Before the Show,1,0,0,1,31,33
983423048,Supply Chain Radio,0,0,0,0,2,2
983494015,Back to the Future: The Podcast,0,0,1,1,18,20
983782306,Federalist Radio Hour,37,30,19,34,314,434
983795625,Conversations with Tyler,0,3,1,1,45,50
983808184,Living Homegrown Podcast with Theresa Loe,2,0,0,6,108,116
984107360,The SKOR North Twins Show,3,3,3,1,109,119
984262918,Homebrew Happy Hour,2,1,0,1,13,17
984527862,"The Writer Files: Writing, Productivity, Creativity, and Neuroscience",0,0,3,1,13,17
984564254,Townhall Review | Conservative Commentary On Today's News,3,1,2,4,13,23
984598599,The Dating Den,2,1,1,1,26,31
984715472,The Nomad Capitalist Audio Experience,1,1,0,1,23,26
984771479,Tumble Science Podcast for Kids,9,4,4,2,31,50
984947792,Cloudbase Mayhem Podcast,0,0,1,0,39,40
984987791,Undisclosed,8,5,5,5,27,50
985005895,The Slow Home Podcast,0,0,1,0,49,50
985396258,The Learning Leader Show With Ryan Hawk,0,0,1,0,49,50
985412966,WGN Radio Theatre,2,0,3,2,14,21
985700909,Becoming Ultra,1,0,0,0,38,39
985719424,First Things Podcast,3,2,6,5,21,37
985752066,TIME's Top Stories,2,1,0,1,4,8
985869862,Collider Witching Hour,10,2,5,6,47,70
985870258,Better System Trader,0,0,1,0,82,83
985956967,Anik and Florian,11,1,4,8,76,100
986093642,TIME's The Brief,1,1,0,1,4,7
986108444,US Modernist Radio - Architecture You Love,0,0,0,0,11,11
986120629,WTFFF?! 3D Printing Podcast: Digital Manufacturing From Design to Print,3,1,0,0,12,16
986153424,Italian for Beginners,4,1,0,0,7,12
986178502,The Mom Hour,1,0,0,1,48,50
986223478,The Dad Edge Podcast (formerly The Good Dad Project Podcast),0,2,0,0,48,50
986595124,The Lowe Post,48,19,21,25,387,500
986634977,History in the Bible,2,3,1,0,44,50
986759513,The Michael Caz Podcast,1,0,1,0,48,50
986901174,Dunc'd On Basketball NBA Podcast,54,12,17,18,399,500
987241430,"Agency Nation Radio - Insurance Marketing, Sales and Technology",0,0,2,0,12,14
987530751,Bear All Podcast,0,0,0,0,1,1
987724897,The Psychology of Eating Podcast,1,2,3,0,44,50
987967575,20/20,98,60,34,20,38,250
988092938,Cafe Mocha Radio,0,0,0,0,1,1
988176687,Hay House Radio Podcast,0,1,0,0,8,9
988177838,Dr. Wayne W. Dyer Podcast,3,1,0,2,39,45
988178116,Hay House Live!® Podcast,1,0,0,1,3,5
988410790,What Healthy Couples Know That You Don't,0,0,0,3,33,36
988440891,"Overland Roundtable - Overland Travel in a Jeep, Toyota, Nissan, Land Rover or on an adventure bike",0,0,0,2,8,10
988565102,Mendelspod Podcast,0,0,0,0,2,2
988576741,Align Podcast,1,2,1,0,46,50
988803279,Clifford Baptist,0,0,0,0,1,1
988935339,Adult ADHD ADD Tips and Support,1,0,5,2,28,36
989564408,Punk Rock Libertarians Podcast,2,2,2,0,3,9
989649712,This Week in Photo,2,0,1,1,11,15
989652832,The Fitness Business Podcast,0,0,0,0,29,29
989653618,The Qwipster Film Review Podcast,1,0,0,0,18,19
989854020,The Yale Law Journal Podcast,0,0,0,0,2,2
989972759,She Thinks,1,1,0,0,21,23
990122385,Lodging Leaders,1,0,1,0,31,33
990149481,The Knowledge Project with Shane Parrish,0,0,0,0,7,7
990753230,Truth & Justice with Bob Ruff,65,28,27,31,349,500
990831069,TOPcast: The Teaching Online Podcast,0,0,0,0,22,22
990859592,Women at Warp: A Roddenberry Star Trek Podcast,1,2,3,3,51,60
990871441,Writing Excuses,10,7,10,12,80,119
990897842,Myths and Legends,3,0,3,8,186,200
991129779,Euphomet,6,6,5,6,168,191
991149400,ASIAN AMERICA: THE KEN FONG PODCAST,0,1,0,1,80,82
991156680,The Eric Metaxas Show,15,7,5,5,120,152
991202699,Top Of The League Podcast,0,0,0,0,2,2
991237306,Us & Them,1,3,1,4,66,75
991313597,Story Time,0,0,2,7,41,50
991378217,The Hippo Education Podcast,0,0,0,0,22,22
991383481,Social Anxiety Solutions - your journey to social confidence!,4,1,1,0,44,50
991452758,Action: The Pursuit Of Acting Excellence,0,1,0,2,133,136
991567843,Main Podcast – SeekersGuidance,0,0,0,0,3,3
991593581,Lost in Translationmon - A Digimon Podcast,0,0,1,2,20,23
991621063,Guitar Nerds,1,0,0,1,20,22
991671232,Agile for Humans with Ryan Ripley,0,0,0,0,25,25
991739142,The School Leadership Show,0,0,0,0,8,8
991883809,The Empowered Parent Podcast,0,0,0,0,24,24
991991560,Turncloaks - D&D5E Dark Fantasy Actual Play,0,1,2,0,47,50
992015074,Berkeley Zen Center Dharma Talks,0,1,0,0,0,1
992161919,Science Underground,0,0,1,1,18,20
992181345,Eater's Digest,36,23,13,4,89,165
992207609,The Positive Head Podcast,8,4,4,3,481,500
992525558,Angela Yee's Lip Service,5,9,4,9,23,50
992922763,Dirshu Mishnah Brurah Yomi,0,1,0,0,0,1
993000668,Paralyzed,4,1,5,8,32,50
993043203,BYU Speeches,0,1,0,1,15,17
993270804,GovLove - A Podcast About Local Government,0,0,0,1,49,50
993284374,All the Books!,11,15,12,17,145,200
993339442,The Press Room from Deloitte Insights,0,0,0,0,1,1
993356795,The No Proscenium Podcast,0,0,0,0,7,7
993378747,The Fatal Charm of Italy: A Question and Answer Podcast with Rick Zullo,0,0,0,0,8,8
993416182,The Civil Engineering Podcast,0,0,0,0,7,7
993457998,Trends Like These,8,3,4,4,31,50
993662961,DC's Legends of Tomorrow Podcast,4,4,0,0,25,33
993666762,A Thing or Two with Claire and Erica,0,1,0,1,48,50
994349813,Flash Forward,4,8,13,15,406,446
994362496,The Internet of Things Podcast - Stacey On IoT,4,2,1,0,20,27
994512359,Fashion Friends,0,0,0,0,3,3
994539742,The Perception & Action Podcast,0,0,0,0,5,5
994563121,Japan Eats!,0,0,1,0,8,9
994667625,A Corporate Time with Tom and Dan,0,0,0,0,50,50
994786654,NRL Boom Rookies,0,0,0,0,3,3
994999190,The Other Half,0,0,0,0,2,2
995039015,Here To Make Friends - A Bachelor Recap Show,135,68,61,27,209,500
995159486,No Filter,11,1,6,3,109,130
995386468,Locked On Hornets - Daily Podcast On The Charlotte Hornets,3,1,0,2,53,59
995672024,Sup Doc: A Documentary Podcast,1,0,1,0,29,31
995859414,"Just Shoot It: A Podcast about Filmmaking, Screenwriting and Directing",0,0,0,1,114,115
996090554,BRAVE Church,0,0,0,0,3,3
996338562,The Jealous Curator : ART FOR YOUR EAR,1,0,0,0,79,80
996723808,Wheat Pete's Word,0,0,0,0,1,1
996770623,The Giant Beastcast,12,5,2,4,27,50
997056633,Ron Paul Liberty Report,3,2,0,0,45,50
997178675,Dead Earth: Tales of Survival in the Zombie Apocalypse,2,0,2,2,14,20
997215878,The Relationship School Podcast,2,5,3,4,248,262
997497392,The Long War - Warhammer 40k Podcast,5,3,0,5,30,43
997522893,The Black Tapes,2,5,4,6,33,50
997819235,Sports Illustrated Media Podcast,20,4,8,10,157,199
997872651,Locked On Saints - Daily Podcast On The New Orleans Saints,6,4,1,2,91,104
997900930,Friday Night Quests: A D&D Podcast,0,0,1,1,48,50
997930288,Robot or Not?,0,0,0,0,11,11
998362236,RV Maintenance Tips and Information for the DIY,0,0,1,0,4,5
998408464,Retrovaniacs,0,0,1,2,17,20
998421286,Marriage Is Funny,2,1,0,1,167,171
998568017,Casefile True Crime,70,48,78,54,750,1000
998766691,"Accelerated Spanish: Learn Spanish online the fastest and best way, by Master of Memory",5,3,4,2,36,50
999167292,The Building Science Podcast,0,0,1,1,42,44
999438021,Haunted Talks - The Official Podcast of The Haunted Walk,0,0,0,0,17,17
999471212,Listen To Your Body Podcast,0,1,0,1,48,50
999487472,Pass the Real Estate Exam with PrepAgent,0,0,0,2,21,23
999606476,Weekly Games Chat,7,0,2,2,67,78
999652201,The Jurassic Park Podcast,0,0,0,0,74,74
999728026,Total Reboot with Cameron James & Alexei Toliopoulos,0,0,0,0,17,17
999975096,The Skift Podcast,0,0,0,0,5,5
1000134807,Twitter Smarter Podcast with Madalyn Sklar - The Best Twitter Tips from the Pros,0,0,0,2,48,50
1000230848,L/L Research's Law of One Podcast,0,0,0,0,4,4
1000443325,PT Pintcast - Physical Therapy,1,0,0,0,49,50
1000457699,The Bitcoin Podcast Network,4,0,1,1,21,27
1001095170,Giant Thinkers Podcast,0,0,0,0,38,38
1001264567,SoulFood FM,0,0,0,0,30,30
1001591696,Cortex,5,5,5,8,78,101
1001659715,No Jumper,19,3,3,10,172,207
1001747204,Sharpened Artist | Colored Pencil podcast,2,0,0,0,74,76
1001794471,Exponential Wisdom,2,0,2,0,18,22
1001991847,Hedrich Files,1,0,1,2,58,62
1002073669,Think Again – a Big Think Podcast,6,4,5,9,117,141
1002243133,Examining Ethics,0,0,0,1,18,19
1002611243,Rusty Quill Gaming Podcast,0,0,0,1,49,50
1002655335,Booking The Territory Pro Wrestling Podcast,3,0,0,1,173,177
1002799146,Ballpark Dimensions,4,2,7,4,32,49
1002807630,TALKING TESLA,6,2,5,7,170,190
1002937870,Dear Hank & John,4,1,5,12,478,500
1003019020,"SuperCreativity Podcast with James Taylor | Creativity, Innovation and Inspiring Ideas",0,0,0,0,39,39
1003087927,Running Inside Out Podcast,0,0,0,1,8,9
1003655963,The Detroit Lions Podcast,3,4,6,4,103,120
1003811629,Bollywood Weekly,0,0,1,2,1,4
1003885427,Trumpet Daily,2,0,0,0,14,16
1004494626,Unlocking The Magic: Talking all things Disney World and Disneyland,5,5,5,9,476,500
1004530793,The Action Network Sports Betting Podcast,11,3,5,10,334,363
1004552233,The DC3cast!,0,0,0,1,8,9
1004561753,Alpha and Omega Ministries,11,2,0,2,69,84
1004580375,Leading With Purpose,1,0,0,1,43,45
1004653727,Wrestling Inc. Podcast,27,7,4,4,41,83
1004688973,Drop Zone - GOLF Podcast,3,3,1,1,18,26
1004789177,Universal Orlando Podcast by Orlando Informer,2,2,3,4,44,55
1004885814,Keep Your Daydream,0,0,0,3,292,295
1005210315,Beyond The Baseline: SI's Tennis Podcast with Jon Wertheim,2,2,4,5,26,39
1005628280,Twin Peaks Unwrapped,1,2,4,1,48,56
1005719306,Motorcycle Men,3,0,2,1,10,16
1005744797,eCommerce MasterPlan,0,0,0,0,34,34
1005774516,Core EM - Emergency Medicine Podcast,0,0,1,1,14,16
1006020160,Cult Of Us,2,0,0,0,48,50
1006030122,Sneak Attack!,1,0,1,1,47,50
1006051665,Logical Progression (LP) - logicalprogression,0,0,0,0,2,2
1006173000,ars PARADOXICA,4,2,5,5,34,50
1006329802,Talking Biotech Podcast,0,0,2,3,79,84
1006337409,Off Panel: A Comics Interview Podcast,1,1,0,1,52,55
1006433135,Always A Lesson's Empowering Educators Podcast,1,0,0,0,49,50
1006557991,Passive Real Estate Investing,3,1,3,8,185,200
1006655503,Lighthouse Hockey: for New York Islanders fans,2,5,2,1,13,23
1006942473,The Homemaking Foundations Podcast,0,3,2,2,43,50
1006974447,Missing,205,80,49,24,142,500
1007021910,The Glass Cannon Podcast,0,0,1,0,49,50
1007344621,"Salesman.org - Salesman Podcast, This Week In Sales, Sales School And More...",0,0,0,6,62,68
1008452319,InvestED: The Rule #1 Investing Podcast,19,12,24,10,135,200
1008577710,The Pitch,4,7,8,13,118,150
1009093452,Rabbi Daniel Kalish Shas Illuminated,0,0,0,0,2,2
1009197596,Maed in India,0,0,0,0,11,11
1009386477,SlipAngle powered by TrackTuned,0,0,1,1,47,49
1009470193,Wellness Force,2,0,0,0,48,50
1009644227,SiftPop,0,1,1,0,22,24
1009853057,NFL Talking Heads Fantasy Football Podcast,4,1,1,6,46,58
1010493715,Real Estate Uncensored - Real Estate Sales & Marketing Training Podcast,5,0,0,0,45,50
1010619816,Bloke In A Bar,0,0,0,0,2,2
1010678148,Matty & The Caddie,3,3,0,1,33,40
1010686786,Private Pilot Podcast by MzeroA.com,0,0,0,0,14,14
1010687213,Instrument Pilot Podcast by MzeroA.com,0,0,1,0,6,7
1010694405,CFI Podcast by MzeroA.com,0,0,0,0,5,5
1010695603,Inspire Aviation Podcast by MzeroA.com,0,0,0,0,1,1
1010738108,CBS Sunday Morning with Jane Pauley,5,4,4,5,13,31
1010962669,Speak Up For The Ocean Blue,1,0,1,1,82,85
1011492832,Best Drum and Bass Podcast,0,0,0,0,50,50
1011668648,Decoder with Nilay Patel,75,34,23,11,57,200
1011924486,Physical Preparation Podcast – Robertson Training Systems,0,0,0,1,41,42
1011997523,The Renaissance: A History of Renaissance Art.,3,0,3,2,25,33
1012136787,Spiritual Psychic with Sara Wiseman Show,0,0,0,0,3,3
1012145180,Overly Animated Podcast,4,3,2,2,26,37
1012570406,REAL AF with Andy Frisella,0,2,2,2,292,298
1012623331,LearnDoBecome Radio,1,2,0,0,25,28
1012713381,Hunt Talk Radio,8,3,2,4,212,229
1013225660,Ear Snacks,10,1,4,2,33,50
1013226980,Padre Peregrino,1,0,0,0,68,69
1013272774,Boss Girl Creative | Unconventional Business Wisdom,0,0,1,0,49,50
1014116331,The Food Blogger Pro Podcast,0,0,1,2,144,147
1014257063,Conan Neutron's Protonic Reversal,0,2,2,0,12,16
1014348960,Hearts of the Dulcimer,0,0,0,0,26,26
1014654399,Victor Davis Hanson's The Classicist,3,0,0,2,45,50
1014731221,From The Runway Up: An Airport and Aviation Podcast,0,0,0,0,10,10
1014738314,Tabletop Champions - Real Play D&D 5E (DND 5e),1,0,0,2,47,50
1014759821,Advanced TV Herstory,1,0,0,0,8,9
1015078747,ManTalks Podcast,1,2,0,1,73,77
1015210035,Hot Copy,0,0,1,1,28,30
1015394113,The Good Phight: for Philadelphia Phillies fans,14,13,15,8,157,207
1015729196,The Infinite Now,1,0,0,1,19,21
1015738084,Urban Wildlife Podcast,0,0,0,4,4,8
1016037208,Book Club for Kids,2,1,6,3,38,50
1016231664,Daily Zen,1,0,1,0,7,9
1016295072,Ghostbusters Interdimensional Crossrip,0,0,0,0,36,36
1016752437,Activity Quest,3,0,0,0,6,9
1016760065,King Falls AM,2,1,1,3,43,50
1016928343,Weird Tales and the Unexplainable,7,2,1,3,54,67
1017003702,Autism Science Foundation Weekly Science Report,1,1,0,0,3,5
1017074168,Omar Suleiman,0,0,0,0,8,8
1017103666,Insight Hour with Joseph Goldstein,1,0,0,0,24,25
1017192753,Nutrition Matters Podcast,4,1,2,0,43,50
1017211614,Fallout Off the Record - A Fallout Podcast,7,4,3,5,218,237
1017325738,Rule Breaker Investing,4,0,2,0,97,103
1017392627,Loving Without Boundaries,1,0,0,0,18,19
1017583072,Cop Doctors,0,0,0,0,7,7
1017927121,Cookery by the Book,0,1,0,2,5,8
1017971475,Fantasy Bites,3,0,1,0,30,34
1018124010,Commander's Brew,2,0,0,1,47,50
1018144428,The Construction Leading Edge Podcast,0,1,0,0,40,41
1018225068,Hello PhD,1,0,1,2,25,29
1018262895,Loan Officer Leadership,0,0,0,0,15,15
1018701693,The Jenkins & Jonez Podcast,4,0,2,2,130,138
1018710197,OK Talk - Paranormal Tales of Mysterious Travels,1,1,2,3,87,94
1018952191,Theology in the Raw,5,1,0,1,67,74
1019315354,The Modern West,1,0,0,1,22,24
1019576853,Software Engineering Daily,0,0,0,0,2,2
1019622752,Rabbi Daniel Lapin,2,0,0,0,55,57
1019700531,The Perez Hilton Podcast with Chris Booker,45,7,11,25,412,500
1019780519,In Plain Cite,0,0,0,0,6,6
1020146838,Bilal Philips,1,0,0,0,0,1
1020147522,Zakir Naik,0,0,0,0,1,1
1020669587,No Guitar Is Safe,0,0,0,0,50,50
1020690238,The Real Story,1,1,1,1,14,18
1020815439,Unorthodox,5,3,0,11,238,257
1020840453,Fit + Vibrant You,1,0,0,0,37,38
1020880772,The Hunt Backcountry Podcast,2,0,0,8,490,500
1021126077,HOME Podcast,4,8,4,6,247,269
1021242759,Retro Warriors,1,0,0,1,48,50
1021295179,The SweetGeorgia Show,0,0,0,0,14,14
1021331410,Double Tap – A Podcast for the Fighting Game Community,0,0,0,0,16,16
1021340531,Quanta Science Podcast,1,0,3,1,17,22
1021422295,Mind of The Warrior,2,0,0,2,46,50
1021703062,Our Fake History,4,0,1,4,41,50
1021735830,"Ann Kroeker, Writing Coach",0,0,0,0,17,17
1021817294,"The Strategy Skills Podcast: Management Consulting | Strategy, Operations & Implementation | Critica...",0,0,0,0,7,7
1021836339,Better Than Happy,2,1,1,0,46,50
1022404158,The Weekly Briefing,0,0,0,0,8,8
1022438086,The Jacki Daily Show,0,2,0,0,4,6
1022441491,Perpetual Traffic,2,2,2,1,43,50
1022495556,The Membership Guys Podcast with Mike Morrison,0,0,0,0,44,44
1022539239,Reasonable Doubt,11,8,2,7,22,50
1022700383,The Elective Rotation: A Critical Care Hospital Pharmacy Podcast,0,0,2,0,45,47
1022705760,The Pelvic Health Podcast,0,0,0,0,5,5
1022737612,GeekVerse Podcast,21,7,2,2,37,69
1022877899,Marina Ventura: Kids Guide to Our Planet,0,0,0,0,2,2
1022908801,Super J-Cast,6,1,2,3,56,68
1023115441,Buddhist Society of Western Australia,0,0,1,1,17,19
1023150373,Saints Happy Hour,3,2,3,2,67,77
1023224738,Lore Watch,1,7,6,5,27,46
1023234452,Harris Fantasy Football Podcast,23,5,12,3,457,500
1023264209,Black Men Can't Jump [In Hollywood],4,3,1,18,445,471
1023334577,Wanderlust Swingers - Swinging Lifestyle,0,0,0,1,49,50
1023376595,SBJ Morning Buzzcast,2,0,1,1,2,6
1023385674,Pats Pulpit: for New England Patriots fans,5,1,2,3,20,31
1023488671,Watching the Throne: A Lyrical Analysis of Kanye West,2,1,1,2,44,50
1023761733,"SaaS Interviews with CEOs, Startups, Founders",5,2,1,2,90,100
1023815223,Indie Film Hustle® - A Filmmaking Podcast with Alex Ferrari,1,1,0,6,78,86
1024068765,FML FPL - Fantasy Premier League Podcast,1,0,1,1,28,31
1024072304,Love Over Addiction,0,0,1,1,48,50
1024190279,The Arts of Language Podcast,0,0,0,0,14,14
1024192472,HumaNature,0,0,0,0,56,56
1024207975,Sell or Die with Jeffrey Gitomer and Jennifer Gluckow,2,0,0,4,126,132
1024247322,Limetown,6,3,8,9,24,50
1024389633,Hardwood Knocks: An NBA Podcast,9,1,0,5,106,121
1024389997,High and Mighty,3,1,0,1,45,50
1024822151,Skidmarks Show,0,0,0,0,44,44
1025054420,Entrepreneur Network Podcast,1,1,0,1,6,9
1025244022,Style Matters,2,2,1,1,31,37
1025268152,The Thriving Artist,0,0,1,0,11,12
1025326955,Finding Mastery,5,2,2,2,39,50
1025399574,Ride the Lightning: Tesla Motors Unofficial Podcast,2,2,1,2,43,50
1025470195,Spacepod,0,0,1,2,159,162
1025633056,English Premier League podcast: EPLpod,6,5,4,8,175,198
1025768401,Coin Concede: A Hearthstone Podcast,0,1,1,0,48,50
1025864075,What It Takes,1,1,1,0,73,76
1026750035,Audiotrainer | Deutsch lernen | Deutsche Welle,0,0,0,0,2,2
1027152189,Briefly with OZY,4,1,1,1,9,16
1027216124,Cruise Radio News Briefs,0,0,0,0,21,21
1027312526,Natural Meditation podcast,0,0,0,0,3,3
1027328897,Out on the Wire,0,0,0,1,23,24
1027400535,Edit Your Life,2,0,3,5,40,50
1027430378,JAMA Clinical Reviews,6,1,2,2,39,50
1027584309,Hoge and Jahns: a show about the Chicago Bears,10,4,4,9,302,329
1027603976,"The Law School Toolbox Podcast: Tools for Law Students from 1L to the Bar Exam, and Beyond",3,5,2,3,37,50
1027658451,Local Mouthful: A podcast about food and home cooking,0,0,0,2,3,5
1027680998,FlightCast,0,0,1,0,12,13
1028531064,Get Booked,5,1,8,13,86,113
1028771571,The Elite Advisor Blueprint®: A Podcast for Financial Advisors,0,0,0,2,48,50
1028877816,The Yarn,0,0,1,2,29,32
1028908750,Hidden Brain,204,114,102,120,2160,2700
1028911150,The Modern Customer Podcast,0,0,0,1,33,34
1029038371,Detective,9,10,22,16,196,253
1029088717,Weapon Wheel Podcast,5,0,0,3,28,36
1029121973,Airline Weekly Lounge,7,5,0,1,12,25
1029288349,8 Minute Millionaire: Learn the Secrets of Millionaire Entrepreneurs,3,2,2,1,42,50
1029297168,House Call With Dr. Hyman,2,1,0,1,16,20
1029751323,J. Brown Yoga Talks,6,1,3,3,37,50
1030019034,Live Awake,0,0,0,0,50,50
1030050704,Respectful Parenting: Janet Lansbury Unruffled,0,0,0,0,5,5
1030058294,Ghost Stories the Podcast,0,1,1,4,31,37
1030232536,Your Morning Basket,0,0,0,3,47,50
1030249182,Living The Gimmick: A Pro Wrestling Podcast,1,1,0,1,27,30
1030367902,"4x4 Earth - The 4WD, Camping, Fishing and Outdoors podcast.",0,0,0,0,6,6
1030685050,SLEEP MEDITATION with Lauren Ostrowski Fenton,1,1,0,1,27,30
1030940208,Our Lifestyle Podcast (OLP),0,0,0,0,50,50
1030984057,The Sensibly Speaking Podcast,0,1,1,0,17,19
1031047856,The Sugar Daddy Formula Podcast,3,0,2,0,15,20
1031099411,Therapy Chat,0,2,1,1,46,50
1031143256,Food Heals,0,0,1,0,49,50
1031214925,10 Minute Bhagavad Gita Sessions from Ask Sri Vishwanath Show. How Bhagavad Gita Can Help You Solve ...,0,0,0,0,2,2
1031243664,DC on SCREEN: Zack Snyder's Justice League,0,0,0,0,10,10
1031363405,The Ten Minute Bible Hour Podcast,0,1,0,1,323,325
1031567659,Yahoo Fantasy Football Forecast,21,17,13,14,143,208
1031590716,The Indian Startup Show,0,1,0,3,5,9
1031601814,The ASMR Podcast,5,1,2,3,10,21
1031623200,The Straight Shooters,0,0,0,1,6,7
1031637583,Speech Therapy: Storm of the Brains,0,0,0,2,27,29
1031705346,Top of Mind with Julie Rose,0,0,0,1,5,6
1031936205,The Friend Zone,2,6,9,8,25,50
1031943208,College Football Live,18,8,7,3,8,44
1032044245,The Boss Mom Podcast - Business Strategy - Work / Life Balance - -Digital Marketing - Content Strate...,8,2,0,0,40,50
1032089864,Help Me Teach The Bible,0,0,0,2,38,40
1032157163,Always Cheating: A Fantasy Premier League Podcast (FPL),3,0,1,2,48,54
1032555599,Galleycast,0,0,0,0,2,2
1032751476,The Joan Hamburg Show,1,0,2,0,4,7
1032835304,The Baggage Reclaim Sessions,0,0,0,0,101,101
1032846074,Mindfulness Meditation Podcast,0,0,1,0,7,8
1032909038,Life After God,0,0,1,0,30,31
1032970775,The Tone Mob Podcast,0,1,2,2,64,69
1033011814,The Astral Hustle with Cory Allen,0,0,1,2,197,200
1033048640,The Mindset Mentor,42,21,35,42,1435,1575
1033282990,End-of-Life University,0,0,0,0,16,16
1033364998,The Earth Collective,0,0,0,2,31,33
1033620094,OPTIMIZE with Brian Johnson | More Wisdom in Less Time,0,0,1,2,47,50
1033690074,Grants Rants Hollywood Talk,8,3,3,5,83,102
1034096699,Live Happy Now,4,1,1,1,43,50
1034104649,Night Owl Radio,0,1,2,2,45,50
1034204376,Clear To Send: Wireless Network Engineering,0,0,0,1,21,22
1034379593,Locked On Lakers - Daily Podcast On The Los Angeles Lakers,39,7,7,5,442,500
1034407594,The Modern Drummer Podcast,17,3,2,2,244,268
1034578881,The Western Bowhunter Podcast,0,0,0,7,165,172
1034601476,Loving BDSM,2,1,2,2,43,50
1034659232,The Haunted Estate,3,5,4,8,67,87
1034940481,Around The World With The Archibald Project,0,1,0,3,46,50
1034958991,The Fantasy Authority Fantasy Football Podcast,2,2,3,6,45,58
1034974185,The Lead with Jake Tapper,29,6,9,4,36,84
1035011998,The Tao of Self Confidence,0,0,0,2,198,200
1035087290,What's This Tao All About?,2,1,0,5,51,59
1035148051,Daily Motivation Podcast,0,0,0,2,1,3
1035168120,The Cooligans: A Comedic Soccer Podcast,1,4,1,2,378,386
1035668219,Pediatric Emergency Playbook,0,0,0,1,29,30
1035709473,Bad Boy Running,0,0,0,1,13,14
1035789058,Leadership and Business,0,0,0,0,16,16
1036157294,#WizardTeam: A Harry Potter Podcast,0,1,3,2,64,70
1036167679,The Better Leaders Better Schools Podcast with Daniel Bauer,0,0,0,1,49,50
1036269464,Song by Song,1,0,0,0,5,6
1036276968,Scene on Radio,2,0,4,4,490,500
1036294870,SweetWhispers Podcast,15,4,5,2,24,50
1036379102,6 Minute Vocabulary,0,0,0,2,4,6
1036401333,Claude VonStroke presents The Birdhouse,0,0,0,1,20,21
1036630080,The Movie Graveyard,0,0,0,1,17,18
1036675582,Artist Decoded,1,1,2,1,71,76
1037128898,Animals Today Radio,0,1,0,0,0,1
1037173387,The Fit2Fat2Fit Experience,0,1,1,1,47,50
1037423108,Editors in Conversation,0,0,0,0,1,1
1037455598,Leading Learning  - The Learning Business Podcast,0,0,0,0,13,13
1037691804,Relationship Alive!,1,1,0,2,83,87
1037718896,Into The Wilderness with Byron Pace,0,0,0,0,22,22
1037722896,Technology Flows : Salesforce Architecture Podcast,0,0,0,0,1,1
1037924282,Agile Answers,0,0,0,0,15,15
1038082516,The Hookblast Podcast with Mike McCready,0,0,0,1,3,4
1038134586,The Spanish Dude Podcast (Audio),1,0,0,1,30,32
1038292563,Matters of State - Underreported Issues in World News & International Relations,0,0,0,1,17,18
1038314297,Headcanon,0,0,0,0,56,56
1038357955,The Terri Cole Show,0,0,1,0,49,50
1038458641,Steal the Show with Michael Port,0,0,1,4,162,167
1038531011,Business of Dentistry,0,0,0,0,14,14
1038932247,Grow My Accounting Practice | Tips for Accountants & Bookkeepers to Grow Their Business,3,0,0,1,27,31
1038974883,Good Morning Vogue,11,7,5,0,13,36
1039032256,Awards Chatter,5,2,4,5,143,159
1039097111,Locked On Magic - Daily Podcast On The Orlando Magic,4,2,2,0,29,37
1039178520,The Early Childhood Research Podcast,0,0,0,0,15,15
1039214964,TurfNet RADIO,0,0,0,0,2,2
1039413502,Kotaku Splitscreen,8,5,7,4,26,50
1039481487,The Potter's House At One LA,0,1,0,0,12,13
1039511252,Little Stories for Tiny People: Anytime and bedtime stories for kids,0,0,0,0,2,2
1039540784,A Small Voice: Conversations With Photographers,1,0,0,1,31,33
1039562972,Inspire Nation Show with Michael Sandler,3,4,7,10,204,228
1039621715,Bodega Boys,1,1,1,3,44,50
1039639115,Recording Studio Rockstars,2,1,1,3,210,217
1039644241,The Tastes of India Podcast in Hindi : Healthy Living Tips and Cookery Show,0,0,0,1,8,9
1039662268,Wooden Overcoats,0,0,1,0,49,50
1039692339,A Sustainable Mind - environment & sustainability podcast,0,0,0,2,74,76
1039708229,Brown Ambition,3,1,1,2,193,200
1039714402,The History of the Twentieth Century,0,0,0,1,49,50
1039715134,Teacher Tactics: High school teaching strategies,0,0,0,0,12,12
1039729852,Jesse Lee Peterson Radio Show,39,1,2,1,57,100
1039751243,PetaPixel Photography Podcast,0,0,3,9,38,50
1039910852,The Chicago Audible - Chicago Bears Podcast and Postgame Show,5,2,0,12,335,354
1039976787,History of Indian and Africana Philosophy,0,1,0,2,14,17
1040046560,End of All Hope,5,13,13,7,12,50
1040190323,The Cashflow Academy Show,2,0,0,0,20,22
1040221975,Chicago's Morning Answer with Dan Proft & Amy Jacobson,1,0,0,0,11,12
1040280961,Business Game Changers with Sarah Westall,2,0,0,1,10,13
1040370097,The Six Figure Photography Podcast With Ben Hartley,1,0,0,0,49,50
1040380210,Pride of Detroit: for Detroit Lions fans,18,9,11,20,152,210
1040481893,THE ADAM BUXTON PODCAST,10,4,4,16,714,748
1040570923,Resourceful Designer,0,0,0,1,57,58
1040614570,Not So Standard Deviations,4,11,9,2,27,53
1040940802,Becoming Your Best | The Principles of Highly Successful Leaders,0,0,0,3,96,99
1040955947,Design Notes,0,0,0,0,3,3
1041003003,Flying and Life Podcast,0,0,0,0,5,5
1041068895,Seamwork Radio: Sewing Stories,0,0,0,1,49,50
1041122387,Girlboss Radio,25,22,17,25,111,200
1041153303,Oddball Pilot Radio: Fuel for an unconventional flying career,0,0,0,0,3,3
1041201977,TigerBelly,6,1,4,4,35,50
1041419531,Liverpool FC - KopTalk,0,0,0,0,1,1
1041509070,At Home With Sally,1,0,0,1,48,50
1041684187,The History of India Podcast,0,1,1,3,15,20
1041801905,The Birth Hour - A Birth Story Podcast,4,2,3,6,35,50
1041814489,Food Heaven Podcast,0,0,1,0,49,50
1041859215,CORE - Core Gaming for Core Gamers,4,0,2,0,44,50
1041868690,DJ Shinski Mixes,0,0,0,0,15,15
1041876428,God Awful Movies,8,4,1,3,356,372
1041984671,Brunch,7,0,1,4,251,263
1042013130,Undressed,0,0,0,1,35,36
1042017993,iNTO THE FRAY RADIO - An Encounter with the Abyss that is the Paranormal,16,10,8,6,208,248
1042028608,NFL Live,20,6,8,8,18,60
1042028615,My Wife is Going to Kill Me,2,1,0,2,43,48
1042342868,Best of Roula & Ryan,0,1,0,0,5,6
1042352601,The Car Pro Show,1,0,1,0,1,3
1042361179,KILL TONY,17,1,1,2,29,50
1042368254,The Herd with Colin Cowherd,206,80,86,100,278,750
1042390551,PS I Love You XOXO - A Kinda Funny PlayStation Podcast,27,4,1,1,17,50
1042399760,ICNYU Podcasts,0,0,0,0,2,2
1042433083,The Weeds,12,5,12,6,15,50
1042433465,Little Gold Men,12,9,9,13,174,217
1042442760,Street Soldiers Radio,1,0,0,0,2,3
1042454970,Affirmation Pod,3,0,2,0,45,50
1042517353,The Effortless Swimming Podcast,0,0,0,1,4,5
1042631089,Dan Snow's History Hit,10,8,16,16,284,334
1042635536,The Chris Moyles Show on Radio X Podcast,12,1,1,5,113,132
1042673386,Science Of Ultra,0,0,1,1,39,41
1042702460,Dirty South Soccer: for Atlanta United FC fans,2,3,4,4,23,36
1042709241,VOUS Church,0,1,0,0,86,87
1042809784,Spooked!,5,0,0,1,5,11
1042827113,Wharton FinTech Podcast,0,1,1,0,17,19
1043107219,Agile in 3 Minutes,0,0,0,0,8,8
1043245989,The Dig,0,0,4,3,146,153
1043544702,The Cricket Sadist Hour,0,0,0,0,10,10
1043593599,The Axe Files with David Axelrod,3,3,3,4,37,50
1043699613,The Bill Simmons Podcast,192,43,38,28,197,498
1043758104,Office 365 Exposed,0,0,0,1,0,1
1043994904,A Delectable Education Charlotte Mason Podcast,0,0,1,1,48,50
1044002385,Pregnancy Podcast,8,5,8,1,28,50
1044062004,"Eat Clean, Run Dirty Podcast",0,1,1,2,22,26
1044066741,SCARED? - A Paranormal Podcast,47,15,9,17,191,279
1044115915,Basketball Coach Unplugged ( A Basketball Coaching Podcast),0,0,2,3,138,143
1044173337,The General Hospital After Show Podcast,3,1,0,5,24,33
1044196249,My Dad Wrote A Porno,18,8,14,8,452,500
1044209457,The Rugby Pod,0,1,0,1,19,21
1044301397,A Taylored Adventure To Happiness,4,1,0,0,45,50
1044738282,BrotoGP - Motorcycle Road Racing,1,1,2,1,45,50
1044753097,"The Grappling Central Podcast: The biggest names in Brazilian Jiu-Jitsu (BJJ), MMA and Grappling",2,0,1,2,60,65
1044840362,IGN Unfiltered,1,1,0,1,50,53
1044963177,Sex Talk With My Mom,2,1,0,2,45,50
1045171376,The Andrew Klavan Show,6,1,1,0,42,50
1045461151,Learn 15 Minute Spanish for your Job Podcast,1,1,0,0,9,11
1045736181,Contra Krugman,8,3,0,2,112,125
1045850849,The Hockey PDOcast,7,2,7,5,239,260
1045871373,SunCast,0,0,0,0,40,40
1045873679,My Seven Chakras With AJ,0,0,1,1,48,50
1045990056,LifeAfter/The Message,2,1,3,2,42,50
1046045197,Sales Enablement Podcast with Andy Paul,0,0,0,0,167,167
1046063478,The Ash Cash Show,0,0,1,0,10,11
1046094700,Singletracks Mountain Bike Podcast,1,2,0,6,106,115
1046121933,Mom Struggling Well,0,1,2,0,47,50
1046138184,Your Virtual Upline Podcast,0,0,1,1,198,200
1046413761,The Show About Science,7,0,4,4,83,98
1046421064,The Coffee Podcast,0,2,0,0,19,21
1046423132,Bandrew Says Podcast,0,0,0,0,19,19
1046616567,Wrestling Sheet Radio,29,5,6,6,59,105
1046733414,CHITHEADS from Embodied Philosophy,0,0,1,0,30,31
1046737870,Fundraising Voices from RNL,0,0,0,0,2,2
1046958127,ABA Law Student Podcast,0,0,0,0,7,7
1046978749,Causality,0,0,0,0,13,13
1046992703,The Liberty Podcast,1,1,4,7,37,50
1047012231,Beautiful Writers Podcast,0,0,1,2,128,131
1047320599,"Find Your Dream Job: Insider Tips for Finding Work, Advancing your Career, and Loving Your Job",3,3,4,4,186,200
1047332516,Unresolved,50,24,37,36,353,500
1047335260,The Ben Shapiro Show,735,65,40,110,1675,2625
1047366529,Met Opera Guild Podcast,0,1,2,2,28,33
1047430562,The Official Red Chip Poker Podcast,12,1,1,0,36,50
1047467866,Legends: National Wrestling Hall of Fame,0,0,0,0,1,1
1047470403,Slums of Film History,0,0,0,0,41,41
1047498785,The Unraveling Podcast,1,0,0,1,47,49
1047779421,Tour Junkies: PGA Tour Betting & DFS,10,2,2,6,480,500
1047879204,Better Podcasting,2,0,0,2,18,22
1047970546,Two Friends Mixes,0,0,1,0,20,21
1048375034,The History of Literature,5,9,2,8,116,140
1048483221,Let's Fight a Boss,1,0,1,1,33,36
1048488265,The Wild Die: A Savage Worlds RPG Podcast,0,0,0,1,9,10
1048515651,Israel Story,3,0,0,1,247,251
1048612826,DC on RMD,2,0,0,0,3,5
1048766030,The Vinyl Guide,2,0,2,2,44,50
1048770490,SinBin.vegas Podcast,2,0,5,2,45,54
1048830863,ALIEN THEORISTS THEORIZING,27,6,9,5,453,500
1049169349,Locked On Celtics - Daily Podcast On The Boston Celtics With Rainin' J's,18,5,4,7,370,404
1049173993,Get Sex-Smart,0,0,0,0,8,8
1049183167,TANIS,1,5,4,0,40,50
1049223522,The Crazy Ex-Girlfriend Podcast,0,0,0,0,1,1
1049406375,Story Grid Podcast,2,2,6,8,182,200
1049412059,This Day in Maine,0,0,0,1,2,3
1049452428,Women Of The Hour,123,6,3,26,342,500
1049460553,writing class radio,4,0,0,1,76,81
1049730336,Story Time with Yarn Story Factory | Free Stories for Kids!,5,1,1,0,11,18
1050102620,The Modern Mann,0,1,0,0,45,46
1050321415,Over It And On With It,2,0,3,0,45,50
1050430296,The New Yorker Radio Hour,39,26,13,18,124,220
1050430716,"Thrive By Design: Business and Marketing Strategy for Fashion, Jewelry and Creative Brands",1,0,0,0,49,50
1050462261,Acquired,2,0,0,3,156,161
1050512159,"""They're not dolls!""",3,0,0,0,11,14
1050794610,Tripod: The Nature Photography Show,0,0,0,0,36,36
1050832450,BibleProject,0,0,0,0,32,32
1050847009,Open Floor: SI's NBA Show,74,17,16,7,385,499
1050853720,College Hoops Today with Jon Rothstein,3,2,4,3,27,39
1050956449,#GERIonICE - Physical Therapy | Fitness | Geriatrics,0,0,0,0,22,22
1051088186,The Land of Israel Network,2,0,1,0,26,29
1051156990,Wholesaling Inc,0,1,0,0,199,200
1051168436,Jim and Tomic's Musical Theatre Happy Hour,0,0,0,0,9,9
1051193720,Valley Beit Midrash,0,0,0,0,2,2
1051289963,Laravel News Podcast,0,0,0,1,11,12
1051431829,Jaret Goes to the Movies (Movie Reviews),0,0,0,0,40,40
1051557000,Science Vs,2,1,2,1,2,8
1052346812,Blood & Mud Rugby Podcast,0,0,0,0,6,6
1052350440,Throttled Motorcycle Podcast,0,1,1,3,14,19
1052353755,The Unstoppable Entrepreneur Show,0,0,0,0,50,50
1052359696,The History of Standup,0,0,0,1,49,50
1052378769,Retirement Starts Today Radio,0,0,0,4,64,68
1052541481,Zacks Market Edge,2,1,0,0,9,12
1052606381,The Intelligent Vocalist with John Henny,0,0,0,0,18,18
1052650163,The Miami Heat Beat Podcast,8,1,3,1,53,66
1052839207,Synchronicity with Noah Lampert,2,3,3,4,180,192
1052842770,The Rubin Report,89,28,19,23,341,500
1052879087,Background Mode,0,0,0,0,1,1
1052989183,Pantheon - The Music Podcast Network,6,2,5,3,64,80
1053077930,Federal Newscast,0,0,1,0,3,4
1053131863,5-Minute Daf Yomi with Rabbi Shmuel Herzfeld,0,0,0,0,12,12
1053245743,Loop Matinal,2,0,1,0,28,31
1053266080,The Cynic | A Celtic FC Podcast,0,0,0,0,5,5
1053268058,The Bright Sessions,3,3,1,4,39,50
1053276768,Sri Ramana Maharshi Teachings,0,0,0,0,1,1
1053284614,Creative Writing Career,0,1,4,1,22,28
1053299163,Google Cloud Platform Podcast,0,0,1,0,3,4
1053981528,Economic Update with Richard D. Wolff,3,0,1,2,78,84
1054081827,Game Theory Podcast,5,2,3,8,150,168
1054135564,🎧 Uplifting Trance Sessions with DJ Phalanx,1,0,0,0,4,5
1054149217,We're So Bad At Adventuring,1,0,0,1,22,24
1054235979,Ending Human Trafficking Locally and Globally,0,0,0,0,1,1
1054509922,Special Sauce with Ed Levine,2,6,7,5,18,38
1054540734,The Field Guides,2,0,0,0,112,114
1054565539,News AF - The Internet's Best News Stories that are Actual Factual News,1,1,0,1,312,315
1054720784,Forge the Narrative - Warhammer 40k Podcast,0,2,2,1,45,50
1054744455,The All Things Risk Podcast,1,0,1,0,3,5
1054817076,Pivot with Jenny Blake,0,1,0,0,49,50
1054824418,FujiLove - All Things Fujifilm. A Podcast for Fuji X and GFX Users.,6,1,0,0,10,17
1054860435,Wise About Texas,2,0,1,1,88,92
1055001251,Go-To Gal with Jaclyn Mellone: Online Marketing + Mindset for Female Entrepreneurs,3,0,1,1,45,50
1055037387,Growth Marketing Toolbox,0,0,0,1,28,29
1055044256,Most Notorious! A True Crime History Podcast,8,3,9,13,378,411
1055098034,UNKNOWN — a UFO podcast,4,0,2,2,11,19
1055121160,User Defenders – UX Design & Personal Growth,0,0,0,2,79,81
1055169471,"Surreal Talk - Cults, Conspiracies & the Paranormal",18,12,8,2,10,50
1055348656,Pantsuit Politics,40,9,7,5,439,500
1055459878,Roundball Stew,2,2,5,4,23,36
1055497887,Super Tuesday Recap - Comic Book & TV Show Reviews,0,0,1,1,41,43
1055726188,Siraj Wahhaj,0,0,1,0,0,1
1055764100,Art of Procurement,0,0,0,0,11,11
1055866423,The Akashic Reading Podcast,0,0,1,1,49,51
1056200096,Odd Lots,6,4,2,10,56,78
1056223392,Experimental Brewing,3,1,2,2,35,43
1056471528,The Weather Junkies,0,0,0,1,7,8
1056734780,GreenBiz 350,0,1,0,1,10,12
1056758008,Diesel Performance Podcast,2,0,2,4,42,50
1056793768,Black Girl Nerds,0,1,1,1,61,64
1056879870,First Draft: A Dialogue on Writing,0,0,0,1,8,9
1056948460,ArtTactic,0,0,0,1,25,26
1056952502,Lead Singer Syndrome with Shane Told,3,1,0,6,347,357
1056971799,Striking Gold: A 49ers Pod,8,3,1,3,36,51
1057023829,Teaching Jasmin How to Cook Vegan,0,0,1,0,7,8
1057045285,Inner Hoe Uprising,0,1,0,0,49,50
1057255460,The NPR Politics Podcast,208,60,68,52,354,742
1057287970,Real Estate Marketing Dude,0,1,0,0,19,20
1057307365,Local Knowledge,4,8,5,5,25,47
1057594509,Live Well Anyway,1,2,0,8,189,200
1057714949,The Next Picture Show,4,5,3,7,96,115
1057851300,Choose Your Own Religion,0,0,0,0,11,11
1058002796,IFR Flight Radio Show – IFR Flight Radio,0,0,0,0,1,1
1058705097,Selected Talks on Buddhism and Meditation by the Karmapa,0,0,0,0,4,4
1058718804,The Jason & Scot Show - E-Commerce And Retail News,0,0,0,0,46,46
1058810987,Chip & Charge,0,0,0,0,2,2
1058883968,Knightly Pleasures - Erotica for Women,5,2,3,3,59,72
1058911614,The Press Box,85,35,40,25,314,499
1058911829,Art Works Podcast,0,0,0,0,4,4
1059045374,Anna Faris Is Unqualified,6,3,7,6,28,50
1059147899,Healthy Critters Radio,0,0,0,0,3,3
1059459491,Girl Camper,5,3,4,2,90,104
1059509178,The Science of Success,0,1,1,0,48,50
1059554013,School of House Flipping | Real Estate Investing,1,0,0,0,49,50
1059573987,The Keto Diet Podcast,2,1,1,0,46,50
1059597638,Let's Talk Stocks with Sasha Evdakov - Improve Your Trading & Investing in the Stock Market,2,0,1,0,7,10
1059663016,Reckonings,3,0,1,1,57,62
1059753731,Computer Science,0,0,1,0,0,1
1060183650,"Coach Your Brains Out, by Gold Medal Squared",0,0,0,0,4,4
1060273831,The Mindful Kind,1,0,0,0,49,50
1060685475,The Countryside Hour,0,0,0,0,1,1
1060868464,From Ring to Veil a Wedding Planning podcast,0,1,0,1,30,32
1060917092,Saturday Morning Cartoon Boom,2,2,1,1,44,50
1061222770,Outside/In,0,5,2,5,259,271
1061344282,The Italian American Podcast,1,2,2,1,76,82
1061361026,Drinkin' Bros Podcast,7,1,0,0,42,50
1061406250,Ways & Means,0,0,0,0,15,15
1061467382,CoinWeek,1,0,0,1,6,8
1061513970,Breakup Recovery Podcast,1,0,1,2,13,17
1061704535,The Property Management Show,0,0,1,0,8,9
1061855908,Ordinary Vegan Podcast,0,0,2,0,48,50
1061976747,TrailManners,0,0,0,1,60,61
1062077484,Sportsmen's Nation - Whitetail Hunting,3,1,5,2,147,158
1062151999,Hablando a 24 Frames / Hablando PoP,0,0,0,0,15,15
1062333296,The Harvard EdCast,1,2,0,2,3,8
1062394049,The Garden Path Podcast,0,0,0,0,5,5
1062418176,True Crime Garage,19,17,16,20,427,499
1062520214,Zen for Everyday Life with Matt Valentine: Mindfulness | Guided Meditation - Buddhaimonia,0,1,0,1,12,14
1062532126,The Sky Sports Football Podcast,10,4,4,2,9,29
1062660794,"Schoeny Presents AGR  Workout Music | Non-stop 1 hour mixes : Gym Music, High energy mix",0,0,0,0,30,30
1062738845,A Tale of Two Hygienists Podcast,1,0,2,0,56,59
1062997995,The WAN Show Podcast,2,0,5,3,39,49
1063004379,The Wisdom of Compassion: Exploring The Values of Buddhism Through Timeless Meditation Techniques,1,0,0,0,2,3
1063149340,The Haz Mat Guys podcast,0,0,0,0,50,50
1063165791,The Health Ranger Report,8,4,4,1,33,50
1063393054,Bitch Sesh: A Real Housewives Breakdown,10,2,2,4,32,50
1063458936,Sleep with Silk: ASMR Triggers,14,3,0,5,15,37
1063469747,When They Was Fab: Electric Arguments About the Beatles,0,0,1,1,7,9
1063849084,Chameleon Academy Podcast with Bill Strand,0,0,0,0,34,34
1064051384,Love Life with Matthew Hussey,0,2,3,6,241,252
1064365676,The Youth Baseball Edge Podcast with Rob Tong: Coaching | Drills | Strategy,0,0,0,2,147,149
1064413273,Inspirational Living: Life Lessons for Success & Happiness,5,6,2,4,33,50
1064413714,WhatCulture Wrestling,18,4,5,5,265,297
1064604170,Care & Discipleship Podcast – IBCD,0,0,0,0,1,1
1064651383,The Sarah Fraser Show,13,2,8,4,332,359
1064701549,AFP: American Family Physician Podcast,2,0,1,2,44,49
1064835727,The Essential Oil Revolution w/ Essential Oils Educator Samantha Lee Wright,2,4,0,2,42,50
1064929463,Science(ish),0,0,0,0,2,2
1064966935,The Emotionally Healthy Leader Podcast,0,0,0,0,18,18
1064978212,LadyGang,86,16,30,16,352,500
1065019039,The Word on Fire Show - Catholic Faith and Culture,6,3,4,6,481,500
1065050908,Conservative Review with Daniel Horowitz,13,5,6,2,160,186
1065311542,Radio Dharma,0,0,0,0,2,2
1065331619,Meaningful Life Skills: Weekly Global Class,0,0,0,0,1,1
1065348531,Fangirls Going Rogue: Star Wars Conversation from a Female POV,1,1,0,2,59,63
1065379126,Smarter Brain Now,0,0,0,0,13,13
1065472102,40+ Fitness Podcast,2,1,1,2,44,50
1065480415,Your First Hundred Million - As Read by the 50 Billion Dollar Man,0,0,0,0,9,9
1065492988,The OCD Stories,2,0,3,2,43,50
1065515588,Professional Book Nerds,2,3,4,6,52,67
1065559535,Modern Love,0,0,0,4,18,22
1065628305,Functional Medicine Research with Dr. Nikolas Hedberg,0,0,0,1,24,25
1065802449,How To Be A Better Drinker,1,0,0,0,20,21
1065958718,"Brazilian Portuguese Podcast, by RLP",0,0,1,0,9,10
1065964913,UpToDate Talk,0,2,1,2,13,18
1066024691,Rune Soup,6,2,6,4,60,78
1066056346,The Talent Angle with Scott Engler,0,0,0,1,26,27
1066085248,The X-Files Podcast,3,1,2,1,40,47
1066154319,Sleep with Silk: Nature Sounds,5,7,2,13,23,50
1066326306,Blueshirts Breakaway: A show about the New York Rangers,13,6,3,1,260,283
1066375775,BLISTER Podcast,0,0,1,1,27,29
1066569149,The Crafter's Box Podcast,0,0,0,0,2,2
1066636552,Campground of the Week,0,0,0,0,28,28
1066936563,Beyond Reality Paranormal Podcast,18,6,4,9,68,105
1066959663,Awesome Marriage Podcast,0,0,1,2,47,50
1067005678,"2 Docs Talk: The podcast about healthcare, the science of medicine and everything in between.",4,4,2,3,37,50
1067020550,Book of Mormon Central,1,0,2,0,19,22
1067068502,MASTERPIECE Studio,3,2,5,11,58,79
1067344634,Space,2,0,0,1,8,11
1067405180,Pro Wrestling Illustrated Presents,0,1,0,0,0,1
1067471691,The Director's Cut - A DGA Podcast,0,0,4,6,24,34
1067573465,This Week in Evolution,1,0,1,1,15,18
1067586243,Ask The Tech Coach,0,0,0,0,1,1
1067605198,The Camino Podcast,0,0,0,0,5,5
1067649051,Audio Arguendo,0,0,0,0,2,2
1067688314,Optimal Living Daily: Personal Development & Minimalism,0,2,3,4,41,50
1067992218,DNVR Denver Broncos Podcast,15,7,7,8,198,235
1068022483,Golf Central Podcast,3,1,3,2,5,14
1068207118,The Robin Sharma Mastery Sessions,0,0,4,8,120,132
1068288639,Overtime,1,4,1,1,42,49
1068563276,Getting Curious with Jonathan Van Ness,12,7,14,28,439,500
1068590753,Educators Lead with Jay Willis,0,0,0,0,50,50
1068930986,Golf Monthly Clubhouse,0,0,0,0,1,1
1068940771,The Guilty Feminist,13,2,5,6,474,500
1069427485,Radio Labyrinth,0,1,1,0,82,84
1069494505,DNVR Colorado Rockies Podcast,0,2,1,3,31,37
1069497109,DNVR Colorado Avalanche Podcast,5,5,9,8,130,157
1069638315,Stuff I Never Knew Trivia Game Show Podcast,2,0,0,1,31,34
1069738341,Overly Animated Miraculous Ladybug Podcasts,0,1,1,3,33,38
1069742339,Slow Russian,1,0,1,0,48,50
1069757084,The Minimalists Podcast,6,3,1,1,39,50
1070016067,"The 85 South Show with Karlous Miller, DC Young Fly and Chico Bean",0,1,1,2,46,50
1070322219,Jocko Podcast,10,1,2,5,480,498
1070377913,OldPreMeds Podcast,0,0,0,0,23,23
1070595177,The Librarian Is In,4,2,1,6,161,174
1070598794,"Weight Loss Made Real: How real women lose weight, stop overeating, and find authentic happiness.",0,0,0,1,49,50
1070649025,Craig Groeschel Leadership Podcast,0,0,0,0,29,29
1070655328,Hoardganize Podcast,2,0,0,0,12,14
1070974651,Fantasy Golf Degenerates,4,0,4,3,194,205
1071032154,"Tiny Leaps, Big Changes",10,5,7,1,27,50
1071096710,SokukoJi Buddhist Temple Monastery,0,0,0,0,2,2
1071100620,The Power Company Podcast,1,0,2,8,144,155
1071148475,Rare & Scratchy Rock 'N Roll Podcast,0,0,0,0,13,13
1071171446,Ready For Takeoff - Turn Your Aviation Passion Into A Career,0,0,0,0,43,43
1071185901,Toyota Trucks and Trails Podcast,0,0,0,2,32,34
1071230619,Quran Weekly,0,0,0,0,2,2
1071230854,The Deen Show,0,0,0,0,3,3
1071239521,Submitted For Your Approval - A Twilight Zone Podcast,2,1,1,1,21,26
1071406906,School of Self-Image,0,0,0,0,50,50
1071469441,The Cabral Concept,2,0,1,0,47,50
1071472964,Natural MD Radio,0,0,1,0,49,50
1071545581,The Scarecast,21,15,10,13,141,200
1071557714,Talking Beards,0,1,0,0,8,9
1071578260,Secular Buddhism,2,0,2,3,189,196
1071598101,Counter Worlds,0,0,0,1,5,6
1071616809,Retro Movie Geek,0,2,1,0,9,12
1071620152,Smart Poker Study Podcast,0,0,0,0,40,40
1071714260,Put A Ring On It: The Wedding Planning Podcast,0,0,0,0,6,6
1071716704,The Biddy Tarot Podcast: Tarot | Intuition | Empowerment,0,0,0,1,49,50
1071726419,Unravel A Fashion Podcast,4,2,2,0,13,21
1071735505,Manchester United Weekly Podcast,0,0,0,1,32,33
1071736656,Speaking Easy - A Cocktail Podcast,0,0,0,0,15,15
1071748483,"Beyond Bourbon Street, an Insider's Guide to New Orleans",2,1,1,0,304,308
1071755499,Bartender at Large,0,0,0,1,15,16
1071809231,Dreams Unlimited Travel Show - A Weekly Discussion About Travel and Dreams Unlimited Travel,1,0,0,0,14,15
1071831261,The CyberWire Daily,4,0,2,4,107,117
1071990583,Real Talk With Jimmy Moore,4,3,3,3,37,50
1072002470,Play Therapy Community,0,0,1,0,15,16
1072021022,DK Pittsburgh Sports,3,0,5,6,60,74
1072170823,Presidential,4,2,5,8,31,50
1072185017,Aquarium Co-Op Podcast,4,2,1,0,43,50
1072212202,Simply Charlotte Mason Homeschooling,0,0,0,0,9,9
1072228536,"Grace & Grit Podcast:  Helping Women Everywhere Live Happier, Healthier and More Fit Lives",0,0,0,0,50,50
1072258963,OPTAVIA® Habits of Health® Community Time Podcast,0,4,0,1,5,10
1072307993,The Money Show,0,2,2,1,16,21
1072421783,Mentors for Military Podcast,0,0,1,0,26,27
1072469956,Fox Across America w/ Jimmy Failla,5,2,0,2,41,50
1072506427,Seeking Wisdom,0,0,0,0,50,50
1072618042,Wise Traditions,3,2,0,0,45,50
1072833310,Risen Motherhood,0,1,3,2,494,500
1072835737,The Speaker Lab,1,0,0,3,196,200
1072931592,The Blogging Millionaire,0,3,8,0,189,200
1073196213,Motivational Mornings,1,1,1,0,18,21
1073226719,Pivot,186,111,132,153,597,1179
1073270208,The Retro Hour (Retro Gaming Podcast),0,2,0,0,29,31
1073275062,Body Kindness,0,1,1,0,48,50
1073349789,The Authority Hacker Podcast,0,1,2,3,44,50
1073354021,50 Years of Maximum Rock n' Roll,0,0,1,1,67,69
1073361940,Girlfriends (A Podcast for Catholic Women),0,0,0,2,106,108
1073364619,SinCast - Presented by CinemaSins,10,10,9,11,139,179
1073386634,IoT This Week,0,0,0,0,1,1
1073455415,Video Creators,0,0,0,2,24,26
1073460738,Untangle,3,4,0,3,28,38
1073473354,Salt Strong Fishing,6,3,1,4,486,500
1073482419,Bruce Springsteen Sings the Alphabet,0,0,0,2,31,33
1073499086,What Should I Read Next?,6,2,5,7,180,200
1073520842,Will You Accept This Rose?,12,1,2,10,440,465
1073554021,The Jason Manford Show,0,1,2,4,63,70
1073694283,H.A.M. Radio Podcast,3,3,0,4,66,76
1073779629,Eye on Security,0,0,1,0,0,1
1073817284,Cultures of Energy,0,0,0,0,12,12
1073885415,B2B Growth: Your Daily B2B Marketing Podcast,1,0,0,1,148,150
1074067483,On The Merits,0,0,1,0,0,1
1074070278,History of Westeros (Game of Thrones),12,8,13,10,157,200
1074126728,Insatiable,1,1,0,0,48,50
1074167723,Walk to Work - A Mobile Hearthstone Podcast,2,1,0,0,46,49
1074177662,The History of Judaism: The History and Story of the Jews,0,0,0,0,1,1
1074379805,Exploring Unschooling,1,0,0,0,24,25
1074394632,The Mind Your Business Podcast,0,0,0,2,98,100
1074410525,Greater Boston,0,2,0,2,46,50
1074507850,My Favorite Murder with Karen Kilgariff and Georgia Hardstark,222,94,72,42,568,998
1074822039,The Xbox Two Podcast,3,1,0,0,7,11
1075393336,Teach 4 the Heart,1,1,1,1,31,35
1075720295,The Amazon FBA Private Labeler Show,0,0,0,0,50,50
1075734700,Dietitian Connection Podcast,0,0,0,0,3,3
1075744322,Personal Finance with Warren Ingram,0,0,1,0,3,4
1076039478,Adventure Rider Radio RAW Motorcycle Roundtable Talks,0,0,1,0,24,25
1076077727,Off The Script w/JDfromNY,13,0,2,3,282,300
1076129620,"School of Psych | Insightful interviews and stories about psychology, culture, and relationships.",0,0,1,0,23,24
1076142249,Libros para Emprendedores,0,0,0,1,66,67
1076170311,Sewing Out Loud,8,11,3,1,27,50
1076186016,Nursing School Struggles by NURSING.com (NRSNG),0,0,0,0,3,3
1076207687,"Chrissie, Sam and Browny",7,3,2,4,37,53
1076213200,RSD Sanga,0,0,0,0,1,1
1076213902,Dynamic Duel: DC vs Marvel,0,0,0,2,131,133
1076222594,The Billions Podcast,3,6,7,2,12,30
1076365673,Art Made Easy,1,0,0,0,49,50
1076377547,Who? Weekly,0,1,1,1,47,50
1076405618,Thrivetime Show | Business School without the BS,14,6,3,3,174,200
1076435153,Golf Guide Podcast,0,0,0,1,10,11
1076436648,The Tom Ferry Podcast Experience,4,2,1,2,117,126
1076448558,Becoming A Data Scientist Podcast,0,0,0,1,5,6
1076460838,Plein Air Art Podcast,1,2,3,1,17,24
1076629098,The Beginner Photography Podcast,0,0,0,0,89,89
1076673018,The Love Food Podcast,0,0,0,1,49,50
1076731927,The Call The Midwife Podcast,1,0,1,0,6,8
1076806340,Manage This - The Project Management Podcast,0,0,0,1,7,8
1077045014,Global Recon,0,0,1,7,42,50
1077135613,Why We Fly,0,0,0,0,8,8
1077418457,FiveThirtyEight Politics,236,69,64,23,108,500
1077458313,Mortgage Marketing Radio,0,0,0,0,50,50
1077530854,Victoria's Lift,4,1,3,1,41,50
1077592473,MedConversations,0,0,1,0,2,3
1077793493,GrowCast,1,0,3,2,44,50
1077823917,Dopey: On the Dark Comedy of Drug Addiction,1,0,1,1,47,50
1077888124,Widow Cast:  Widows Empowering Widows - How to Self Coach Through Grief,0,0,0,1,53,54
1078098622,1001 Classic Short Stories & Tales,3,3,1,3,40,50
1078112813,Unexplained,12,12,21,23,432,500
1078117734,Living Unconventionally,0,0,0,0,59,59
1078121654,Drywater,0,0,0,1,4,5
1078207549,The Lesbian Romantic,3,0,0,2,45,50
1078225050,The Greatest Generation,5,0,0,0,45,50
1078252534,Wedding Planning Podcast,0,0,4,2,44,50
1078431985,Rolling Stone Music Now,5,5,2,14,24,50
1078466875,Picture This: Photography Podcast,3,3,1,1,75,83
1078480299,Legends of Surgery,0,0,0,2,29,31
1078657833,Urban Forestry Radio,0,0,0,0,2,2
1078713316,The Crossover NBA Show with Chris Mannix and Howard Beck,14,3,11,11,78,117
1078714736,"Weird Darkness: Stories of the Paranormal, Supernatural, Legends, Lore, Mysterious, Macabre, Unsolve...",26,13,10,18,433,500
1078804724,The No Film School Podcast,4,2,4,3,41,54
1079001185,The Working Songwriter,0,0,0,0,50,50
1079078977,Building your T-Shirt Empire,0,0,0,0,10,10
1079172742,Macro Voices,5,3,5,3,184,200
1079271584,Slave Stealer,0,0,0,0,26,26
1079278616,Silhouette Zero: Star Wars Edge of the Empire Actual Play Podcast,0,0,0,1,49,50
1079598542,Afford Anything,6,2,6,4,182,200
1079680168,Padres Hot Tub,4,1,0,2,14,21
1079952715,Real Estate News: Real Estate Investing Podcast,0,0,0,0,11,11
1080024347,Micheaux Mission,0,1,0,2,54,57
1080090608,"Space Nuts | Astronomy, Space and Science News",0,0,0,1,18,19
1080144159,BEHIND THE CURTAIN: BROADWAY'S LIVING LEGENDS » Podcast,0,0,0,1,49,50
1080169763,The Hamilcast: A Hamilton Podcast,6,4,7,7,176,200
1080170463,The Deconstructionists,9,11,10,11,133,174
1080172128,CIIS Public Programs,0,0,0,0,6,6
1080174248,Ten Tenths Podcast,0,1,1,0,47,49
1080215490,Build Your House Yourself University,2,0,0,2,114,118
1080234163,The Tennis Files Podcast,0,0,0,0,31,31
1080364582,Extreme Productivity with Kevin Kruse,0,1,1,12,181,195
1080382371,The Intuitive Hour: Awaken Your Inner Voice,1,3,2,1,29,36
1080467174,Recode Media,4,1,2,4,39,50
1080467712,Triathlon Coaching with TOWER 26- Be Race Ready Podcast,0,1,1,0,33,35
1080477414,Madhouse Chicago Hockey Podcast,11,2,5,6,62,86
1080487291,Won Buddhism Dharma Talks,1,0,1,0,5,7
1080505022,The Hook Up,2,1,2,2,38,45
1080634709,Locked On Dynasty Football,8,4,11,9,190,222
1080864041,Sounds Good with Branden Harvey,0,0,3,3,44,50
1080871005,Spirits,3,5,1,2,39,50
1080900600,The Anxiety Guy Podcast,0,1,0,1,48,50
1080935752,"SpaceTime with Stuart Gary | Astronomy, Space & Science News",7,2,2,2,30,43
1080974028,6 Minute Grammar,0,0,1,1,6,8
1080978877,The Complete HP Lovecraft Podcast,0,0,0,0,7,7
1081046968,Your Daily Revolution,0,0,0,1,67,68
1081072067,Is This Going To Cause An Argument,1,0,0,2,47,50
1081124929,The Vanished Podcast,30,36,52,18,150,286
1081130355,Foot Traffic Podcast,1,0,0,1,48,50
1081244497,Real Crime Profile,102,59,69,52,218,500
1081280312,Morrisonic: A Podcast About the Portland Timbers (Mostly),0,0,0,2,31,33
1081294989,Joe on Joe - A G.I. Joe Podcast,0,0,0,1,22,23
1081455328,Misery Loves Company,15,2,1,0,32,50
1081457352,The Folktale Project,1,0,0,1,22,24
1081481629,Columbia Energy Exchange,0,1,0,2,18,21
1081501574,Blueshirt Banter: for New York Rangers fans,13,9,3,2,58,85
1081584611,Vox Conversations,50,19,31,27,373,500
1081585361,Bernie and Sid,5,2,3,6,34,50
1081733743,No Joke Podcast,0,0,1,0,49,50
1081967443,Jesus Calling: Stories of Faith,4,2,0,3,37,46
1081967784,Commentary Magazine Podcast,5,1,3,3,38,50
1082012464,FBI Retired Case File Review,4,7,9,11,178,209
1082170831,The Prancing Pony Podcast,3,0,0,2,195,200
1082207851,The Ask Mike Reinold Show,0,1,1,4,44,50
1082214582,Talking Chop: for Atlanta Braves fans,8,5,4,5,83,105
1082234332,alinajim,1,0,1,1,18,21
1082244480,Dr Justin Coulson's Happy Families,0,0,1,0,73,74
1082252585,The Secret Room | True Stories,17,6,9,11,170,213
1082262134,"Accessible Astrology Podcast with Eugenia Krok, MA - Astrologer Trained in Psychotherapy",22,1,3,3,129,158
1082504877,On the Other Hand: Ten Minutes of Torah,1,1,1,1,35,39
1082548342,The Dynasty Dude | Dynasty Fantasy Football | Fantasy Football,3,0,3,3,380,389
1082586770,Mexico Unexplained,4,1,4,3,12,24
1082603272,Manga Mavericks,0,1,0,0,4,5
1082678396,Crime in Sports,2,0,0,0,48,50
1082703097,"Andy Zodin's KickServeRadio.com, featuring Mats Wilander and Jonny Levine",0,0,0,0,2,2
1082710266,So Fly Fishing,0,0,0,0,6,6
1083070207,Against the Odds,0,2,1,0,21,24
1083180382,Wrench Nation,3,0,0,0,9,12
1083319184,Earth Speak with Natalie Ross and Friends,0,1,1,0,76,78
1083324677,Foreplay Radio -- Couples and Sex Therapy,0,0,1,1,48,50
1083410032,Running Commentary,0,0,0,0,1,1
1083418078,Relatos & Leyendas Urbanas,0,0,0,1,7,8
1083618984,Rental Property Owner & Real Estate Investor Podcast,2,0,1,0,47,50
1083627744,I-KID-A-POD,0,0,0,0,8,8
1083737218,Literature and History,1,2,1,2,194,200
1084020770,The Trail Went Cold,48,41,27,51,330,497
1084105171,Dateable: Your insider's look into modern dating,5,5,4,5,128,147
1084200702,Mindful Recovery,0,0,0,0,23,23
1084208738,The F*ck It Diet with Caroline Dooner,2,3,3,5,37,50
1084340508,The Curious Cases of Rutherford & Fry,0,0,3,0,61,64
1084410565,The OneFootball Podcast,0,0,1,1,68,70
1084439570,Vinnie Paz Presents The Broad Street Breakdown,0,0,0,0,110,110
1084484313,Door Bumper Clear - Dirty Mo Media,10,4,6,9,471,500
1084700219,Someone Who Isn't Me,0,0,0,0,23,23
1084736600,Marveling at Marvel's Marvels,7,3,2,6,76,94
1084872411,Pregnancy Confidential,8,12,6,4,20,50
1085300491,The RV Entrepreneur,2,1,0,2,195,200
1085301578,The Dean Graziosi Show,2,1,0,2,126,131
1085828103,Slow German,1,0,0,0,14,15
1085913209,Conscious Chatter with Kestrel Jenkins,0,0,0,0,33,33
1085919903,Best of Barstool Radio,20,3,4,2,21,50
1085976393,Cincinnati Soccer Talk,0,0,0,1,45,46
1086081512,Lost Origins,10,4,6,2,49,71
1086141856,The Crush,0,0,1,0,18,19
1086314758,Mufti Ismail Menk,0,0,0,0,4,4
1086315045,Return Home,1,3,8,2,36,50
1086404799,MrCreepyPasta's Storytime,7,5,9,9,170,200
1086413253,The Behavioral Observations Podcast with Matt Cicoria,1,3,1,5,112,122
1086509138,The BIRTHFIT Podcast,1,0,3,0,35,39
1086855191,When Calls the Heart Reviews and After Show - AfterBuzz TV,0,1,0,1,18,20
1087110764,The Way I Heard It with Mike Rowe,18,8,12,12,226,276
1087147821,Ten Percent Happier with Dan Harris,24,15,30,30,330,429
1087159044,The Resident Evil Podcast,1,1,0,0,11,13
1087252154,Kung Fu Drive-In Podcast,0,0,0,1,39,40
1087275550,The Eating Disorder Recovery Podcast,0,0,0,0,50,50
1087454803,The 10 Minute Jazz Lesson Podcast,0,0,0,0,31,31
1087487035,Trial Lawyer Talk Podcast,0,0,0,1,35,36
1087542066,Better Health While Aging Podcast,0,0,0,0,27,27
1087579283,Around The Rim,0,0,0,2,29,31
1087614779,Fat Mascara,21,11,17,11,140,200
1087684663,40 Weeks Pregnancy Podcast,1,2,1,0,46,50
1087831900,Khalid Al Jalil,0,0,0,1,1,2
1087855153,Raad Mohammad al Kurdi,0,0,1,0,7,8
1087926635,Earn Your Happy,2,0,0,0,48,50
1087985958,Insijam Podcast with Dalal Al-Janaie,0,1,3,1,37,42
1087991703,Ocean Science Radio,0,0,0,0,7,7
1088015938,Judaism Unbound,1,0,0,2,58,61
1088331670,False Neutral,0,0,0,0,9,9
1088398598,Obsessed Show,0,0,0,0,28,28
1088504227,Born In June Raised In April: What Adoption Can Teach the World,0,0,0,0,12,12
1088587697,Nonprofits Are Messy: Lessons in Leadership | Fundraising | Board Development | Communications,0,1,1,1,47,50
1088641856,Real Talk School of Nursing,0,0,0,0,15,15
1088683533,Analytics on Fire,0,0,0,3,18,21
1088698598,#PTonICE Daily Show,0,0,2,1,9,12
1088699608,The Mad Mamluks,5,2,2,4,57,70
1088880557,POS,3,0,0,1,29,33
1088906982,Justin Bieber Podcast,2,1,2,1,3,9
1088942953,Art Ed Radio,0,0,2,1,22,25
1088943065,Behavior Analysis,0,0,0,0,8,8
1088978354,Alice Isn't Dead,5,8,4,4,29,50
1089022756,Pardon My Take,89,20,15,8,368,500
1089027054,The Brian Buffini Show,2,0,2,0,196,200
1089047924,Front End Happy Hour,1,0,1,2,27,31
1089059721,After Sectionals,0,0,0,1,34,35
1089216339,Someone Knows Something,29,13,19,36,403,500
1089370742,RealzTenisFanz Podcast,1,1,0,0,10,12
1089420711,Naptime Is Sacred,0,0,0,0,11,11
1089555645,There Goes the Neighborhood,2,1,1,2,56,62
1089649401,The Hospital Finance Podcast,0,0,0,0,2,2
1089655956,Everything Hertz,0,0,1,0,10,11
1089780289,A Good Football Show,9,7,11,11,296,334
1089866508,#Hip-Hop #Reggae #Electronic Dance Music,2,0,0,1,7,10
1089973241,The Official SaaStr Podcast: SaaS | Founders | Investors,1,0,0,0,19,20
1090009312,Made For Living Well,0,0,1,1,48,50
1090136163,Dev Game Club,0,0,0,1,49,50
1090147504,Beautiful Stories From Anonymous People,15,7,4,4,470,500
1090216419,The Star Wars Collector Podcast,0,0,0,0,10,10
1090260338,Bite,3,3,4,0,29,39
1090272358,Learn True Health with Ashley James,1,1,0,1,47,50
1090433226,The Resus Room,0,0,0,0,2,2
1090500561,Outside Podcast,14,6,17,23,128,188
1090600339,The John Campea Show Podcast,14,3,4,24,435,480
1090666976,The Penumbra Podcast,3,3,5,7,182,200
1090684236,The Self Publishing Show,0,0,0,0,9,9
1090692055,"The Motivation Movement | Inspirational Quotes, Daily Advice, Lifestyle Design, Personal Development",2,0,1,2,24,29
1090705905,Secret Transmission Podcast,11,2,1,3,69,86
1090743486,Sports Radio Detroit,2,0,0,0,7,9
1090744241,School Psyched!,0,0,4,2,11,17
1090807493,Rock Your Retirement Show,1,0,1,1,31,34
1090822398,Optimal Finance Daily,10,6,9,9,166,200
1091031079,The Uncertain Hour,0,3,2,2,43,50
1091310056,The Love U Podcast with Evan Marc Katz,0,0,1,4,78,83
1091337608,Athletico Mince,11,0,5,12,327,355
1091341048,Soft Skills Engineering,0,1,0,1,35,37
1091353410,The Movie Show,0,0,2,0,11,13
1091363992,Locked On Auburn -  Daily Podcast On Auburn Tigers Football & Basketball,7,6,3,1,110,127
1091402153,STEM-Talk,0,0,0,2,48,50
1091448948,ABA Inside Track,1,0,1,1,96,99
1091474629,Perfect Organism: The Alien Saga Podcast,1,2,2,1,11,17
1091709555,Embedded,46,36,8,10,194,294
1091741758,JAMA Pediatrics Editors' Summary,0,0,0,0,1,1
1091763413,Paychecks & Balances,2,1,1,1,45,50
1091861630,THIRD EYE DROPS,2,0,4,2,218,226
1091969414,Far From Home,0,0,1,3,45,49
1092096635,Mile High Endurance Podcast,0,0,0,0,3,3
1092207516,Distraction with Dr. Ned Hallowell,1,0,0,2,47,50
1092220986,MEDIA INDIGENA : Indigenous current affairs,0,0,0,0,17,17
1092246229,Policing Matters,0,1,1,1,4,7
1092247887,Giants Talk: A San Francisco Giants Podcast,5,0,1,2,28,36
1092280776,The Koy Pond with Jo Koy,4,5,1,5,35,50
1092361338,Las Culturistas with Matt Rogers and Bowen Yang,2,1,1,0,46,50
1092391018,Downloadable Content,0,0,0,0,14,14
1092660175,Parenting Beyond Discipline,5,4,1,3,30,43
1092674204,The Shameless Mom Academy,0,1,0,0,49,50
1092700322,Sunday School Dropouts,12,1,1,1,160,175
1092751338,Business Made Simple with Donald Miller,14,13,9,9,155,200
1092800054,Sleep Whispers,6,1,4,4,35,50
1092904387,Jim Robbie and the Wanderers,1,1,1,3,14,20
1092994298,Anime Arcade,0,0,0,0,6,6
1092995407,Uncanny County,2,0,2,0,46,50
1093028505,The Skinny Confidential Him & Her Podcast,19,2,2,4,23,50
1093031383,"Behind the Porn Scenes with Lelu Love - Sex, Dating and My Real Life",1,0,0,1,16,18
1093063276,Unsafe Space,2,0,3,0,16,21
1093135143,Wild Heart Meditation Center,1,0,0,1,10,12
1093184840,Music Makers and Soul Shakers with Steve Dawson,0,0,0,2,52,54
1093260018,Trumpcast,9,2,3,2,34,50
1093272481,The Car and Driver Podcast,3,0,0,2,12,17
1093320744,Barstool Rundown,23,2,7,4,118,154
1093364587,The West Wing Weekly,9,7,6,9,469,500
1093422763,Free Hypnosis | Hypnotherapy | Self help | Life coaching with Kim Little,0,0,0,0,8,8
1093471812,The Drive Podcast,2,1,2,0,10,15
1093570212,The New Yorker: The Writer's Voice - New Fiction from The New Yorker,5,5,6,10,74,100
1093613867,ASCD  Learn  Teach  Lead Radio,0,0,0,1,2,3
1093699006,Short & Curly,2,1,0,4,43,50
1093725475,Coffee + Crumbs Podcast,6,3,1,0,40,50
1093776529,Mark And Sarah Talk About Songs,3,0,0,2,45,50
1093807015,The Original Cast,0,2,1,1,44,48
1093934861,Scuderia F1: a Formula 1 podcast,0,0,1,0,4,5
1094120819,The Hardcore Self Help Podcast with Duff the Psych,4,0,1,1,44,50
1094372050,Are We There Yet?,0,2,0,1,19,22
1094394003,Talking Out Your Glass podcast,0,0,0,0,17,17
1094448991,Starcalled,0,1,1,2,17,21
1094490100,Monsters Among Us Podcast,17,2,8,6,467,500
1094554104,New Slang,0,0,0,0,16,16
1094870430,Learn Jazz Standards Podcast,1,0,1,0,48,50
1094911742,The Clubhouse with Shane Bacon,4,0,0,4,376,384
1095013227,Hammer Factor,3,1,0,2,21,27
1095068557,Becoming Wise,0,0,0,2,26,28
1095138637,The Magnus Archives,1,0,1,1,197,200
1095141478,Bark n Wag 15 Minute Vet Talk,0,0,0,0,40,40
1095157047,Flite Test Community Podcast,0,0,0,0,10,10
1095176665,EM Clerkship,0,0,0,0,50,50
1095195175,Fairway Rollin',65,21,12,15,322,435
1095382766,The Privacy Advisor Podcast,0,1,2,1,4,8
1095461885,Spiritual Awakening - Dr. Erin Podcast,0,0,0,0,62,62
1095530140,The Christian History Podcast,2,1,0,2,62,67
1095785626,The Incredible Dr. Polcast,0,0,0,0,17,17
1095859621,Not By Accident,2,0,1,13,192,208
1096112069,The Sneak Diss Sneaker Podcast,2,0,1,0,48,51
1096113994,Harry Potter and the Sacred Text,30,15,9,10,436,500
1096416947,Yoga | Birth | Babies,0,1,0,0,49,50
1096622066,Ctrl Alt Delete,4,6,6,5,106,127
1096811000,Parts Per Billion,0,1,1,1,2,5
1096830182,Drink Champs,31,19,30,33,386,499
1096865604,JEL,0,0,0,0,11,11
1096923241,Talk of the TOUR Golf Podcast,0,0,0,2,4,6
1096925458,Golf Talk America,1,1,0,0,2,4
1096925460,On the Mark Golf Podcast,0,1,3,1,36,41
1097012082,The Vikings After Show Podcast,0,0,1,0,5,6
1097166428,The Presentation Podcast,0,0,0,0,14,14
1097193327,2 Dope Queens,3,1,0,1,45,50
1097284330,The Easy Allies Podcast,2,1,2,1,44,50
1097326296,Not Your Mother's Menopause with Dr. Fiona Lovely,1,1,0,1,22,25
1097336671,Don't Give Up The Ship Podcast,0,0,0,0,6,6
1097402685,WeMartians Podcast,0,0,0,1,20,21
1097417804,Chapo Trap House,6,1,7,4,32,50
1097449598,Lifetime Cash Flow Through Real Estate Investing,9,4,10,6,171,200
1097564705,Tales Of The Black Badge - A Wynonna Earp Fan Podcast,1,0,1,1,41,44
1097591566,How to Succeed Podcast,1,0,0,1,26,28
1097637934,The Dance Podcast,0,0,1,1,10,12
1097661809,Square Roots - THE Classic RPG Podcast,0,0,2,4,113,119
1097687350,The Paid Search Podcast | A Weekly Podcast About Google Ads and Online Marketing,0,1,0,0,49,50
1097690465,The Real Weird Sisters: A Harry Potter Podcast,3,1,7,5,184,200
1097696129,"The Fifth Column - Analysis, Commentary, Sedition",9,3,2,4,32,50
1097852666,Thinner Peace in Menopause,2,1,0,2,45,50
1097862282,Pints With Aquinas,6,5,3,8,478,500
1097989571,The Sivana Podcast,3,1,3,22,247,276
1098006247,"Master Mind, Body and Spirit",1,0,0,1,187,189
1098071434,The Steam Rollers Adventure Podcast,0,0,0,0,18,18
1098194172,Archive 81,2,1,1,2,44,50
1098263655,The Homeschool Highschool Podcast,0,0,0,0,14,14
1098329116,Firehouse Problems Kitchen Table Solutions Podcast,0,0,0,0,3,3
1098413063,The Tony Robbins Podcast,1,0,0,1,2,4
1098603931,Digital Health Today 360 with Dan Kendall,0,0,0,0,25,25
1098781682,"ClutterBug Podcast - Organize, Clean and Transform your Home",3,0,0,3,44,50
1098802558,HerMoney with Jean Chatzky,3,2,0,5,155,165
1098856846,The Hardcore Closer Podcast,0,0,0,0,100,100
1099004465,Agency Intelligence,0,0,0,0,9,9
1099053340,Sasquatch Syndicate,2,2,2,2,19,27
1099188767,Crochet Circle Podcast,0,0,0,0,3,3
1099277290,Macro Musings with David Beckworth,0,0,0,1,49,50
1099304101,The Fallen State (Audio),2,0,0,1,15,18
1099363803,Magical Mystery Radio: Conspiracy & Paranormal Review,17,4,6,4,44,75
1099478699,Based on a True Story,3,0,3,3,70,79
1099540724,5 Minute Marketing with Brian Moran,0,0,0,2,48,50
1099620894,The Saltwater Aquarium Radio Podcast,0,0,0,0,50,50
1099630309,"The Other Stories | Sci-Fi, Horror, Thriller, WTF Stories",2,2,3,5,38,50
1099656930,Skyrim Book Club,0,0,0,2,24,26
1099690502,Sleep with Silk: Binaural Beats,2,0,2,1,10,15
1099849462,Nordeast Podcast,1,0,0,0,60,61
1099980720,"Lab Values Podcast (Nursing Podcast, normal lab values for nurses for NCLEX®) by NURSING.com (NRSNG)",0,0,0,0,4,4
1100077750,Black N' Gold Hockey Podcast,0,0,2,2,52,56
1100417601,Talk Easy with Sam Fragoso,0,1,1,1,81,84
1100563458,The History of Ancient Greece,7,3,4,3,33,50
1100596518,Live Kabbalah – Weekly Zohar Study,0,0,1,0,2,3
1100818156,I'll Have Another with Lindsey Hein Podcast,1,2,7,7,483,500
1100949693,Heroine,0,0,2,1,197,200
1101136985,Following On in India Cricket Podcast,1,0,0,1,1,3
1101679010,Negotiate Anything,1,1,0,0,48,50
1101754136,Coffee House Shots,19,5,12,26,252,314
1101822747,AUAUniversity,0,0,0,0,2,2
1101900764,Parenting Great Kids with Dr. Meg Meeker,14,5,2,6,23,50
1101916802,"Research in Action | A podcast for faculty & higher education professionals on research design, meth...",0,0,0,1,8,9
1101933650,The Trial Lawyers College Podcast,3,0,2,0,9,14
1101948864,Cop Life,0,0,0,0,87,87
1101953069,Wire Talk with Karen Stubbs,0,0,0,0,50,50
1101989658,PSG Talking,0,0,0,0,11,11
1102030053,Pure Natural Pregnancy,0,0,0,0,3,3
1102055778,TILT Parenting: Raising Differently Wired Kids,0,1,0,0,49,50
1102094287,The NBA Podcast,4,0,1,4,14,23
1102107854,"Moshe, Midrash, and Mashiach",2,0,0,0,2,4
1102144048,Jojo's World,0,0,1,0,32,33
1102255353,Puck Soup,42,20,15,14,373,464
1102298716,The Party Room,16,8,3,3,118,148
1102505312,Nonprofit Leadership Podcast,0,0,1,1,25,27
1102562418,Schlaulicht,0,0,0,1,0,1
1102569130,The Guitar Hour Podcast,0,0,0,0,8,8
1102634452,Thaddeus Ellenburg's Casual Friday,0,0,0,1,5,6
1102878180,Small Town Horror,23,34,28,28,87,200
1102929069,Viking Age Podcast,1,0,0,2,47,50
1103246927,A Balancing Act,0,0,0,0,40,40
1103320303,But Why: A Podcast for Curious Kids,4,0,1,5,40,50
1103400101,Buck Reising on 104-5 The Zone,1,3,4,0,6,14
1103813295,The Fantasy Football Smackdown,1,2,1,1,84,89
1103840521,REALITY OF REALITY,4,0,0,0,70,74
1103910723,Dynasty Happy Hour | Fantasy Football | Dynasty | NFL | NFL Draft,9,3,4,6,100,122
1103913361,Nerdette Recaps With Peter Sagal,29,21,15,7,182,254
1103992568,Love Smarter: Relationship Advice for Women Who Like Personal Development,1,1,0,1,23,26
1104078567,The ThinkOrphan Podcast,0,0,0,0,25,25
1104134900,Why Service Design Thinking,0,0,0,0,12,12
1104409807,Pageant Planet,0,0,0,0,9,9
1104427904,Whiskey Politics,1,0,0,1,28,30
1104535262,FDNY Pro,0,0,0,0,5,5
1104769476,The Fitness And Lifestyle Podcast,0,0,0,0,11,11
1104844373,The Guitar Knobs,0,0,0,0,26,26
1105145426,"The How of Business - How to start, run & grow a small business.",0,0,0,0,42,42
1105264849,ScareZone - Halloween Horror Nights Podcast,1,1,0,0,32,34
1105270013,Sylvester Stallone Fan Podcast Network,0,0,0,2,21,23
1105451767,The Zen Mountain Monastery Podcast,0,0,1,0,4,5
1105457520,Main Engine Cut Off,0,0,1,0,27,28
1105760780,Massenomics Podcast,0,0,0,0,50,50
1105934044,A Quest for Magic and Steele - DnD,1,0,0,3,46,50
1105991757,The Bill Barnwell Show,19,7,2,10,73,111
1106517231,That Couple Next Door,4,0,0,1,39,44
1106548091,How to Be Awesome at Your Job,6,5,3,2,155,171
1106608410,Over The Monster: for Boston Red Sox fans,2,2,4,5,13,26
1106620664,Learn to Code With Me,1,1,4,8,127,141
1106679693,Clever,2,5,3,2,66,78
1106739747,Bionic Planet: Reversing Climate Change by Restoring Nature,0,0,0,0,13,13
1106762925,Mountain & Prairie with Ed Roberson,0,0,1,2,158,161
1106880454,Copy That Pops: Writing Tips and Psychology Hacks for Business,0,0,1,0,49,50
1106886477,The Jump,31,11,14,9,41,106
1107033358,Mastering Nutrition,0,0,1,1,48,50
1107185328,To Be Continuous,0,0,0,0,3,3
1107327166,The Hosel Jockeys Golf Podcast,0,0,0,0,49,49
1107494901,Be Remarkable.,0,1,0,0,7,8
1107533906,The Lavendaire Lifestyle,2,0,0,2,46,50
1107627222,The Disruptive Voice,0,0,0,0,5,5
1107637427,Critically Acclaimed Network,0,1,2,0,61,64
1107712211,The Jam with Marmalead,4,1,4,4,6,19
1108086835,These Football Times,1,1,3,1,4,10
1108147135,WBEZ's Reset,0,0,2,1,38,41
1108412026,The Lando Cal Experience,0,0,0,0,5,5
1108496943,Best In Galaxy,0,0,0,0,1,1
1108539202,Servant Leadership Institute Podcast,0,0,0,2,0,2
1108561398,The Focus Group,0,0,1,0,33,34
1108662449,Circulation on the Run,0,0,0,0,5,5
1108729395,Tripawd Talk Radio,0,0,0,0,1,1
1108749751,Docs Outside The Box - Ordinary Doctors Doing Extraordinary Things,0,1,0,1,124,126
1108934644,Freya's Singing Tips: Train Your Voice | Professional Singers | Singing Technique | Mindset,0,1,0,0,9,10
1109013655,Bear Download — A Chicago Bears podcast,12,7,7,7,24,57
1109062967,Royal Blue: The Everton FC Podcast,0,1,1,2,10,14
1109064476,Blood Red: The Liverpool FC Podcast,0,0,5,1,29,35
1109139637,Mikeadelic,1,0,1,2,114,118
1109233211,Anansi Storytime,1,0,0,1,2,4
1109249666,Off the Cuffs: a kink and BDSM podcast,2,1,0,0,47,50
1109271715,The Ringer NBA Show,111,53,45,65,226,500
1109282822,The Ringer NFL Show,144,64,78,51,163,500
1109360879,exocast,1,0,0,1,2,4
1109580065,OPB Politics Now,1,0,5,2,19,27
1109768097,@ Sea with Justin McRoberts,0,0,0,0,22,22
1109801013,Millionaire Mindcast,0,2,0,1,197,200
1109880286,Blues Hockey Podcast,2,1,0,1,18,22
1109943717,AP: Australian Politics,7,1,4,6,77,95
1110183965,Cubs Related: A Chicago Cubs Podcast,5,1,0,1,80,87
1110402018,PoetryNow,0,0,0,0,2,2
1110503698,The LEO Family Fitness Podcast,1,0,0,0,49,50
1110514880,Islam for Life with Shaykh Walead Mosaad,0,0,0,0,1,1
1110641404,The Below Deck After Show Podcast,5,2,2,2,2,13
1110860681,Drew and Mike Show,9,2,2,1,36,50
1111319839,POLITICO's Nerdcast,11,7,8,7,17,50
1111739567,The Watch,66,22,35,29,224,376
1111780628,Unstoppable Recording Machine Podcast,1,0,1,4,179,185
1111784882,Elseworlds Exchange,4,0,2,0,26,32
1111786097,Carioca Connection: Brazilian Portuguese Conversation.,0,1,1,1,34,37
1111786329,Latinos Who Lunch,0,0,1,2,324,327
1111787243,"Don't Salt My Game | With Laura Thomas, PhD",1,0,2,3,38,44
1111787862,Nursing Mnemonics Show by NURSING.com (NRSNG) (Memory Tricks for Nursing School),0,0,1,0,4,5
1111792057,STEM Everyday,0,0,0,0,3,3
1111794030,The PodCask: a Podcast About Whiskey,2,0,2,0,96,100
1111796513,The Lazy Genius Podcast,1,0,2,0,47,50
1112004494,Crimelines True Crime,64,40,31,21,344,500
1112190608,Code Switch,80,18,28,28,562,716
1112194905,The Sean Hannity Show,158,14,16,16,296,500
1112233641,Hyperallergic,1,2,0,0,13,16
1112383789,Inside The Big Ring: The Podcast for Endurance Athletes,0,0,0,1,12,13
1112396528,Off the Pulpit with Rabbi David Wolpe,1,0,0,0,8,9
1112425552,Spittin Chiclets,30,6,9,14,441,500
1112605924,Harford County Living with Rich Bennett,0,0,0,0,2,2
1112620087,The Tesla Tidbits Show,0,0,1,2,13,16
1112641452,Fantasy Football Counselor - Fantasy Football Podcast,103,8,6,1,382,500
1112672017,Spidell's California Minute,0,0,0,0,2,2
1112736899,"Story Story Podcast: Stories and fairy tales for families, parents, kids and beautiful nerds.",5,0,5,3,37,50
1112764695,Dr. Joe Tatta | The Healing Pain Podcast,0,0,0,0,50,50
1112821897,Let’s Teach History:  Tips and Ideas for Teaching American History to High School Students,0,0,0,1,8,9
1112825340,Circling the Bases,2,0,1,4,28,35
1112838129,ChangeUnderground,0,0,0,0,3,3
1113056721,The Chief Customer Officer Human Duct Tape Show,0,0,1,0,14,15
1113191228,The Feast,0,0,0,1,22,23
1113193062,The Full Nerd,0,1,0,1,16,18
1113563080,On Brand with Nick Westergaard,0,1,0,3,34,38
1113583715,You Had Me at Black,26,0,1,3,75,105
1113585468,Cum Town,4,0,1,2,43,50
1113848918,Expected Buffalo | The Podcast,0,1,1,3,7,12
1114174900,Little Known Facts with Ilana Levine,2,0,0,0,48,50
1114202041,PA Power Wrestling Podcast,0,0,0,1,5,6
1114362643,The Matt & Blonde Show,2,0,0,1,47,50
1114398275,Psychedelics Today,2,0,2,3,46,53
1114569714,Early Break – 93.7 The Ticket KNTK,1,0,0,0,7,8
1114632629,PokerNews Podcast,6,2,0,2,40,50
1114936271,RC Roundtable,0,0,0,1,5,6
1114969265,The Mad Scientist Podcast,9,1,2,3,69,84
1115023437,The Instigator Podcast,2,0,0,1,6,9
1115024566,Investing in Real Estate with Clayton Morris | Investing for Beginners,26,0,5,4,65,100
1115048476,3D Muscle Journey,1,1,1,1,46,50
1115048807,The Homeschool Solutions Show,2,3,3,1,41,50
1115101341,All About Fitness,2,0,0,2,44,48
1115543715,Great Moments In Science,0,0,0,0,4,4
1115818419,Dungeon Delve – An Official Dungeons & Dragons Podcast,3,2,1,0,44,50
1116000318,Java with Juli,2,0,1,3,111,117
1116240763,Augustine,2,1,1,3,11,18
1116295539,Living Free in Tennessee - Nicole Sauce,1,1,1,0,30,33
1116303051,The TWIML AI Podcast (formerly This Week in Machine Learning & Artificial Intelligence),1,0,1,4,63,69
1116485154,Anesthesia and Critical Care Reviews and Commentary (ACCRAC) Podcast,1,0,0,0,49,50
1116487308,That Classical Podcast,1,1,0,4,119,125
1116489860,Tree Hill Talk - One Tree Hill Podcast,1,0,1,0,63,65
1116520729,Mrs. Trimble's Tuck In - Bedtime Stories,1,0,3,5,41,50
1116571844,Baalgatha : Bedtime Stories for Children,1,0,1,0,18,20
1116782774,Cultivating Place,1,2,1,0,34,38
1116847329,The Von Haessler Doctrine,4,4,2,2,50,62
1116866428,Weather: Storm Front Freaks Podcast,0,0,1,2,12,15
1116995036,Lakers Talk with Allen Sliwa,4,0,0,0,18,22
1116997629,Who Knew's Quick and Dirty Household Tips and Lifehacks,0,1,4,0,12,17
1117073822,Rope Drop Radio: A Disney Travel Planning Podcast,0,0,0,0,155,155
1117116329,Vibrant Happy Women,0,0,0,0,50,50
1117202653,Radiolab Presents: More Perfect,1,0,4,4,41,50
1117221239,CyclingTips Podcast,16,5,7,3,102,133
1117246594,The Matty Johns Podcast,6,2,5,11,75,99
1117421416,Marijuana Today Daily,12,0,4,4,80,100
1117459728,Cinephile with Adnan Virk,4,2,4,14,411,435
1117489326,Presentable,0,0,0,0,7,7
1117556964,The Chris Hogan Show,23,12,6,13,146,200
1117776582,AWS TechChat,0,0,1,0,0,1
1117951237,Black Girl In Om,0,0,1,1,48,50
1117997117,Cinema Shock,0,0,0,0,13,13
1118019442,Reading Women,0,0,0,1,52,53
1118188207,Business Is Boring,0,1,0,0,9,10
1118313513,The BBQ Beat Podcast,0,0,0,1,13,14
1118636511,Dorking Out,1,1,0,3,29,34
1118712475,Hair of the Dogcast,0,0,0,0,13,13
1118770038,The Duke Basketball Podcast,0,0,1,0,42,43
1118781520,The Homeschool Sisters Podcast,0,1,2,0,47,50
1118867383,Motley Fool Money,5,3,5,7,62,82
1118875240,Red FM Bauaa,1,0,0,2,15,18
1118938394,A Music In Time,0,0,0,0,21,21
1118969643,Betrayal Trauma Recovery,0,1,1,1,47,50
1119044000,Battles of the First World War Podcast,1,0,2,2,45,50
1119222036,Let's Know Things,1,1,2,1,45,50
1119389968,Revisionist History,180,80,88,80,1244,1672
1119435387,Team Never Quit,1,0,1,1,47,50
1119439036,2000 Books for Ambitious Entrepreneurs - Author Interviews and Book Summaries,0,0,0,1,5,6
1119698679,Near Perfect Pitch,0,0,0,0,2,2
1119808906,The Animanicast- An Animaniacs Podcast,0,0,1,0,39,40
1119855779,Precious Little Sleep Parenting Podcast,4,0,0,1,29,34
1119917335,The Great Discontent,0,0,0,0,11,11
1119939501,Be Here For A While,16,1,0,0,33,50
1120117659,Peds in a Pod: A Pediatric Board Review,0,0,1,0,6,7
1120278253,American Ninja Warrior RHAPup | Reality TV RHAPups,0,1,0,1,47,49
1120485668,The Kibbe and Friends Show,2,1,0,1,46,50
1120885936,Being Well with Dr. Rick Hanson,0,0,0,0,50,50
1120941458,Rich On Tech,0,0,0,3,38,41
1120947649,Counselor Toolbox Podcast,1,0,1,2,24,28
1120948170,Windows Central Podcast,2,1,2,0,5,10
1120964487,Go Time,2,0,0,0,7,9
1121047188,Just Fly Performance Podcast,0,0,0,1,49,50
1121077274,Writing for Children,1,2,0,8,92,103
1121362690,The Nine Club With Chris Roberts,7,0,2,2,183,194
1121391184,Within the Wires,2,0,2,9,37,50
1121407665,Sinica Podcast,9,3,3,2,67,84
1121467751,The Life Stylist,10,5,3,0,32,50
1121816957,The Hangardeck Podcast,0,0,1,0,10,11
1121846301,"Casual Preppers Podcast - Prepping, Survival, Entertainment.",2,5,3,3,144,157
1121894800,Afternoonified,14,0,1,1,16,32
1122181463,Transfert,0,0,0,2,22,24
1122201914,Magic Hour,0,0,1,1,20,22
1122207891,Hear Cincinnati,0,0,0,0,6,6
1122333284,Blamo! | Exploring Fashion with the People Who Shape It,0,0,0,1,64,65
1122376417,Young House Love Has A Podcast,8,3,5,5,179,200
1122650415,Once Upon A Crime | True Crime,38,31,30,31,370,500
1122754861,Classic BYU Speeches,0,0,3,0,15,18
1122769143,The Art Of Living with Kathy Smith,1,0,0,1,48,50
1122785133,AWS Podcast,1,1,1,1,1,5
1122804248,Unsolved Murders: True Crime Stories,148,56,112,40,244,600
1123249983,April Eight Songs & Stories,0,0,0,0,19,19
1123253491,Northwest Jeepcast,1,0,1,0,48,50
1123347203,Rose Pricks: A Bachelor Roast,47,12,10,12,266,347
1123372859,Adoptees On,0,0,1,0,37,38
1123488172,The Art History Babes,16,9,10,6,159,200
1123552997,Invest Like a Boss,2,0,0,2,96,100
1123709737,"Dear Prudence | Advice on relationships, sex, work, family, and life",7,13,3,3,24,50
1123793940,Home Inspector Podcast,0,1,0,1,3,5
1123904816,Generation Xbox - Your Home for Xbox Series X News and Opinions!,3,1,1,2,26,33
1123922160,Unchained,7,7,7,7,94,122
1124228879,UFC Unfiltered with Jim Norton and Matt Serra,49,27,33,29,362,500
1124379551,Kill By Kill,0,0,1,0,65,66
1124477585,The Roundtable,2,1,0,0,4,7
1124566025,She Explores,0,3,4,6,156,169
1124567779,The Sexually Liberated Woman,1,1,0,0,48,50
1124608295,Office Hours with Spencer Rascoff,0,0,0,0,17,17
1124616529,The Hunting Public,2,0,3,3,86,94
1124942958,The Leadership Podcast,0,0,0,0,35,35
1124982482,The Media Project,1,0,1,0,0,2
1125007560,Eleanor Amplified,2,0,1,5,42,50
1125018164,Politically Re-Active with W. Kamau Bell & Hari Kondabolu,9,7,8,5,471,500
1125066071,Meditation x Attachment with George Haas,0,0,0,0,3,3
1125158498,Encyclopedia Botanica,0,1,1,4,63,69
1125550872,Mom & Mind for Pregnancy and Postpartum Mental Health,0,0,0,0,35,35
1125635053,What You Will Learn,3,0,3,0,24,30
1125728412,Elite Full Restore,0,0,0,0,4,4
1125752101,The Community Cats Podcast,0,0,0,0,45,45
1125877319,Guided Meditations,0,0,1,1,10,12
1126021323,Side Hustle Pro,0,0,0,2,198,200
1126031966,The Nature of Causation,0,0,0,0,2,2
1126119288,"Terrible, Thanks For Asking",33,27,23,21,396,500
1126543994,Bill O’Reilly’s No Spin News and Analysis,142,22,19,22,295,500
1126568463,Locked On Bulls - Daily Podcast On The Chicago Bulls,11,3,5,7,109,135
1126663530,Reggae Lover,0,0,0,0,12,12
1126865107,This Week I Learned,2,2,0,2,32,38
1126972369,Brute Force,0,0,1,2,47,50
1127067121,"Sex Addiction, Pornography, and Sexual Purity -- Castimonia.org",0,0,0,0,8,8
1127162036,Truth From The Stand Deer Hunting Podcast,3,2,1,2,54,62
1127408595,The Fine Homebuilding Podcast,3,1,1,4,175,184
1127915772,The Chase Jarvis LIVE Show,0,0,0,0,50,50
1127945925,SharkFarmer Podcast/ agriculture farm,0,1,1,1,22,25
1128139090,BirdCallsRadio,0,0,0,0,6,6
1128237763,Conversations on Dance,1,0,0,0,35,36
1128248295,The Crazy One,0,0,2,2,150,154
1128413893,Sooo Many White Guys,19,1,0,1,29,50
1128428812,Daily Tech Headlines,2,0,2,2,17,23
1128435380,Christina The Channel,1,1,0,1,47,50
1128636404,Glorious in the Mundane Podcast with Christy Nockels,0,0,2,4,245,251
1128841871,Locked On Pelicans - Daily Podcast On The New Orleans Pelicans,4,3,2,2,88,99
1128890743,#Killstream,10,0,1,4,35,50
1128955736,The Meb Faber Show,1,1,1,4,193,200
1129287619,Airways Podcast,1,1,1,10,35,48
1129323212,Locked On Knicks - Daily Podcast On The New York Knicks,21,7,9,9,71,117
1129588849,Locked On Thunder - Daily Podcast On The Oklahoma City Thunder,10,5,1,4,64,84
1129600119,In The Circle,0,1,1,0,7,9
1129843813,En La Jugada RCN,3,0,1,0,1,5
1130124620,VeryPink Knits - Knitting Q and A,1,0,4,1,44,50
1130189253,Low FODMAP Diet and IBS Podcast,0,0,0,0,4,4
1130424845,MarsCorp,1,0,1,2,46,50
1130464057,Commercial Drones FM,0,0,0,0,38,38
1130488614,"Teach Me, Teacher",0,0,1,0,49,50
1130708584,The Mastin Kipp Podcast ,1,1,1,2,43,48
1130710911,Keepin It 100 with Konnan,18,7,10,10,241,286
1130733597,Everyday Green Home,0,0,0,0,5,5
1130733604,The Sneaker Podcast,2,0,0,2,9,13
1130759240,The Bridge,1,5,5,5,34,50
1130788682,The Brian Craig Show,13,0,0,0,16,29
1130791158,Successful Nonprofits Podcast,0,0,1,2,27,30
1130798819,The Stubborn Heroes: A D&D Podcast,0,0,1,0,10,11
1130804244,Alright Mary: All Things RuPaul's Drag Race,7,12,12,6,212,249
1131117531,Women In-Depth:  Conversations about the Inner Lives of Women,0,0,1,0,49,50
1131144827,Saregama Carvaan Classic Retro Music,0,1,1,5,17,24
1131305272,Ham Radio 2.0,2,0,0,1,1,4
1131408917,Pitcher List Fantasy Baseball,5,1,6,6,204,222
1131463879,Get Up in the Cool,0,0,0,0,40,40
1131715322,breakup BOOST Relationship Advice,0,1,0,3,338,342
1131723994,The Fried Egg Golf Podcast,6,0,4,4,106,120
1131751310,APM Reports Documentaries,0,0,0,0,5,5
1131754929,Locked On Spurs - Daily Podcast On The San Antonio Spurs,5,6,3,2,9,25
1131885881,2-Bit Encryption - A Mr Robot Podcast,9,2,0,2,93,106
1131995361,How To Go Vegan Podcast : A Comprehensive Resource for Those Interested in Becoming Vegan,0,0,0,0,1,1
1132312535,eCommerce Uncensored - Email Marketing | Facebook Ads | Social Media Marketing,1,1,0,0,24,26
1132331080,The Big Beard Theory,0,0,0,1,29,30
1132586596,Brave Little State,1,0,1,0,26,28
1132678060,Locked On Clippers - Daily Podcast On The LA Clippers,6,1,2,4,160,173
1132914986,The Martin Garrix Show,1,0,0,0,20,21
1133023095,America Adapts the Climate Change Podcast,1,1,4,0,29,35
1133194268,Jim Cornette Experience,68,16,14,12,300,410
1133200053,Eastern Lariat,1,0,1,0,6,8
1133268930,Locked On Blazers – Daily Podcast On The Portland Trail Blazers,4,1,1,3,41,50
1133320064,Sleep and Relax ASMR,10,2,3,6,41,62
1133381225,Saturday Night Live (SNL) Afterparty,5,2,2,4,21,34
1133618045,TrapDraw Podcast – No Laying Up,3,0,3,2,94,102
1133738396,The Aware Show,0,0,0,0,3,3
1133744544,Liberty Ballers: for Philadelphia 76ers fans,6,1,5,1,73,86
1133785570,Health Via Modern Nutrition,1,0,0,3,45,49
1133835109,Medical Medium Podcast,5,2,1,3,39,50
1133865220,Teen Creeps,3,3,3,3,188,200
1134012081,Marty & Sarah Love Wrestling,3,4,2,0,225,234
1134154895,Next Question with Katie Couric,35,11,15,24,415,500
1134176697,Bright Side of the Sun: for Phoenix Suns fans,2,0,1,0,11,14
1134179516,The Test of Time,0,0,0,0,7,7
1134397605,Pokemon Go Radio,2,0,1,0,47,50
1134425259,Satsang with Mooji,0,0,0,0,20,20
1134637518,A Scottish Podcast the Audio Drama Series,0,0,2,2,46,50
1134661275,Happiness at Work,0,0,0,0,11,11
1134673435,Bruce Lee Podcast,4,6,4,6,255,275
1134820562,Mr Robot,1,4,0,4,40,49
1134840455,A Rosary Companion,0,5,4,4,67,80
1134891957,Learn English Through Listening,0,0,0,0,6,6
1134941986,Locked On Nuggets - Daily Podcast On The Denver Nuggets,5,2,2,5,164,178
1134941995,Locked On Bucks – Daily Podcast On The Milwaukee Bucks,1,2,2,9,116,130
1134941997,Locked On Hawks - Daily Podcast On The Atlanta Hawks,2,0,2,3,70,77
1135005078,Kame House Party - A Dragon Ball Comedy Podcast,1,0,0,0,27,28
1135092442,The Cannabis Business Minds Show,3,0,0,0,26,29
1135137367,The Tim Dillon Show,20,1,3,6,468,498
1135148587,Ordinary Marathoner,0,0,0,0,8,8
1135262567,More Cheese Less Whiskers,0,0,0,0,23,23
1135300063,"InsideTheBoards for the USMLE, COMLEX & Medical School",0,0,0,0,50,50
1135332109,Juicy Scoop with Heather McDonald,5,0,0,0,45,50
1135563666,Locked On Rockets - Daily Podcast On The Houston Rockets,3,3,2,4,76,88
1135591082,In Legal Terms,0,0,0,0,2,2
1135592550,Everyday Tech,0,0,1,0,1,2
1135598495,The Gestalt Gardener,0,0,0,0,3,3
1135622993,Headshots: Psychology + Gaming,0,0,1,1,7,9
1135626757,Clouded,1,0,1,1,26,29
1135682868,Rex Rivetter: Private Eye,0,0,0,0,35,35
1135938603,Bowjunky archery podcast,4,1,1,3,12,21
1136055333,Locked On Cavs - Daily Podcast On The Cleveland Cavaliers,17,7,6,5,51,86
1136251922,Optimal Health Daily,6,3,4,1,36,50
1136473128,Everything I Learned From Movies,0,0,0,0,10,10
1136518710,One Objective Bass Fishing,4,0,0,1,10,15
1136777305,Tom Curran’s Patriots Talk Podcast,8,4,2,12,115,141
1136844459,Nirankari Baba Ji Discourses,1,0,0,0,0,1
1136844796,Voice Divine: The Internet Radio,0,0,0,0,3,3
1136877230,Team Building Podcast,0,0,0,0,50,50
1137170219,Locked On Dolphins - Daily Podcast On The Miami Dolphins,9,3,9,5,455,481
1137424007,You've Got This | Tips & Strategies for Meaningful Productivity and Alignment in Work and Life,0,0,0,0,12,12
1137452802,'Paul Or Nothing' Podcast,1,1,1,1,13,17
1137452803,That Early Childhood Nerd,0,0,1,1,5,7
1137465844,Adventure a Dungeons and Dragons Podcast,0,1,1,3,45,50
1137521932,Ek Kahani Aisi Bhi,0,1,0,0,12,13
1137646373,SuperMegaCast,0,1,1,2,46,50
1137767458,Future of Agriculture,0,0,1,0,72,73
1137772216,Beat Your Genes Podcast,3,4,0,2,45,54
1137789035,Acquisitions Incorporated: The Series,0,0,0,0,15,15
1137998639,Fish Stripes: for Miami Marlins fans,2,1,0,0,21,24
1138061190,An Acquired Taste Podcast,12,6,7,6,469,500
1138081298,The Christy Wright Show,4,5,6,6,197,218
1138081319,Magic Lessons with Elizabeth Gilbert,3,1,1,1,141,147
1138193112,Synth Zone,0,0,0,0,7,7
1138222209,The Married At First Sight After Show Podcast,11,6,5,2,10,34
1138381298,Art Biz Podcast,0,0,0,2,32,34
1138490044,The Low Carb Hustle Podcast,0,0,0,0,50,50
1138520803,"Marietta Stories | Crazy cool stories from the community builders of Marietta, Georgia",0,0,0,0,42,42
1138611256,Fare of the Free Child,0,0,1,1,23,25
1138869817,Marketing School - Digital Marketing and Online Marketing Tips,0,0,0,0,16,16
1138942145,FantasyPros - Fantasy Football Podcast,11,5,9,22,453,500
1138957862,AP Top 25 College Football Podcast,4,0,0,1,21,26
1139017868,Go Trek Yourself,1,0,0,0,4,5
1139115219,Trivia With Budds,1,1,0,0,48,50
1139238555,Locked On Pistons - Daily Podcast On The Detroit Pistons,7,3,1,4,20,35
1139240239,Business Security Weekly (Video),0,0,0,0,1,1
1139391156,Something to Wrestle with Bruce Prichard,47,17,13,13,410,500
1139556079,Tunnels,8,6,7,9,20,50
1139672164,The Alien Adventures of Finn Caspian: Science Fiction for Kids,3,1,2,5,39,50
1139751780,Locked On Raiders - Daily Podcast On The Las Vegas Raiders,10,6,1,5,73,95
1139752021,Locked On Bucs – Daily Podcast On The Tampa Bay Buccaneers Fans,4,1,5,3,39,52
1139815028,The Morbid Curiosity Podcast,2,3,3,0,42,50
1139815935,Conversations on Health Care,1,0,0,0,1,2
1139837809,Sales Influence - Why People Buy!,0,0,1,0,60,61
1139903017,Locked On Eagles - Daily Podcast On The Philadelphia Eagles,4,1,3,3,78,89
1139967050,Locked On NFL – Daily Podcast On The National Football League,11,4,7,12,145,179
1139973582,"Piano Parent Podcast: helping teachers, parents, and students get the most of their piano lessons.",0,1,0,0,25,26
1139992713,The Heart of Hospice,0,0,0,1,7,8
1140122776,Amazing World of Radio,0,0,0,0,1,1
1140287901,Dani Daniels Show,1,1,0,0,12,14
1140300048,Buckeye Talk: Ohio State podcast by cleveland.com,34,13,14,24,407,492
1140300483,Blade Licking Thieves,0,0,1,1,16,18
1140304624,Your Last Meal with Rachel Belle,0,0,1,9,133,143
1140333666,The MCAT Podcast,1,1,0,3,34,39
1140497332,Soundtracking with Edith Bowman,0,2,1,3,63,69
1140512627,Locked On Patriots - Daily Podcast On The New England Patriots,3,3,0,3,69,78
1140514879,Locked On Lions - Daily Podcast On The Detroit Lions,23,6,7,5,91,132
1140522532,Locked On Steelers – Daily Podcast On The Pittsburgh Steelers,6,3,3,1,161,174
1140596919,Up and Vanished,136,116,124,88,256,720
1140948717,Jack Slack Podcast,0,0,0,1,57,58
1140967385,Poverty Research & Policy,0,0,0,0,1,1
1141063625,Pleasing Terrors,4,0,2,3,315,324
1141081555,Locked On Chiefs - Daily Podcast On The Kansas City Chiefs,5,11,11,21,214,262
1141129184,The Lucky Letcord Podcast,0,0,0,0,3,3
1141442116,The Creative Classroom with John Spencer,1,0,0,1,48,50
1141509275,...These Are Their Stories: The Law & Order Podcast,30,14,15,13,137,209
1141563910,The Fall of Rome Podcast,1,1,1,3,44,50
1141591437,Locked On Bears - Daily Podcast On The Chicago Bears,17,6,3,5,60,91
1141622977,Kilowatt: A Podcast about Tesla,1,1,0,1,6,9
1141654957,TOTAL EM - Tools Of the Trade and Academic Learning in Emergency Medicine,0,0,1,0,13,14
1141673391,Overeaters Anonymous of San Francisco,1,1,0,0,4,6
1141688163,Redefining Strength Fitness Hacks,0,0,0,1,20,21
1141754534,Career Talk: Learn - Grow - Thrive,2,1,0,1,55,59
1141816572,The Panpsycast Philosophy Podcast,1,1,0,2,29,33
1141921489,Fantasy Baseball Prospects at Razzball,2,1,0,0,26,29
1141941405,MZANSI DEEP- Soulful & Deep House Sessions,0,0,0,0,6,6
1141945550,"Goop Tales — An Engaging, Entertaining, and Educational Storytelling Podcast for Kids",4,0,1,2,43,50
1141951148,THE SITH LIST,0,0,0,1,68,69
1141968957,Dinosaur George Podcast - A Podcast Devoted to Paleontology and Natural Science,0,0,1,0,4,5
1141969328,Varmints!,0,1,1,2,46,50
1142107621,The Serial Killer Podcast,59,30,31,20,216,356
1142132203,"Fastest 5 Minutes, The Podcast Government Contractors Can't Do Without",0,0,0,0,2,2
1142302785,Just for Variety with Marc Malkin,12,1,3,2,6,24
1142320492,Cincy Jungle: for Cincinnati Bengals fans,4,2,1,0,6,13
1142321584,German Podcast,4,0,2,0,4,10
1142321960,Cases and Controversies,1,0,0,0,3,4
1142370805,The Greg Hill Show,107,4,5,1,18,135
1142418191,ALL MARINE RADIO,0,0,1,0,9,10
1142736861,ArtCurious Podcast,3,6,7,10,137,163
1142986267,Perspective Podcast | Fuel for Your Mind & Creative Grind,0,0,0,1,144,145
1143167911,Lama Yeshe Wisdom Archive,0,0,0,0,1,1
1143172060,Dialed In - Some Obsession Required,3,2,0,0,34,39
1143265842,Cape Up with Jonathan Capehart,0,0,0,0,50,50
1143358718,Locked On 49ers - Daily Podcast On The San Francisco 49ers,2,2,3,7,151,165
1143497810,Living Open | Modern Magick and Spirituality for Mystics and Seekers,1,0,0,0,51,52
1143630029,WIRED Tech in Two,4,3,3,4,4,18
1143631798,"WIRED Business: Startups, Cryptocurrency, Tech Culture, and More",0,1,0,0,1,2
1143682445,Cool Kids Table,1,0,0,2,24,27
1143845868,Dissect,0,0,0,0,50,50
1143976129,Embodied Astrology with Renee Sills,7,1,2,0,74,84
1144008991,Putting Racism on the Table Podcast Series,0,0,0,0,2,2
1144077201,Shared Practices | Your Dental Roadmap to Practice Ownership | Custom Made for the New Dentist,0,0,0,0,50,50
1144137857,Court Junkie,15,23,17,22,423,500
1144153396,Locked On Fantasy Football – Daily NFL Fantasy Football Podcast,3,3,4,2,19,31
1144153403,Locked On Vikings - Daily Podcast On The Minnesota Vikings,5,1,3,7,49,65
1144183096,Locked On Washington Football Team,8,1,4,2,17,32
1144280043,"Malcolm Gladwell, Revisionist History: Special Event",11,4,3,10,282,310
1144476540,The Maximum Lawyer Podcast,0,0,0,0,50,50
1144508840,Locked On Packers - Daily Podcast On The Green Bay Packers,23,9,7,7,281,327
1144653856,Gartner ThinkCast,0,1,1,1,13,16
1144805575,VoicerFM,0,0,0,0,8,8
1144941431,Locked On Giants - Daily Podcast On The New York Giants,10,8,8,9,55,90
1144959980,Shat the Movies: 80's & 90's Best Film Review,23,9,12,11,255,310
1145089790,Snapped: Women Who Murder,7,2,2,8,18,37
1145096336,Wisdom Inspired Life,0,0,0,0,1,1
1145198837,Creator Lab - interviews with entrepreneurs and startup founders,0,0,0,0,70,70
1145222943,"Mysterious Radio: Paranormal, UFO & Lore Interviews",87,27,21,14,351,500
1145261115,Rebank: Banking the Future,0,0,0,0,19,19
1145479962,Locked On Bills - Daily Podcast On The Buffalo Bills,3,3,3,5,181,195
1145532412,The Final Straw Radio,2,0,0,0,9,11
1145532509,Heinemann Podcast,1,2,0,0,18,21
1145563229,Dynasty Leadership Podcast,0,0,0,1,0,1
1145990861,Accused,38,49,44,47,322,500
1146086687,The Absolute Strength Podcast,0,0,1,1,48,50
1146187659,Swinger Diaries,2,0,0,2,46,50
1146277289,Imagined Landscapes Podcast,0,0,0,0,17,17
1146329262,The Howie Games,5,4,1,13,112,135
1146579746,Hillbilly Horror Stories,15,9,8,6,462,500
1146588641,Locked On Broncos - Daily Podcast On The Denver Broncos,2,2,4,0,131,139
1146613549,Naruhodo,0,0,0,0,24,24
1146697314,Superhero Ethics,1,0,0,2,26,29
1146719983,The Overlook Hour Podcast,0,0,0,0,6,6
1146781072,Canary Cry News Talk,1,0,1,0,152,154
1146941306,Therapist Uncensored Podcast,1,1,2,5,106,115
1147092464,Opening Arguments,13,10,4,10,377,414
1147166189,The Sustainability Agenda,0,0,1,0,1,2
1147205326,About Buildings + Cities,2,0,1,1,41,45
1147245791,Locked On Falcons - Daily Podcast On The Atlanta Falcons,5,6,1,4,81,97
1147257638,Wharton Business Daily,3,0,0,1,3,7
1147277549,IGN Game Reviews,2,2,1,0,6,11
1147278052,IGN Movie Reviews,0,0,0,0,1,1
1147459691,Podcast en Spanish (PES) - Learn Spanish as a Second Language,1,0,1,1,24,27
1147475295,Sirenicide,3,6,3,5,33,50
1147876214,Set For Life,0,0,0,0,2,2
1147910296,Warriors Plus Minus: A show about the Golden State Warriors,3,1,2,3,42,51
1148115183,The BEMA Podcast,2,0,0,1,100,103
1148175292,In the Dark,60,22,44,12,520,658
1148183612,Almost 30,72,12,10,11,395,500
1148213706,RuPaul's Drag Race Season 13 Rucaps,16,7,5,2,36,66
1148391442,French Blabla,0,0,0,0,13,13
1148418720,Bat Flips And Nerds,0,0,0,0,3,3
1148439276,The Ryback Show,32,10,9,8,357,416
1148570190,"Your Parenting Mojo - Respectful, research-based parenting ideas to help kids thrive",1,1,2,1,45,50
1148650883,The Tony Kornheiser Show,72,26,36,21,345,500
1148679972,American Banker Podcast,2,0,0,0,3,5
1148704289,"Secrets, Crimes & Audiotape",3,4,0,2,41,50
1148762825,The Bourbon Show,1,2,2,2,70,77
1148968947,Locked On Rams - Daily Podcast On The Los Angeles Rams,2,1,1,2,86,92
1149028520,Popcorn with Peter Travers,0,0,0,0,9,9
1149033319,Locked On Jets - Daily Podcast On The New York Jets,6,5,3,8,88,110
1149072856,Children and Adults with ADHD (CHADD),1,1,1,0,3,6
1149112550,The Career Change Maker Podcast,0,0,0,0,9,9
1149175431,Locked On Jaguars - Daily Podcast On The Jacksonville Jaguars,7,3,1,2,33,46
1149182265,On The Trail With Kevin and Scott,0,0,0,0,39,39
1149341049,Grow Your Video Business,0,0,1,0,49,50
1149484402,CockTales: Dirty Discussions,1,2,3,4,40,50
1149649113,Chicken Dinner,0,0,0,0,38,38
1149687923,The Retro Cinema Podcast,0,0,0,0,24,24
1149940384,The Nourished Child,0,0,1,0,20,21
1149989450,Locked On Browns - Daily Podcast On The Cleveland Browns,6,3,4,4,33,50
1149992167,Paul's Security Weekly (Podcast-Only),0,0,0,0,1,1
1150088852,Skip and Shannon: Undisputed,138,40,50,42,230,500
1150124880,Something You Should Know,3,1,0,0,46,50
1150131366,Behind the Mic with Greg Wrubell,0,0,0,0,12,12
1150186828,The Wilderness Podcast: An OldSchool RuneScape Show,1,0,0,1,20,22
1150237453,The Editors,10,2,2,4,32,50
1150241800,Buffering the Vampire Slayer | A Buffy the Vampire Slayer Podcast,12,9,15,14,340,390
1150510297,How I Built This with Guy Raz,105,21,84,84,1456,1750
1150660542,Baseball Dads Podcast,0,0,0,0,52,52
1150712659,JayhawkSlant,0,0,0,1,7,8
1150800298,Heavyweight,14,5,7,8,466,500
1150818895,Modern Audio Drama,0,0,0,0,9,9
1150854418,Simply Convivial: Pep Talks for Homemakers & Homeschoolers,0,1,0,3,42,46
1150931432,The Communication Guys Podcast: Communication Excellence | Professional and Personal Success,0,1,0,1,40,42
1150960126,The Peter King Podcast,16,11,7,8,69,111
1150965112,The Albert Breer Show,9,10,4,7,44,74
1151022824,L'heure bleue,0,0,1,0,2,3
1151212633,The Ob/Gyn Podcast,0,0,1,0,6,7
1151215065,Locked On Titans - Daily Podcast On The Tennessee Titans,2,3,3,1,76,85
1151215071,"Locked On NFL Draft - Daily Podcast On The NFL Draft, College Football & The NFL",39,9,16,14,236,314
1151436460,Still Processing,21,14,10,18,437,500
1151519475,Locked On Cowboys - Daily Podcast On The Dallas Cowboys,4,3,5,1,65,78
1151555311,Why Not Now? with Amy Jo Martin,1,0,0,16,155,172
1151558476,Locked On Chargers - Daily Podcast On The Los Angeles Chargers,7,3,4,1,20,35
1151607856,Career Warrior Podcast,0,1,0,0,14,15
1151621299,Locked On Seahawks - Daily Podcast On The Seattle Seahawks,10,3,1,3,62,79
1151621599,ReWilding for Women,0,3,2,0,26,31
1151634104,The Jewish History Podcast - With Rabbi Yaakov Wolbe,4,0,1,2,41,48
1151670380,Wrongful Conviction Podcasts,34,7,16,14,429,500
1151674744,ATS.io Sports Betting & Handicapping Podcast,4,4,2,3,18,31
1151813735,Small Farm Nation,0,0,0,4,73,77
1151856991,Zero Blog Thirty,7,1,0,0,42,50
1151890990,Disability After Dark,1,0,1,0,48,50
1151965239,Philosophy For Our Times,1,2,0,1,9,13
1151988852,Washington Football Talk,15,4,13,21,447,500
1152012998,Husker247 Podcast,1,0,2,1,31,35
1152146807,"My Creative Corner3- quilting, crafts and creativity",0,0,0,2,12,14
1152248491,Darkness Prevails Podcast | TRUE Horror Stories,13,3,6,16,398,436
1152277456,The Queen Sugar Podcast,0,0,0,0,4,4
1152607745,JoshCast,0,0,0,0,2,2
1152618068,Secrets & Spies: The Dry CleanerCast,0,0,1,0,5,6
1152656464,I'm Too Effing High,0,1,1,0,19,21
1152681640,Where Cures Begin - Salk Institute,0,0,0,0,5,5
1152745706,The Powell Movement Action Sports Podcast,0,1,2,2,91,96
1152759754,numberFire Daily Fantasy Podcasts,2,0,1,2,138,143
1152767505,FUTURE FOSSILS,0,0,0,1,60,61
1152853871,The Thoughtful Counselor,0,0,1,2,12,15
1152978569,Fulhamish,0,0,0,0,28,28
1153019457,Locked On Wolves - Daily Podcast On The Minnesota Timberwolves,13,4,3,0,13,33
1153048437,1st Talk Compliance,0,0,0,0,3,3
1153134918,Doing It At Home,0,1,0,0,49,50
1153178064,The Fertility Warriors,0,0,0,0,30,30
1153262163,Crazy Sh*t In Real Estate with Leigh Brown,0,0,0,0,32,32
1153426906,The Actor CEO Podcast: Acting Business | Interviews | Motivation,0,0,2,0,28,30
1153456714,Locked On Ravens - Daily Podcast On The Baltimore Ravens,5,2,2,2,16,27
1153457233,49ers Talk with Matt Maiocco and Laura Britt,3,2,7,4,59,75
1153461563,Energy Matters,1,0,0,2,45,48
1153465419,EmPowered Couples with The Freemans,0,0,0,1,101,102
1153475023,Unexceptional Moms,0,0,0,2,18,20
1153483893,Kinda Dating,3,6,8,1,101,119
1153622465,Under Center Podcast,33,7,8,4,59,111
1153661014,The Next Pats Podcast - A Patriots Podcast,0,1,1,4,118,124
1153678569,Locked On Mavericks - Daily Podcast On The Dallas Mavs,6,2,2,4,249,263
1153737630,Danger Dan's Talk Shop,0,1,0,0,15,16
1153787018,The Studleys,13,10,5,10,311,349
1153789570,Saints Talk presented by NewOrleans.Football,0,0,2,1,42,45
1153817009,The Sales Development Podcast,0,0,0,0,9,9
1153873309,Locked On Warriors – Daily Podcast On The Golden State Warriors,14,10,9,7,56,96
1153925147,OCCULTURE,0,0,0,0,30,30
1154105909,Invest Like the Best,3,1,1,1,181,187
1154127358,"Connecting with Walt - A look into the history of the man behind Mickey Mouse, Disneyland and Walt D...",5,5,4,5,88,107
1154176782,Pokemon World Tour: United,0,1,0,3,46,50
1154277850,She Creates Business,0,0,1,1,64,66
1154304419,Private Parts Unknown (FKA Reality Bytes),1,0,1,0,48,50
1154461374,Directing Magic Podcast,0,0,0,1,5,6
1154524634,Law School Insider,0,0,1,0,2,3
1154758766,Reality Life with Kate Casey,43,9,16,8,424,500
1155061645,All About Agatha (Christie),5,6,6,17,121,155
1155163742,Dead Pilots Society,7,3,8,12,68,98
1155194811,The United States of Anxiety,17,4,1,13,130,165
1155318497,Rush Limbaugh Morning Update,13,0,0,0,37,50
1155343204,Locked On Kings - Daily Podcast On The Sacramento Kings,10,5,3,4,67,89
1155392992,Bedtime History,0,0,0,6,44,50
1155622334,The Unofficial NCLEX® Prep Podcast by NURSING.com (NRSNG),1,0,0,1,5,7
1155629323,The Reason Roundtable,7,5,5,5,28,50
1155755580,Photog Adventures Podcast: A Landscape Photography and Astrophotography Podcast,1,0,3,1,41,46
1155768511,Exoplanetary,0,0,0,1,14,15
1155828849,SonexFlight,0,0,0,0,5,5
1155846302,They Walk Among Us - UK True Crime,25,37,38,41,359,500
1155856616,Mongabay Newscast,0,0,0,1,5,6
1155883792,The Orphans,1,1,0,4,34,40
1155913704,Hit The Streets with Valerie Jardin,0,0,0,0,4,4
1155946433,Dobber Prospects Radio,0,0,0,0,8,8
1156002023,Todd White (Lifestyle Christianity Church),7,2,4,0,96,109
1156258045,Hangar Talk - An Aviation Podcast,2,1,0,0,6,9
1156329240,Healing Broken Trust In Your Marriage After Infidelity,2,2,2,3,41,50
1156336614,The Miracle Morning for Network Marketers Podcast,0,0,0,0,4,4
1156343076,Timesuck with Dan Cummins,0,2,1,0,47,50
1156483471,Disrupt Yourself Podcast with Whitney Johnson,0,0,2,5,78,85
1156487141,Emergency Medicine Board Review,1,1,0,0,13,15
1156557386,Keep Calm and Homeschool On,0,0,1,0,44,45
1156592336,The Chuck ToddCast: Meet the Press,61,32,50,43,162,348
1156646189,Cold Call,0,0,0,3,6,9
1156724104,Hysteria 51,22,8,8,9,302,349
1156737811,The Pemberley Podcast,0,0,0,0,12,12
1156744457,The Propaganda Report,6,0,2,2,40,50
1156763561,The Dildorks,0,1,1,3,35,40
1156793766,This Is Us After Show Podcast,3,3,7,6,6,25
1156851543,One Year No Beer | Hack your healthy Lifestyle,1,0,1,0,21,23
1157097612,The X-Cast - An X-Files Podcast,0,0,0,1,15,16
1157097748,Parent Footprint with Dr. Dan,1,0,0,0,9,10
1157097749,The Overlanding Podcast,0,0,0,0,4,4
1157152128,Mark and Me Podcast,1,0,0,0,4,5
1157227410,ABN-Nava Jeevana Vedam,0,0,0,0,3,3
1157245144,The Grape Nation,7,1,7,3,8,26
1157619382,Mighty Blue On The Appalachian Trail: The Ultimate Mid-Life Crisis,0,0,0,1,151,152
1157625604,Stars on Suspense (Old Time Radio),1,0,0,0,22,23
1157631148,CBS This Morning,1,4,4,6,35,50
1157693037,True Geordie Podcast,13,6,6,13,461,499
1157695571,Wildland Fire Lessons Learned Center,0,0,0,0,8,8
1157719963,AdExchanger,0,0,1,0,6,7
1157864949,Qur'an Tafsir: Understanding the Word of Allah with Shaykh Faid Mohammed Said,0,0,0,0,1,1
1158031787,The Unexplainable Disappearance of Mars Patel,3,0,2,8,36,49
1158068764,Investigating Breast Cancer,0,0,1,0,7,8
1158256537,The Art of Living Big | Subconscious | NLP | Manifestation | Mindset,0,0,1,1,50,52
1158546491,Las Raras,0,0,0,0,17,17
1158565649,SPINES Podcast,3,2,1,6,77,89
1158624049,The Podfathers,6,2,1,2,39,50
1158759190,The Orbiting Human Circus,3,5,0,1,41,50
1158760173,Medic Mindset,0,0,0,0,50,50
1158889592,Christopher Kimball’s Milk Street Radio,8,5,12,15,89,129
1158916949,microTalk,0,0,0,0,3,3
1158942934,Locked On 76ers - Daily Podcast On The Philadelphia Sixers,40,4,4,5,14,67
1158967390,Catholic School Matters,0,0,0,0,13,13
1159005821,The Successful Bookkeeper Podcast,0,0,0,0,19,19
1159017691,The Leader's Panel,1,0,0,4,25,30
1159034515,Raising Daughters,0,0,0,1,12,13
1159170164,Waypoint Radio,10,1,3,1,35,50
1159251584,Brady Heywood Podcast,0,0,1,0,15,16
1159253732,Save Your Marriage Podcast - Nicola Beer,1,0,0,1,43,45
1159425037,Locked On Nets - Daily Podcast On The Brooklyn Nets,7,1,1,0,33,42
1159498258,Minimalist Moms Podcast,2,0,4,1,43,50
1159499233,8 Bit Book Club,1,0,0,1,188,190
1159520965,"Dating Tips, Relationships & Dating Advice For Single Women Podcast | Magnetize Your Man",0,0,0,0,5,5
1159558384,Noisy Neighbors Podcast,0,0,0,0,51,51
1159723162,Locked On Bengals - Daily Podcast On The Cincinnati Bengals,7,5,7,2,91,112
1159749342,SUCCESS Talks,1,0,1,3,26,31
1160066385,Sheologians,55,17,21,14,380,487
1160325324,Always Open,1,2,1,3,43,50
1160491947,Start Me Up with Kimberley A. Johnson,1,1,2,0,49,53
1160854995,Destiny Community Podcast,9,8,6,3,24,50
1160860118,Mabel,1,0,3,3,22,29
1160913402,Locked On Pacers - Daily Podcast On The Indiana Pacers,4,0,2,8,25,39
1160965218,Healing Hormones,0,0,0,0,29,29
1161063301,The Explorers Podcast,1,1,0,2,46,50
1161185862,Venture Maidens | A Dungeons and Dragons Podcast,0,0,2,0,48,50
1161195772,Genius Network,0,0,0,0,39,39
1161227380,Science Adventure Stories For Kids,1,0,5,5,22,33
1161257444,Female Strength Academy,0,0,0,2,13,15
1161261587,The Money Nerds,0,0,0,0,32,32
1161286064,BROKE GIRL THERAPY,0,0,0,0,32,32
1161431357,Apes Among Us,1,0,1,3,18,23
1161476761,The Lonely Hour,0,0,1,3,41,45
1161521789,Point Mystic,0,0,0,3,47,50
1161523222,The Classical Homeschool,0,1,1,1,11,14
1161539127,Vinyl-O-Matic,0,0,0,0,1,1
1161583100,Unpopular Culture,2,2,2,2,101,109
1161597030,OFFSHORE,2,3,0,6,67,78
1161728753,Southern Gardening Podcast,0,0,0,0,3,3
1161738627,The Final Four Is Not On The Schedule - A Michigan State Basketball Podcast.,0,0,0,1,24,25
1161784063,Tap into The Power of Your Mind using Law of Attraction and Hypnosis Techniques,0,1,0,1,16,18
1161880916,Foundering,11,3,4,10,127,155
1162162346,"Girl Get Visible Podcast: SEO Traffic, Marketing, and Business",0,0,0,0,32,32
1162163701,Bulls Talk Podcast,10,4,5,6,25,50
1162163703,White Sox Talk Podcast,4,2,2,2,31,41
1162369953,The Passionate Few,0,0,0,0,50,50
1162447122,Making Gay History | LGBTQ Oral Histories from the Archive,1,0,1,1,47,50
1162733995,Chemistry in its element,0,0,0,2,13,15
1162734003,Chemistry World Podcast,0,0,0,0,1,1
1162840944,Cubs Talk Podcast,12,8,9,6,17,52
1162878324,EW’s BINGE,6,2,9,7,43,67
1163094296,The Quote of the Day Show | Daily Motivational Talks,1,1,0,1,47,50
1163178672,Your Family Dog Podcast,0,0,0,0,2,2
1163226019,Undermine,2,4,6,10,419,441
1163347389,"Building the Future: Freedom, Prosperity, and Foreign Policy with Dan Runde",0,0,2,0,1,3
1163350738,Unshakable Self-Confidence,0,0,0,1,32,33
1163362567,Where Accountants Go - The Accounting Careers Podcast,0,0,0,0,9,9
1163517605,Muses,5,3,0,1,20,29
1163561564,Days of Future Cast,0,0,0,0,46,46
1163575703,Historical Blindness,13,3,2,0,32,50
1163591585,Destiny Down Under Podcast,1,1,0,0,10,12
1163599279,Podcast Italiano,0,0,0,0,50,50
1163606279,FUT Weekly Podcast,1,1,1,0,21,24
1163825268,"213Hoops: The Lob, The Jam, The Podcast",2,0,1,1,7,11
1163831041,Spooky Boo's Scary Story Time,12,1,6,3,28,50
1163871694,Darkest Night,5,13,3,9,20,50
1163875124,"Spirit, Purpose & Energy",5,4,3,3,129,144
1163907594,RNZ: Black Sheep,1,0,1,0,71,73
1163916559,The Joy of Procrastination,0,0,0,0,6,6
1163966747,The Parsha Podcast - With Rabbi Yaakov Wolbe,0,0,0,0,13,13
1163966749,TORAH 101 - With Rabbi Yaakov Wolbe,0,0,0,0,8,8
1164056925,Read It On Reddit,1,1,0,0,29,31
1164102724,Rockin' the Suburbs,0,0,0,1,49,50
1164113112,Locked On Suns - Daily Podcast On The Phoenix Suns,5,2,5,5,32,49
1164228167,Chilling Tales for Dark Nights: A Horror Anthology and Scary Stories Series Podcast,0,6,4,3,37,50
1164272877,GeriPal,0,0,0,2,5,7
1164278826,What If World - Stories for Kids,1,1,0,2,46,50
1164304576,The Past and The Curious: A History Podcast for Kids and Families,1,0,1,2,46,50
1164374262,The Grade Cricketer,1,0,1,0,4,6
1164443941,Vet School Unleashed: Dissecting the DVM - Talking About All Things Veterinary School,0,0,0,0,15,15
1164485579,Insecuritea: The Insecure Aftershow,2,3,9,9,235,258
1164577211,Lost in America,2,0,1,0,43,46
1164610947,The Pastors Round Table,0,0,0,1,0,1
1164721597,Speak L.A.,0,0,0,0,37,37
1165189603,Data Crunch,0,0,0,0,11,11
1165264500,Broad Street Hockey: for Philadelphia Flyers fans,9,6,7,8,131,161
1165437401,Our Vantage Point - Retro Wrestling Podcast,4,0,0,2,104,110
1165480129,If That Ain't Country,2,0,0,1,9,12
1165562661,Capitol Crude: The US Oil Policy Podcast,1,1,0,2,3,7
1165660759,Crash The Pond: An Anaheim Ducks Podcast,0,1,1,2,78,82
1165662467,HUB History - Our Favorite Stories from Boston History,0,1,2,0,19,22
1165843330,"The Privacy, Security, & OSINT Show",0,0,1,1,65,67
1165945530,Quran for our times - Bengali,0,0,0,0,1,1
1166007425,National Trust Podcast,0,0,0,0,2,2
1166015598,The SelfWork Podcast,0,0,1,0,49,50
1166029008,Cannabis Health Radio Podcast,0,0,0,0,19,19
1166227345,Sex With Dr. Jess,0,0,0,2,16,18
1166556648,Missing & Murdered: Finding Cleo,25,21,38,26,390,500
1166682012,Live Inspired Podcast with John O'Leary,0,0,0,0,118,118
1166703514,Rapidly Rotating Records,0,0,0,0,1,1
1166774961,Mickstape,25,5,5,5,460,500
1166804944,The Casey Crew,1,3,1,5,40,50
1166822958,The Peer Pleasure Podcast,0,1,1,0,62,64
1166974610,The Redrum Theatre,0,0,0,0,19,19
1166987637,Geaux247 Podcast,0,1,0,1,20,22
1167078901,Blackhawks Talk Podcast,0,1,2,1,33,37
1167082363,The Scouted Football Podcast,0,0,0,0,3,3
1167142200,Michigan's Big Show,1,0,0,0,0,1
1167173941,Live from Here Highlights,7,2,2,1,4,16
1167302496,The Jewish Story,0,1,0,0,8,9
1167575031,NostalgiaCast,1,0,0,0,8,9
1167859928,The Tailored Life Podcast,0,0,0,1,49,50
1168107709,Nature Guys,0,0,1,0,51,52
1168126157,Dream Big Podcast,6,0,5,3,36,50
1168126876,Dark Tome,24,4,5,2,15,50
1168145361,Two Minute Stories,0,0,0,0,1,1
1168202056,Broadway Backstory,0,0,0,1,97,98
1168221980,Four Orbs - A D&D Podcast,0,0,0,0,50,50
1168307590,Sales Success Stories,0,0,0,0,41,41
1168329998,College Admissions with Mark and Anna,0,0,0,0,3,3
1168332267,Fan Service,0,0,0,1,19,20
1168445048,Unnamed Automotive Podcast,2,0,1,1,9,13
1168637747,Real Peace. Real People.,0,0,0,0,4,4
1168716155,Wine Enthusiast Podcast,1,1,1,7,5,15
1169002587,TMV Podcast,0,0,0,0,7,7
1169014616,How to Decorate,10,14,11,16,126,177
1169016854,Finding Genius Podcast,0,0,0,0,50,50
1169052792,The Balanced Blonde // Soul On Fire,0,0,0,1,49,50
1169061256,Gators Breakdown,2,0,1,5,87,95
1169101860,FT Tech Tonic,1,1,1,0,2,5
1169112310,The Film Scene with Illeana Douglas,0,2,2,0,19,23
1169507908,Deep Color,0,0,0,0,5,5
1169814333,Let Me Tell You About...,0,1,1,1,29,32
1169821159,Blogging the Boys: for Dallas Cowboys fans,5,1,1,6,36,49
1169900822,The Keto Savage Podcast,2,2,1,1,44,50
1170073178,What Fresh Hell: Laughing in the Face of Motherhood,0,0,0,0,50,50
1170179745,Social Media and Politics,0,0,0,0,14,14
1170242921,Shaping Fire,0,0,0,1,29,30
1170581640,Indications,0,0,0,0,3,3
1170629044,Chasing Excellence,5,0,0,2,43,50
1170766921,The Healthy Gut,0,0,0,1,19,20
1170787132,Kuldrin's Krypt A BDSM 101 Podcast,0,0,0,0,8,8
1170932252,The Strength Running Podcast,5,2,3,8,198,216
1170934381,Homecoming,24,23,38,49,366,500
1170959623,Crimetown,49,15,16,13,407,500
1170963323,The Lovecraft Tapes | Actual-Play Call Of Cthulhu Podcast,1,0,1,1,24,27
1170975976,The Kyle Thiermann Show,1,1,1,0,89,92
1170976960,TakeTen4Torah Daily Torah Podcast,0,0,0,0,3,3
1171145758,Nintendo Nostalgia,0,0,0,0,16,16
1171155453,Feeling Good Podcast | TEAM-CBT - The New Mood Therapy,1,1,3,2,43,50
1171160683,Making,6,5,8,9,369,397
1171229352,Homeschool Unrefined,2,2,0,0,46,50
1171270672,Twenty Thousand Hertz,1,2,0,3,44,50
1171416564,Borne the Battle,1,0,0,0,49,50
1171438277,NFL: Good Morning Football,5,4,4,3,20,36
1171504117,The SwitchCast - A Nintendo Switch Podcast,8,0,2,3,163,176
1171626258,Landscape Business Course,3,0,0,2,23,28
1171738634,RecTech: the Recruiting Technology Podcast,0,0,1,0,3,4
1171755407,Smart Mouth,1,1,3,1,39,45
1171827836,Physics Frontiers,1,1,1,0,7,10
1171842065,Specialty Stories,0,0,0,0,19,19
1171893571,Quid Pro Quo,0,0,1,0,14,15
1171916912,Fantasy NBA Today Fantasy Basketball,2,4,3,8,252,269
1172101607,Prepping Academy,4,5,2,0,5,16
1172102796,"Going Beyond the Food: Diet Culture, Intuitive Eating, Body Acceptance, Mindset and Anti-Diet Podcas...",0,0,1,0,49,50
1172218725,Exponential View with Azeem Azhar,0,1,1,1,77,80
1172333245,Inside Strategic Coach: Connecting Entrepreneurs With What Really Matters,0,0,0,0,16,16
1172408342,The Welsh Rugby Podcast,0,0,0,1,2,3
1172423472,Sustainable Winegrowing with Vineyard Team,0,0,0,0,6,6
1172443640,DEMENTES,0,0,1,0,7,8
1172473406,Bay Curious,1,1,3,3,128,136
1172546141,The President's Inbox,4,2,1,6,37,50
1172580834,PUT IT IN THE AIR PODCAST,1,0,0,0,2,3
1172855980,CrowdScience,0,1,0,2,20,23
1173027655,Biscuits: A Hockey Podcast,1,0,1,0,135,137
1173085598,Preheated Baking Podcast,0,0,0,0,2,2
1173154375,Prospect One,2,0,1,2,43,48
1173196882,Crit Academy: A Dungeons and Dragons Podcast,0,1,3,4,36,44
1173220211,The Party in My Plants Podcast,1,4,1,0,44,50
1173416233,About Progress,1,1,0,1,47,50
1173559723,"Calm Pills - Soothing Space Ambient and Piano Music for Relaxing, Peaceful Sleep, Reading or Mindful...",1,1,0,0,14,16
1173607671,Air Buds,0,1,0,0,121,122
1173721448,The Undifferentiated Medical Student,2,0,0,2,46,50
1173744974,Charmed Life with Tricia Carr,1,0,0,1,14,16
1174058920,Super Woman Wellness by Dr. Taz,0,2,1,7,40,50
1174075197,The Baking Podcast,4,3,4,2,20,33
1174442079,Wheel Bearings,2,1,1,2,41,47
1174519768,Silent Sales Machine Radio,5,0,1,3,191,200
1174542574,Fightful | Pro Wrestling & MMA Podcast,8,2,0,2,61,73
1174976428,"B2B Revenue Leadership - CEO, CRO, CMO, VC, Sales and Marketing Startup SaaS",1,0,1,1,42,45
1175208416,Destroy The Hairdresser,0,0,0,0,13,13
1175495815,Not Another Anxiety Show,3,1,0,3,43,50
1175563320,Terms,3,1,1,2,43,50
1175746628,"Marriage, Kids and Money",0,0,1,1,98,100
1175777581,Inside Mental Health: A Psych Central Podcast,3,1,3,1,39,47
1175886354,The Dungeoncast,0,1,1,1,47,50
1175939750,Videogame Dads Podcast,1,0,1,4,66,72
1176149749,"Menopause Guide Podcast, with RhondaNP",0,1,0,4,14,19
1176278502,Crushing Iron Triathlon Podcast,2,1,2,0,45,50
1176349237,Bigfoot Eyewitness Radio,8,5,6,5,39,63
1176366805,GamesBeat Decides,0,0,0,0,4,4
1176549358,"Uncanny Japan - Japanese Folklore, Folktales, Myths and Language",0,0,0,0,50,50
1176557027,Rachel Watches Star Trek,0,0,1,1,54,56
1176569932,Grandpa's Memory Box: Remembering the Armed Forces in the World Wars,0,0,0,0,1,1
1176779065,This Week in Virology,1,0,0,1,4,6
1177068388,Matt and Shane's Secret Podcast,0,0,0,0,50,50
1177103033,Trackwrestling Podcast,0,0,0,0,3,3
1177260528,Harry Potter Book Club,3,2,0,2,22,29
1177337327,The Parrothead Podcast: All Things Jimmy Buffett,3,0,0,1,20,24
1177744515,Portuguese Lab Podcast | Learn European Portuguese,0,0,0,0,9,9
1178113915,The Clever Girls Know Podcast,0,1,4,6,64,75
1178167741,Data Science Storytime,0,1,0,0,2,3
1178232410,The Angie Lee Show - Ready is A Lie,3,0,1,0,196,200
1178337794,The Brain Warrior's Way Podcast,3,4,4,1,38,50
1178347345,Stress Free Naturally Guided Meditations,2,1,0,1,46,50
1178373026,Mama Bear Apologetics,2,0,0,0,29,31
1178572854,Griefcast,3,8,6,14,278,309
1178654857,The Rough House Podcast 3.0,0,0,0,0,10,10
1178704872,The Goal Digger Podcast,30,5,6,0,159,200
1178826789,The Orpheus Protocol,0,0,0,0,50,50
1178842489,Morning LineUp,5,5,4,2,31,47
1179186351,Pure Dog Talk,0,0,0,0,50,50
1179199929,Iron Lords Podcast,0,0,0,0,14,14
1179203265,Small Biz 101 Podcast,0,0,0,0,5,5
1179376133,Cyber Security Interviews,0,1,1,0,24,26
1179393899,Buzz Beat: A Charlotte Hornets Pod,0,0,0,1,50,51
1179629560,True Crime All The Time,55,27,14,13,391,500
1180357281,Stray Casts Outdoor Cartoon Television Bass Fishing Talk Show,1,3,2,1,30,37
1180494899,Gilmore Girls: A Year In The Life Reviews and After Show - AfterBuzz TV,1,0,1,0,0,2
1180601694,Optimal StartUp Daily,1,0,1,1,47,50
1180720262,The Gun For Hire Radio Broadcast,0,0,1,0,73,74
1180733925,The Bechdel Cast,28,28,28,25,334,443
1180777353,Israel Show,1,0,0,0,1,2
1180862273,How Friends Roll | a Dungeons and Dragons 5th edition actual play DnD 5e podcast,2,0,0,0,48,50
1180988317,The Sportsman Drag Racing Podcast w/ Luke & Jed,0,0,0,2,23,25
1181016891,Fit Friends Happy Hour,0,0,0,0,16,16
1181091370,Nordic Nation,1,2,0,0,3,6
1181154045,Revive Our Hearts,0,0,0,1,43,44
1181218621,NCIA Cannabis Industry Voice,0,1,0,0,4,5
1181233130,THE ED MYLETT SHOW,4,1,1,5,189,200
1181272913,Hypnotize Me with Dr. Elizabeth Bonet,0,0,0,1,39,40
1181557793,Dumb Gay Politics,5,4,8,8,475,500
1181589165,Make Me Smart with Kai and Molly,61,27,23,24,365,500
1181589175,The Hilarious World of Depression,1,0,0,3,46,50
1181598884,Tiger Basketball Podcast,0,0,1,2,2,5
1181698161,Veterinary Viewfinder Podcast,0,0,0,1,19,20
1181810899,Microsoft Mechanics Podcast,0,0,1,0,0,1
1181984256,Commission: Impossible,0,0,0,0,29,29
1182008770,Worst Foot Forward,0,0,0,0,12,12
1182016534,Satsang with Shambhavi,1,0,0,1,24,26
1182213921,LGBTQ Stories,2,0,1,0,24,27
1182265803,Parkflyer Podcast,0,0,0,0,5,5
1182279656,The Smoking Hot Confessions BBQ Podcast,0,0,0,0,1,1
1182561176,Shell Fischer's Podcast,0,0,0,0,9,9
1182568087,The Black Dahlia Serial Killers,32,36,51,35,211,365
1182594951,Dubs Talk: A Golden State Warriors Podcast,2,5,1,3,9,20
1182787916,Ostium Podcast,5,13,4,7,21,50
1182818802,UK True Crime Podcast,29,16,14,15,148,222
1182825676,Monster Of The Week: A Supernatural Podcast,1,0,0,1,64,66
1182867683,Reality Steve Podcast,95,19,30,21,335,500
1182878969,Fanachu! Podcast,0,0,0,0,3,3
1183011900,Psych Rewind,3,1,0,3,8,15
1183017174,Wild Ideas Worth Living,4,3,3,3,260,273
1183076342,Baseball by the Book,2,2,2,5,259,270
1183089072,Show Your Work,7,5,8,5,17,42
1183093544,Nutrition Facts with Dr. Greger,2,2,1,3,42,50
1183123221,LadyBrains,17,2,1,2,145,167
1183345770,Fashion No Filter,0,0,3,2,10,15
1183404610,Doorway To Mexico | Learn Spanish with Intermediate and Advanced Conversations,0,0,0,1,18,19
1184022695,The Jordan B. Peterson Podcast,336,70,77,154,2702,3339
1184090054,Alias Rewind,0,1,0,1,3,5
1184104197,Black Girl Podcast,13,3,4,10,114,144
1184236525,Social Media Secrets with Rachel Pedersen - The Queen of Social Media,0,0,0,1,49,50
1184273633,The Science of Christmas: How Santa Delivers Presents,0,0,0,0,1,1
1184598130,American Gods,6,1,2,3,35,47
1184615147,Westside Fairytales: Horror and Dark Fiction Stories,1,0,2,0,47,50
1184957849,Brain over Binge Podcast,2,6,2,1,38,49
1185013324,State Secrets,0,0,0,0,3,3
1185023674,Perpetual Chess Podcast,0,0,0,1,49,50
1185048025,Darkness Radio,3,2,1,0,44,50
1185051864,Bravo TV's The Daily Dish,49,19,23,16,119,226
1185333816,Tarot Bytes,0,0,1,2,157,160
1185558472,Judo Chop Suey Podcast,1,0,0,0,10,11
1185660348,Famous at Home,1,0,1,1,47,50
1185664990,The Bourbon Daily,4,3,3,0,64,74
1185710201,LOVE SOMEONE with Delilah,0,0,2,2,26,30
1185762874,"Studio 78: Branding, Productivity, & Business Tips for Female Creative Entrepreneurs",0,0,0,0,40,40
1185850313,Russian Made Easy: Learn Russian Quickly and Easily,0,0,1,1,15,17
1186089636,The Official Podcast,2,1,0,2,44,49
1186098620,H3 Podcast,140,40,62,26,732,1000
1186199709,Board Game Design Lab,0,0,0,2,32,34
1186396321,The Mason Jar,0,0,0,2,18,20
1186449155,The Hollywood in Toto Podcast,0,0,1,2,21,24
1186480811,The AI Podcast,0,0,0,4,21,25
1186794832,Gov Actually,0,0,0,0,6,6
1186824033,American Birding Podcast,0,4,1,1,52,58
1186889023,The Strategy Hour Podcast: Online Business | Blogging | Productivity - with Think Creative Collectiv...,0,0,0,0,24,24
1187006754,Overland Bound,0,0,1,0,9,10
1187085559,Laker Film Room - Dedicated to the Study of Lakers Basketball,7,2,3,2,176,190
1187357113,Dumb People Town,7,6,3,5,29,50
1187370945,nowyouknow's podcast,1,2,1,1,27,32
1187535449,JoJo's Bizarre Podcast,0,1,1,0,31,33
1187569162,Salon Owners Collective,0,0,0,0,8,8
1187593737,Sailing Stories,2,1,2,1,67,73
1187636438,"Easy Paleo, Gluten & Dairy Free Cooking",0,0,0,0,15,15
1187664795,FieldCraft Survival,6,3,2,2,351,364
1187670279,Deck the Halls (with Matrimony!),0,1,1,0,37,39
1187767105,Blessed + Bossed Up,0,0,4,4,192,200
1187770032,ChooseFI,17,10,13,8,152,200
1188042458,FOAMfrat Podcast,1,0,0,0,32,33
1188043651,"The Millennial Homemakers™: Interior Decorating, Hostessing, Homemaking, & Lifestyle Tips",2,0,1,2,14,19
1188345121,Level Up - From Agent to Entrepreneur,0,0,0,1,33,34
1188399653,Accounting Today Podcast,1,1,1,0,2,5
1188406469,MadPx: A Brief History of Power,0,0,0,0,21,21
1188487073,Side Hustle School,15,5,3,5,172,200
1188489488,Radical Candor,2,2,5,7,161,177
1188677160,This Week In The Garden with Peter Seabrook,0,1,0,0,2,3
1188724250,1A,76,39,46,64,275,500
1188838904,Debrief,0,1,0,1,1,3
1188839562,Out There With the Birds,0,0,0,0,5,5
1188898432,I Don't Get It,100,32,36,34,298,500
1189110529,AFTV | All Gunz Blazing Podcast,5,1,0,0,8,14
1189786540,The Paul McGuire Report,1,0,1,1,3,6
1189939833,This Week in the BIG EAST - Weekly Overview of NCAA College Basketball's Top Conference,0,0,0,0,11,11
1189978971,Late Night Linux,2,1,0,0,16,19
1190000968,Eat Sleep Work Repeat,2,0,0,0,10,12
1190024290,Fatima Barkatulla,0,0,0,0,3,3
1190094109,The Adam Schefter Podcast,16,4,4,8,44,76
1190132229,College Sports Now,0,0,0,1,9,10
1190204515,Hi-Phi Nation,3,1,1,0,89,94
1190341231,Financial Advisor Success,1,0,1,1,71,74
1190625755,Wrong Station,3,1,1,2,39,46
1190662967,Story Matters,0,0,0,0,50,50
1190847157,Football Social Daily,0,0,1,1,32,34
1190896090,The Seen and the Unseen - hosted by Amit Varma,7,0,2,3,27,39
1190943472,The Purpose Show,0,1,0,1,48,50
1190973394,Let's Parent on Purpose with Jay Holland,0,0,0,0,44,44
1190977355,Summit Salon Minute,0,0,0,0,1,1
1190981360,This Past Weekend,22,3,8,4,461,498
1191011680,Awesome Etiquette,9,8,5,7,77,106
1191027685,DMXS Radio,2,0,0,0,9,11
1191112800,Hollywood & Levine,1,0,1,1,104,107
1191143178,The Strange and Unusual Podcast,1,0,4,3,42,50
1191180794,The Copywriter Club Podcast,0,0,0,0,50,50
1191227775,"THE CEO PSYCHE PODCAST | BRAIN-BASED ONLINE BUSINESS, SALES PSYCHOLOGY",0,0,0,0,50,50
1191265255,Keys To The Shop : Equipping Coffee Retail Professionals,0,0,0,0,43,43
1191274361,The Minds of Madness - True Crime Stories,41,34,55,42,328,500
1191355791,Running Rogue,5,1,3,3,39,51
1191411985,Dumbgeons & Dragons,0,1,0,1,47,49
1191482456,The ONE Thing with Geoff Woods,1,3,3,2,191,200
1191490065,The Beginner's Garden with Jill McSheehy,2,1,3,1,43,50
1191606694,kPod - The Kidd Kraddick Morning Show,14,3,3,5,25,50
1191649738,The Letters Page,0,0,0,2,39,41
1191681161,Energy Policy Now,0,0,0,0,16,16
1191692019,PS I Hate This Movie,11,1,3,7,476,498
1191775648,Impact Theory with Tom Bilyeu,0,0,1,1,20,22
1191831035,Don't Keep Your Day Job,0,0,1,1,198,200
1191851979,The Lapped Traffic Podcast- Nascar,0,0,0,0,49,49
1191897461,The Firn Line,0,0,1,0,102,103
1191909632,Close Reads,4,4,2,3,107,120
1192087292,The Survivor Specialists: Phil and Alexa,7,2,4,4,43,60
1192105323,Fasting Talk,14,8,5,6,17,50
1192143792,Addicted Fishing Podcast,3,1,0,3,39,46
1192159898,Two Judgey Girls,110,36,49,28,277,500
1192333396,Rosecast | 'Bachelor' Recaps with Rim and AB,2,1,3,2,492,500
1192435712,Petals and Pricks: The Bachelor and Bachelorette Podcast,1,0,0,2,34,37
1192761536,Pod Save America,112,24,30,32,202,400
1192805159,Introduction to Computer Science and Programming in Python,0,0,0,1,1,2
1192810215,Living Myth,0,0,0,0,56,56
1192864007,True Crime Guys,28,12,7,11,439,497
1192871269,I'm Working On It With Matthew P Brown,0,0,0,0,5,5
1192875599,"The Element Podcast | Hunting, Public Land, Tactics, Whitetail Deer, Wildlife, Travel, Conservation,...",1,0,0,0,247,248
1192876328,Eat. Play. Sex.,2,1,0,0,25,28
1192992870,Knowledge Fight,1,0,0,2,47,50
1192996514,The Plaidcast,1,0,1,1,22,25
1193014252,This Organized Life,3,1,3,1,42,50
1193039969,Obstacle Running Adventures,0,0,1,2,34,37
1193040557,Data Engineering Podcast,0,0,0,1,7,8
1193045798,The 12 Steps and Buddhism - from Judith Ragir and others,0,0,0,0,2,2
1193063555,Make Moments Matter:  A Music Education Podcast,0,0,0,0,48,48
1193065784,Courage & Clarity,1,2,1,1,45,50
1193065871,Hineni (Here I Am),0,0,0,0,10,10
1193068130,Crime Stories with Nancy Grace,104,22,22,8,120,276
1193077828,Another Bachelor Podcast,18,2,1,5,474,500
1193115628,Kevin's Cryptids,1,2,0,1,46,50
1193293445,Sixers Talk: A Philadelphia 76ers Podcast,0,0,1,1,13,15
1193332670,Hakai Magazine Audio Edition,0,0,0,0,4,4
1193591199,Leading Voices in Real Estate,0,3,0,0,31,34
1193611459,Sexology,0,0,0,0,50,50
1193651650,Bedtime Stories,2,1,0,0,118,121
1193681611,The Inside Line Podcast - Vital MTB,1,0,0,4,22,27
1193720457,The Strange Case of Starship Iris,3,2,1,4,166,176
1193725606,Poker Stories,0,0,1,1,48,50
1193758599,The FreshRN Podcast with Kati Kleber,2,0,4,5,36,47
1193800608,The Slow Melt: A podcast about chocolate,0,0,0,0,25,25
1193810500,Talking GolfGetaways: Your Golf Getaways Podcast,0,0,0,0,4,4
1193834591,"Switch, Pivot or Quit",2,1,0,3,70,76
1193909390,Psych Essentials,0,0,0,1,6,7
1193988503,The Mustards,1,0,0,1,66,68
1194158462,The RV Show USA Podcast,2,2,2,0,5,11
1194470795,The Analyst Inside Cricket,0,0,0,1,9,10
1194548143,Judaism From Within,0,0,0,1,1,2
1194574160,Intre showuri podcast,0,0,0,0,2,2
1194659367,Frankly Speaking About Family Medicine,3,0,0,3,8,14
1194704874,Harmony UU Podcast,0,0,0,0,1,1
1194755213,Small Town Murder,8,5,1,1,482,497
1194834764,Dr. Greenthumb Podcast,0,0,0,0,21,21
1194875626,Hazard Ground,1,0,1,0,48,50
1194913358,The Losers' Club: A Stephen King Podcast,5,4,2,5,34,50
1195001633,Smashing Security,4,1,0,1,64,70
1195084822,Speaking Broadly,1,0,0,1,12,14
1195141026,The Chromebook Classroom Podcast,0,0,0,0,11,11
1195206601,Intercepted with Jeremy Scahill,15,5,3,4,23,50
1195238167,The B. Scott Show,21,16,13,17,177,244
1195253252,Trotadores,0,0,0,1,15,16
1195362330,Other Life,4,0,0,2,13,19
1195370479,The Scottish Rugby Podcast,0,0,0,0,1,1
1195379864,Dames and Dragons,0,0,0,0,50,50
1195432740,Team VTAC with Kyle Lamb,0,0,0,1,138,139
1195440564,Interdimensional RSS: The Unofficial Rick and Morty Podcast,0,1,1,0,74,76
1195484262,True Crime All The Time Unsolved,34,12,24,17,338,425
1195586628,Peace Out,4,1,1,3,41,50
1195657423,Civics 101,12,8,2,3,25,50
1195695960,Aquarium Myths and Secrets Revealed,0,0,0,0,11,11
1195733658,Ready Set Blow Podcast with Randy Valerio and Chase Abel,7,0,0,1,12,20
1195829295,The GamesIndustry.biz Podcast,0,0,1,0,2,3
1195897108,Road Trippin’,25,3,8,9,366,411
1195955730,Burn it Nutrition Podcast,5,4,5,4,32,50
1195967486,Ever Forward Radio with Chase Chewning,0,0,0,1,49,50
1196030191,Game Misconduct with Don La Greca,3,0,0,1,25,29
1196054437,The Doctor Who Audio Dramas,0,0,0,0,3,3
1196081025,A to B Podcast: Simplicity | Organization | Fun,0,0,0,1,49,50
1196082126,Riveting Stories 18+,2,0,0,0,1,3
1196106699,The Melissa Ambrosini Show,0,0,0,0,50,50
1196134359,Tape Op Podcast,3,1,2,1,17,24
1196155959,Airplane Intel Podcast - Aviation Podcast,1,0,0,0,34,35
1196574285,Lookout Landing: for Seattle Mariners fans,1,0,5,3,7,16
1196829434,Life In The Stocks,0,0,0,0,13,13
1196875127,Brian Moore's Full Contact Rugby,0,0,0,0,4,4
1197082547,White Coat Investor Podcast,3,2,4,1,146,156
1197087242,The Confessionals,60,19,18,14,389,500
1197145825,Google Teacher Podcast,1,1,1,0,47,50
1197440162,Rugby Union Weekly,35,26,35,38,231,365
1197760653,"7 Minute Job Interview Podcast - Job Interview Tips, Resume Tips, and Career Advice",1,2,1,2,103,109
1197907469,Professor Messer's Network+ Study Group,0,0,0,0,5,5
1197907792,Professor Messer's A+ Study Group,0,0,0,0,5,5
1197908641,Professor Messer's Security+ Study Group,0,0,0,0,2,2
1197909615,Skytalkers,4,3,2,1,141,151
1197924737,And The Writer Is...with Ross Golan,2,1,2,5,134,144
1197955534,RX'D RADIO,0,0,0,0,50,50
1198117246,SEN Breakfast,1,4,5,5,15,30
1198119168,The First Serve,0,0,0,0,1,1
1198238095,Can He Do That?,16,6,3,5,20,50
1198287501,The Magicians,1,1,0,4,73,79
1198368203,LA Theatre Works,0,2,3,0,24,29
1198694952,After the Fact,0,0,0,0,21,21
1198704323,Fantasy Hockey Podcast,4,0,0,0,54,58
1198732014,The Curbsiders Internal Medicine Podcast,1,2,4,2,41,50
1198899314,Threshold,0,0,0,0,58,58
1199086209,The Midnight Myth Podcast,0,0,1,1,28,30
1199101868,She Means Business Show,0,0,0,4,117,121
1199230234,Regenerative Skills,0,0,1,0,13,14
1199559501,MindShift Podcast,1,0,0,0,13,14
1199570390,Weight Loss for Busy Physicians,0,0,3,1,46,50
1199607462,eCommerce Evolution,0,0,1,0,14,15
1199620245,The Hustle And Flowchart Podcast,0,0,0,0,50,50
1199648212,Sandy's Spiel,0,0,0,0,2,2
1199677372,Decorating Tips and Tricks,1,0,1,2,46,50
1199768588,Sexy Unique Podcast,34,12,12,16,362,436
1199780143,Barbell Medicine Podcast,1,1,0,1,47,50
1199902190,What Happened When,26,15,20,14,424,499
1199918249,The Patrick Coffin Show | Interviews with influencers | Commentary about culture | Tools for transfo...,11,2,3,3,128,147
1199964972,Bronzeville,0,0,0,1,49,50
1199977889,The Marie Forleo Podcast,3,0,0,3,44,50
1199988093,Skillset Live,1,1,0,0,48,50
1200016351,Pod Save the World,12,2,3,3,30,50
1200068608,Education Research Reading Room,0,0,0,0,6,6
1200202500,Lakers Nation Podcast,6,2,3,4,112,127
1200315036,Fiber Talk,0,0,1,0,7,8
1200343264,Fore Play,114,32,23,20,311,500
1200344562,"The Awakened Man: A Repository For Holistic Health, Red Pill Alpha Masculinity, & Ultimate Freedom",4,1,3,4,232,244
1200361736,The Daily,994,238,266,210,1687,3395
1200400599,Simply Joyful Podcast with Kristi Clover | Encouragement for your Faith and Family,0,5,2,3,40,50
1200537009,The Third Wave,0,1,1,3,45,50
1200558045,Fall of the House of Sunshine,0,0,1,1,48,50
1200570855,Run to the Top Extra Kick Podcast | Answers to Your Running Questions,0,0,2,6,42,50
1200574924,Bilingual Podcast,2,0,0,0,10,12
1200915759,The Fr. Mike Schmitz Catholic Podcast,1,1,0,3,181,186
1200922230,Boundless Way Temple Dharmacast,0,0,0,0,1,1
1200930280,"Hashtag Authentic - for small businesses, bloggers and online creatives",1,0,0,2,47,50
1200938612,Turn Me On,3,2,3,1,27,36
1200953842,Talk About Gay Sex TAGSPODCAST,3,1,5,3,15,27
1201031401,The Money Cafe with Kirby and Kohler,8,2,3,10,55,78
1201114838,Breaking Math Podcast,3,2,4,0,21,30
1201172784,My Camino - the podcast,0,0,1,0,12,13
1201175622,The Melrose Place Podcast,0,0,0,0,54,54
1201250076,Bhagavad Gita Telugu,0,0,0,0,1,1
1201255510,Coffee Break Chinese,0,0,0,0,9,9
1201263130,10 Minute Teacher Podcast,2,0,0,1,47,50
1201282412,The Jeff Cavins Show (Your Catholic Bible Study Podcast),0,0,1,1,128,130
1201285069,The CEDIA Podcast,0,0,0,0,1,1
1201314368,The National Security Law Podcast,0,1,2,3,44,50
1201340557,RealTrending,0,0,0,0,2,2
1201353493,Art Marketing Podcast,0,0,1,0,25,26
1201374883,The FsRideAlong Podcast,1,0,0,0,0,1
1201514593,Same Old Arsenal Podcast,0,0,0,1,3,4
1201883178,Manifest It Now a Law of Attraction Show,4,1,2,2,56,65
1201927184,History of the 90s,1,2,3,3,41,50
1201932953,The Property Management Mastermind Show,0,0,0,0,15,15
1201940175,Congratulations with Chris D'Elia,7,0,0,0,43,50
1201968027,Ongoing History of New Music,0,1,0,2,29,32
1201993943,Fore Golfers Network Podcast,0,0,0,0,25,25
1202030860,The Ghost Story Guys,10,5,5,2,162,184
1202134377,Film Threat,0,0,0,0,11,11
1202281739,Global Translations,4,4,1,3,44,56
1202440119,Challenged: A Podcast About MTV's The Challenge,29,15,7,17,206,274
1202441485,WSJ Minute Briefing,6,0,6,7,12,31
1202449205,Holistic Plastic Surgery Show,1,0,0,0,49,50
1202569587,Simple Families,0,1,1,2,46,50
1202593158,Downtime - The Mountain Bike Podcast,0,0,1,1,26,28
1202658303,Keep Calm and Carry Yarn: A Knitting and Crochet Podcast,0,1,0,0,10,11
1203110397,Strange Familiars,7,5,6,2,131,151
1203122183,NBA Front Office w/ Keith Smith & Trevor Lane,0,0,0,0,25,25
1203133627,In Other Words,0,0,0,0,9,9
1203289615,Be Calm on Ahway Island Bedtime Stories,4,1,2,6,37,50
1203298546,The Hot Dish,0,0,0,0,2,2
1203393721,Good One: A Podcast About Jokes,2,0,3,2,43,50
1203460937,The Current,2,0,1,6,46,55
1203487709,Mac & Gu Movie Club,0,2,1,1,183,187
1203577635,The 3028: Disney History & Disney Listory,1,0,0,1,48,50
1203637893,World’s Toughest Podcast,0,0,2,2,135,139
1203778895,The Honest Designers Show,1,0,2,5,159,167
1203808663,"The Bad Girls Bible - Sex, Relationships, Dating, Love & Marriage Advice",10,2,6,6,26,50
1203911564,The Official Disney on Broadway Podcast,0,0,0,1,5,6
1204019130,wellRED podcast,1,0,2,0,47,50
1204331735,WHERE BRAINS MEET BEAUTY,0,1,0,0,14,15
1204429149,Challenge Mania,33,29,54,41,323,480
1204492895,Strange Animals Podcast,1,0,0,1,31,33
1204506559,CITIUS MAG Podcast with Chris Chavez,3,1,7,0,211,222
1204512892,Iditapod,0,1,0,1,23,25
1204521130,Machine Learning Guide,2,1,1,1,86,91
1204523870,Ali on the Run Show,4,2,2,3,489,500
1204570053,And That's Why We Drink,8,3,7,3,476,497
1204590888,American Wannabes Podcast,1,0,0,0,49,50
1204628230,The Last 10 Pounds Podcast,4,1,0,0,45,50
1204629419,Inkwyrm,0,0,0,7,17,24
1204749824,Keep It Weird,1,0,0,0,49,50
1204792336,Freshly Grounded,0,0,0,0,10,10
1204885502,Pure Cinema Podcast,1,0,1,5,106,113
1204915178,The FPV Show,1,0,0,0,49,50
1204941994,High Resolution,0,0,0,2,47,49
1204967493,Epic Outdoors Podcast,4,2,0,1,47,54
1205030005,Serial Killers,174,126,150,150,816,1416
1205144996,"Drinking From the Toilet: Real dogs, Real training",0,0,0,1,49,50
1205188014,NeoScum,0,0,1,1,48,50
1205350530,Cinemaholics – Movie Reviews,3,2,0,1,17,23
1205352558,Creepy,6,6,2,4,32,50
1205359334,Hidden Forces,7,5,2,1,185,200
1205394015,Nintendo Power Cast - Nintendo Podcast,5,1,2,4,116,128
1205661081,Just The Discs Podcast,2,0,1,1,19,23
1205668403,Draft Dudes – Daily Podcast On The NFL Draft And College Football,13,0,4,7,148,172
1205679186,AT Parenting Survival Podcast: Parenting | Child Anxiety | Child OCD | Kids & Family,0,0,0,0,50,50
1205778260,Discography Discussion,4,0,1,1,34,40
1205997729,This Is Success,5,4,2,1,31,43
1206006469,The Jennifer Allwood Show,0,0,1,1,98,100
1206072242,Capitals Talk,23,16,12,2,142,195
1206165808,Indie Hackers,1,0,0,1,133,135
1206175991,The Best of Coast to Coast AM,48,11,17,11,42,129
1206243851,Body Science Podcast,1,0,0,0,2,3
1206307740,You Meet In a Tavern - A 5E D&D Actual Play Podcast,1,1,2,1,45,50
1206416686,Abiding Together,0,1,3,0,294,298
1206428899,Orange Mud Adventure Channel,0,0,0,0,3,3
1206534123,The Weekly Bible Study Podcast with Tim Hegg,2,0,0,0,5,7
1206572956,Telemetry: The sound of science in Yellowstone,0,0,0,1,9,10
1206817375,Wine & Crime,2,1,0,1,46,50
1206967377,The Passion People Podcast,0,0,1,1,9,11
1207216266,Perfectly Imperfect with Christine and Regina,0,0,0,1,36,37
1207507774,What It Means,0,0,0,2,4,6
1207546879,Hamza Yusuf,1,0,0,2,7,10
1207559390,Talking Mom2Mom,0,0,0,0,2,2
1207583745,Grant’s Current Yield Podcast,4,3,4,3,55,69
1207584759,The Intellectual Agrarian: Philosophy From The Farm,0,0,1,1,17,19
1207586509,The Common Descent Podcast,1,1,0,4,50,56
1207627414,The Rugby League Digest,0,0,0,0,1,1
1207649390,Speaking Your Brand: A Public Speaking Podcast,0,0,0,1,49,50
1207650846,Abundant Practice Podcast,1,1,0,0,36,38
1207672748,Everyday Buddhism: A Jodo Shinshu Buddhism Podcast,0,0,0,0,1,1
1207719562,Barca Talk,0,1,2,2,34,39
1207876943,Inside Psycho,7,16,10,9,167,209
1207947871,The WWE Podcast,15,5,2,2,39,63
1207966428,Lake Clarity,5,5,6,14,20,50
1208024744,Kwik Brain with Jim Kwik,0,2,0,2,30,34
1208147571,Pilot to Pilot - Aviation Podcast,0,0,0,0,50,50
1208172851,Luthier on Luthier with Michael Bashkin,0,0,1,0,26,27
1208232103,The Buck Sexton Show,16,4,5,7,468,500
1208247372,Goalie by Garman - How to Become a Great Goalie,0,0,0,0,5,5
1208276423,Jim Cornette’s Drive-Thru,29,1,8,4,164,206
1208435573,Private Parts,10,11,14,21,272,328
1208550311,Forth And Ten,0,0,0,3,47,50
1208566730,Mother Earth News and Friends,1,0,1,1,11,14
1208568777,RD Real Talk - Registered Dietitians Keeping it Real,0,0,1,1,48,50
1208799616,"The Betrayed, The Addicted, The Expert",0,0,0,4,46,50
1209130206,The Raven Effect,7,5,4,2,315,333
1209162288,The Zen Studies Podcast,1,0,1,0,19,21
1209196729,Savor,24,30,24,20,102,200
1209205258,Gud Vibrations Radio,0,1,0,0,30,31
1209219220,The Futur with Chris Do,0,0,0,0,5,5
1209287641,Kar Dishin' It : All Things Kardashian,10,2,5,4,191,212
1209320782,Take a Break from Drinking,0,1,0,2,47,50
1209328985,PolliNation,0,0,0,2,26,28
1209574213,Chat of the Wild,0,0,0,4,16,20
1209601557,RABBITS,3,2,7,11,27,50
1209616598,JS Party: JavaScript & Web Dev,0,0,1,0,6,7
1209717766,Bullet Cast,0,0,0,0,2,2
1209719013,Understanding Today's Narcissist,1,1,0,2,43,47
1209725805,Quran Garden - The Holy Quran Explained in Clear English (English Tafsir),0,0,0,0,2,2
1209794530,WILD + FREE,0,1,1,4,44,50
1209819706,Swing-Trading the Stock Market,3,0,1,2,65,71
1209821045,That Triathlon Show,1,0,0,2,129,132
1209825233,Ash Tales | Stories of the Apocalypse,1,0,0,0,7,8
1209834771,Ultimate Guide to Partnering™,0,0,0,0,27,27
1209849464,The Musafir Stories - India Travel Podcast,0,0,0,3,24,27
1210156055,Red Line Radio,4,7,2,6,479,498
1210248513,Team Flower,2,1,1,1,26,31
1210250626,Below the Belt,112,20,19,17,299,467
1210294497,NutritionFacts.org Video Podcast,0,0,3,2,15,20
1210383304,"Real Vision: Finance, Business & The Global Economy",67,9,4,3,106,189
1210513735,The Blacksmith's Pub Podcast,0,0,0,0,37,37
1210544585,Benched with Bubba,0,0,0,0,69,69
1210590811,"Nir And Far: Business, Behaviour and the Brain",2,0,0,1,16,19
1210741497,The Investing for Beginners Podcast - Your Path to Financial Freedom,24,22,10,16,116,188
1210796291,Monday Morning Critic Podcast,0,0,0,0,16,16
1210802178,I Think You're Interesting,1,1,2,4,15,23
1210879676,Emergency Medical Minute,1,2,1,0,13,17
1210880174,"Sing Better Fast! | Vocal tips, singing lessons, voice exercises, etc.",0,0,0,5,29,34
1210935826,Black Widow Podcast,1,3,4,7,185,200
1210975738,Straight A Nursing,0,0,0,1,49,50
1210989839,Bang On,1,0,0,1,92,94
1211124529,Live Long and Master Aging,0,0,1,0,15,16
1211183700,On The Ledge,0,1,1,0,48,50
1211264043,Sequelcast 2 and Friends,0,0,0,0,4,4
1211312212,School of Motion Podcast,0,0,0,0,114,114
1211325733,Mars,0,0,0,0,2,2
1211524662,SpawnCast,1,4,3,2,11,21
1211525783,"Addicted to the Mouse: Disney Podcast | Disney World, Universal, & Cruise Vacation Planning",0,0,1,0,87,88
1211560322,Podcasts We Listen To,1,2,0,1,52,56
1211653413,The Puppy Podcast,0,0,0,2,13,15
1211754233,"WIRED Security: News, Advice, and More",1,0,1,0,3,5
1211763424,Paint All The Minis Paint Ramble,0,0,0,1,11,12
1211768503,Very Random Encounters: Chaotic Improv Actual Play,0,0,0,1,49,50
1211773564,Beauty Is Your Business,0,0,0,0,5,5
1211852349,Bassmaster Radio,0,0,1,0,3,4
1211894042,Yaqeen Podcast,0,0,0,1,7,8
1211900236,The Ouija Broads: Tales from the Pacific Northweird,2,0,2,0,53,57
1211918019,Texas Oil and Gas Podcast,1,1,3,2,132,139
1212045046,Trailblazers with Walter Isaacson,1,0,0,2,71,74
1212064750,Under The Skin with Russell Brand,30,5,18,20,427,500
1212067772,The Jason Smith Show,1,1,0,1,16,19
1212068497,Outkick the Coverage with Clay Travis,24,1,2,5,468,500
1212071266,The Odd Couple with Chris Broussard & Rob Parker,9,6,4,4,106,129
1212071900,Straight Outta Vegas with RJ Bell,9,4,2,5,45,65
1212097275,Equity Mates Investing Podcast,3,1,4,4,81,93
1212124420,Music Production Podcast,0,0,2,2,30,34
1212155999,Queens Podcast,7,1,3,3,36,50
1212164645,Advanced Spanish,1,1,0,1,2,5
1212165069,Advanced French,0,0,0,0,3,3
1212185658,The Push - A Traditional Archery Podcast,0,1,0,1,107,109
1212222912,Game of Thrones: On the Throne Podcast,25,20,8,9,298,360
1212235695,The Modern Maker Podcast,3,1,3,2,191,200
1212380212,The Five,82,18,25,31,159,315
1212504521,The One Day At A Time Podcast,0,4,2,1,24,31
1212538589,French Conversations for Beginners – Real Life Language,6,7,2,2,13,30
1212558767,S-Town,24,17,13,15,430,499
1212571693,Parenting ADHD Podcast,1,1,0,2,27,31
1212734488,The Oz Network - TV & Film Recaps,0,0,0,1,0,1
1212911092,The Workplace Therapist Show,0,0,0,0,18,18
1212929626,The Mike Calta Show Featured Cut of the Day,2,0,1,0,1,4
1212985132,Believe You Me with Michael Bisping,8,7,4,7,474,500
1213042361,EAA's The Green Dot - An Aviation Podcast,1,0,1,0,40,42
1213118533,Ideas to Invoices,0,0,0,0,6,6
1213337541,Kahani Suno,0,2,3,4,35,44
1213415786,Chopper's Politics,9,2,3,3,33,50
1213421482,Canes Corner Podcast,0,0,0,0,18,18
1213443885,Everybody's National Parks,0,0,1,1,22,24
1213443908,"hey, girl.",0,0,5,3,176,184
1213591127,Cosmic Vertigo,0,0,0,0,10,10
1213724099,Latitude Photography Podcast,1,1,0,0,11,13
1213881069,The BHooked Podcast for Crochet & Knitting Enthusiasts,0,0,0,1,44,45
1213946592,Jason Dick AF,3,3,2,2,17,27
1213962617,"El Bueno, la Mala y el Feo",15,1,4,4,13,37
1213974770,Embrace The Void,0,0,1,0,23,24
1214113189,The Dive - A League of Legends Esports Podcast,2,0,1,0,49,52
1214156714,GSAPP Conversations,0,0,0,0,1,1
1214369445,Phillies Talk: A Philadelphia Phillies Podcast,1,0,0,2,23,26
1214440424,The Covenant Cast,0,0,1,0,31,32
1214452771,Breaking Beauty Podcast,5,4,3,8,180,200
1214489518,Lean Life Radio,0,0,0,0,23,23
1214646476,Corpus Animus Podcast,0,0,0,0,10,10
1214664324,Python for Everybody (Video/PY4E),1,0,0,0,6,7
1214679007,gone cold podcast - texas true crime,33,28,16,8,137,222
1214713745,Mastering Intensive Care,0,0,0,0,5,5
1214724849,"By Kids, For Kids Story Time",5,1,3,6,35,50
1214760051,The Mindful Dietitian,0,0,0,0,7,7
1214836120,Living the RV Dream,0,0,0,1,14,15
1215027160,Brokedown Podcast,0,0,0,0,39,39
1215052677,Vedic Worldview,0,0,0,0,23,23
1215059384,Matters of Policy & Politics,3,5,0,1,32,41
1215115585,Full Coverage,1,0,0,0,65,66
1215365810,On The Bench: An FSU football podcast,12,6,10,6,205,239
1215386938,Sticky Notes: The Classical Music Podcast,0,0,0,2,161,163
1215420422,The Bible For Normal People,17,6,13,13,286,335
1215424577,Single Smart Female,9,6,4,3,39,61
1215439780,Equity,8,4,9,5,21,47
1215476162,The Stories Behind Wine,0,0,0,0,5,5
1215482070,Beyond The Box Set,0,0,0,0,42,42
1215510944,Tisarana Buddhist Monastery,0,0,0,0,1,1
1215523596,The Chris Harder Show,0,0,0,0,50,50
1215571407,AvTalk - Aviation Podcast,0,0,0,1,49,50
1215646896,PsychEd: educational psychiatry podcast,0,0,0,0,7,7
1215760756,Dirty Erotica,0,1,0,1,11,13
1215810743,ParentingAces - The Junior Tennis and College Tennis Podcast,0,0,0,0,33,33
1216035747,Slayerfest98 (A Buffy the Vampire Slayer Podcast),2,0,0,2,20,24
1216045237,Baseball Things,2,0,0,0,12,14
1216260422,Learn English with the British Council and Premier League,1,1,1,0,3,6
1216346463,Lovett or Leave It,55,17,22,17,389,500
1216418255,Manifest Zone: Exploring the World of Eberron,0,0,0,1,21,22
1216775591,Hebrew In Israel,0,0,0,0,5,5
1216879060,Speak English Now Podcast: Learn English | Speak English without grammar.,0,1,1,0,14,16
1216952656,Scandalous Beauty - A Makeup and Beauty Podcast by Erin Baynham,0,0,0,0,12,12
1217040140,5 Minute Italian,0,0,0,1,13,14
1217144814,The Podcast Discovery Show,0,0,1,1,23,25
1217214391,The Conversation Factory,0,0,0,0,13,13
1217379211,The Fiona Potts Interview,1,0,0,1,5,7
1217591309,The Everyday Astrology Podcast,3,0,0,0,1,4
1217636288,The String,0,0,0,0,3,3
1217657323,Family Ghosts,8,11,9,13,459,500
1217681421,Australian True Crime,122,30,40,24,442,658
1217907061,Disney Travel Secrets - How to do Disney,17,10,3,2,111,143
1217953035,The Black Goat,0,1,0,0,11,12
1217974024,MAPS Podcast,0,0,1,1,17,19
1217975536,The Dan Dakich Show Podcast,117,1,1,2,25,146
1217976554,Evil Thoughts,1,0,0,2,41,44
1218010449,The Equal Rights Institute Podcast,0,0,0,0,3,3
1218054701,Revolutionary Left Radio,5,0,0,0,45,50
1218263890,A Teacher's History of the United States,5,0,0,1,44,50
1218431966,The ZDoggMD Show,2,0,1,0,47,50
1218556999,"AI: The ""C"" Team",0,1,0,2,20,23
1218650505,The Traffic and Funnels Show,1,0,0,0,39,40
1218868456,Rock Talk With Mitch Lafon,4,1,2,3,19,29
1218921251,Podcasts from F3 Nation,0,0,1,0,16,17
1218970459,Windows Insider Podcast,0,0,0,1,4,5
1219105851,"Apsara Skin Care: Tips, Remedies & Info for Flawless Skin & Beautiful Hair",0,0,1,9,90,100
1219412260,The Maker Minded,1,0,0,0,30,31
1219424878,Stories Fables Ghostly Tales Podcast,0,1,0,1,48,50
1219490591,2Bobs - with David C. Baker and Blair Enns,0,0,0,2,29,31
1219493640,New Home Buyers Guide Podcast,0,0,0,0,1,1
1219734739,The Wild Pitch,0,0,0,1,31,32
1219802560,Poker On The Mind Podcast,0,0,0,1,4,5
1219964465,Ask a House Cleaner,0,0,0,1,117,118
1220141801,Adjuster Talk's Podcast,0,0,0,0,23,23
1220200987,Bobbycast,5,0,7,11,288,311
1220495522,Getting Into Nursing School Podcast by NURSING.com (NRSNG),0,0,1,0,1,2
1220510307,Walking The Dog with Emily Dean,8,6,17,23,413,467
1220546899,The Bobby Bones Show,2,3,2,5,38,50
1220563942,Daily Detroit,1,0,1,0,12,14
1220571848,Raising Arrows - Big Family Homeschool,1,0,0,0,18,19
1220616094,"RC Afterhours - RC Planes, Multirotors & Technology",0,0,0,1,30,31
1220673127,Judd’s Hockey Show - a Minnesota Wild podcast,0,0,0,0,4,4
1220808096,Fortunately... with Fi and Jane,8,6,10,8,182,214
1220847890,Sound the Foghorn Podcast on the SF Giants,0,0,0,0,2,2
1220910735,Fully Booked by Kirkus Reviews,0,1,3,0,3,7
1220937301,Tutor Ted Talks College Admissions,0,0,0,0,8,8
1221085548,Epic Gardening: Daily Growing Tips and Advice,0,2,0,1,47,50
1221256195,Everyone Hates Marketers,0,0,0,0,27,27
1221460035,The Interchange,0,1,0,1,59,61
1222041050,Nancy,4,5,3,10,417,439
1222114325,Up First,130,40,40,32,478,720
1223715132,Natch Beaut,3,0,2,1,193,199
1223764016,Capital Allocators,0,0,3,1,116,120
1223767856,This American President,0,1,1,2,46,50
1223768363,My Neighbors Are Dead,1,0,0,0,47,48
1223774438,Battle Of The Atom: An X-Men Podcast,0,0,1,1,39,41
1223775322,Ajahn Anan Podcast,0,0,0,0,1,1
1223779199,Way of Champions Podcast,0,0,0,1,30,31
1223779511,The Calm Kids Podcast,4,1,2,4,39,50
1223781930,Sluts and Scholars,1,0,1,4,44,50
1223782070,Aviation News Talk podcast,0,0,1,0,49,50
1223790589,Dog Soldier Brand: Hunting and Shooting,0,3,2,0,45,50
1223794451,The Plane Faith Podcast,0,0,0,0,12,12
1223799338,Sounding Off with Rick Beato,0,0,0,1,8,9
1223800559,The Sunday Stoic,0,0,0,0,19,19
1223800566,Don't Blame Me!,8,0,1,3,38,50
1223803642,How Leaders Lead with David Novak,0,0,0,0,50,50
1223805240,Inbox Besties w/ Kate Doster | Email Marketing Podcast,0,0,0,1,49,50
1223807254,Welcome Home: A Disney Parks & DVC Podcast,2,2,7,5,90,106
1223813017,OverSaturated: The Podcast,1,1,0,1,42,45
1223815551,The Second Studio Design and Architecture Show,3,3,1,0,40,47
1223817465,LSE IQ podcast,0,0,0,0,1,1
1223821751,Bariatric Surgery Success,0,0,0,0,6,6
1223826201,Golf DMV,0,0,0,0,2,2
1223826362,Gayish Podcast,5,3,1,2,39,50
1223835829,Code 3 - The Firefighters' Podcast,0,0,0,0,6,6
1223846486,The GSD Show,0,0,0,0,38,38
1223937610,The Tennis Abstract Podcast,0,0,0,0,6,6
1224239045,WHOREible decisions,12,1,1,5,31,50
1224373139,The Oasis Podcast,0,0,0,0,24,24
1224455634,WEIGHING IN,2,1,2,0,40,45
1224505389,Fairytales of India,0,0,1,0,16,17
1224814154,NBA DFS Today,2,1,2,4,43,52
1224965828,The Late-Round Podcast,5,5,4,7,478,499
1225041640,F-Stop Collaborate and Listen,0,0,1,2,72,75
1225046939,Friend Code,1,0,1,0,8,10
1225066122,The Chip Chipperson Podacast,3,0,1,2,44,50
1225077306,Recorded Future - Inside Security Intelligence,1,0,1,0,4,6
1225204588,The Business of Fashion Podcast,4,4,4,2,22,36
1225211182,The Well-Storied Podcast,0,0,0,0,25,25
1225683280,The Modern Craftsman Podcast,3,0,0,3,44,50
1225735334,The Running for Real Podcast,9,1,1,11,401,423
1225760210,Every Little Thing,2,1,3,1,43,50
1225820603,Voices of Deconversion,0,0,0,0,9,9
1226030303,B2B Sales Questions Show - Brutally Honest Answers - Sales Hackers Ideas,0,1,0,1,42,44
1226251499,Teaching While White Podcast,4,1,0,0,25,30
1226578658,Forgotten TV,1,0,0,0,18,19
1226601288,State of Combat with Brian Campbell,23,9,5,4,237,278
1226611379,The UGASports LIVE Podcast,0,2,2,1,60,65
1226660198,The Energy Blueprint Podcast,5,2,2,2,39,50
1226719883,Detroit Lions Breakdown Podcast,1,0,1,1,197,200
1226814913,LUCYD,0,0,1,4,16,21
1226904668,Proof to Product,0,0,0,1,72,73
1227281398,the bioinformatics chat,0,0,0,0,1,1
1227313058,Dharma Talks at Columbus KTC,0,0,0,0,3,3
1227316154,The Earful Tower: Paris,3,0,1,2,100,106
1227366661,REI Mastermind Network | Real Estate Investing Strategies & Mindset,0,0,0,0,31,31
1227478901,1001 Stories For The Road,2,1,0,3,44,50
1227532960,Marketing Tips for Photographers | The Tog Republic Podcast,0,0,0,0,47,47
1227699368,Tifo Football Podcast,0,0,2,2,52,56
1227805760,Land Line Now,0,0,0,0,1,1
1227858637,Somewhere in the Skies,6,4,4,2,116,132
1227863378,The Highwire with Del Bigtree,3,0,0,0,47,50
1227872143,AppStories,2,0,2,2,17,23
1227876455,terrestrial,1,0,0,0,20,21
1227971746,Masters of Scale with Reid Hoffman,0,0,2,10,140,152
1228062573,Optimal Relationships Daily,3,2,7,5,41,58
1228121249,Known Pleasures,0,0,0,0,5,5
1228185407,Industrial IoT Spotlight,0,0,0,1,10,11
1228247828,The Sherman Show,0,1,3,2,18,24
1228459191,Lions247 Penn State Podcast,4,3,1,3,223,234
1228461096,Brave New Weed,0,0,0,0,14,14
1228650484,She's Got Drive: Black Women talk about Success and how they achieved it.,0,0,0,0,35,35
1228706016,At Home With...,1,0,0,2,95,98
1228753412,Acres U.S.A.: Tractor Time,0,0,0,2,1,3
1228755008,The Intermittent Fasting Podcast,13,8,5,3,21,50
1228993643,Heather du Plessis-Allan Drive,1,0,0,0,2,3
1229124446,Entiende Tu Mente,0,1,0,0,21,22
1229128411,Undiscovered,6,2,4,3,153,168
1229244615,Story Break,0,1,6,9,255,271
1229248132,WoT Spoilers Podcast,4,1,3,5,70,83
1229324756,Brothers of the Serpent,0,1,1,0,71,73
1229327374,Queer Sex Ed Podcast,0,0,1,0,66,67
1229401800,The Influencer Podcast,10,4,3,3,180,200
1229434818,UnF*ck Your Brain,115,20,40,35,975,1185
1229438369,Secret Leaders,0,0,1,0,2,3
1229504958,The Best Today™ Podcast,0,0,0,0,19,19
1229505030,20 Sided Stories,1,0,1,0,29,31
1229518712,The Mike Hosking Breakfast,8,1,0,0,6,15
1229524677,"Spin Control Podcast: a knitting, spinning, and fiber craft podcast.",0,0,0,0,4,4
1229532498,Food Safety Matters,1,0,0,0,2,3
1229543362,Nonprofit Optimist,0,0,0,0,21,21
1229625388,Other: Mixed Race in America,0,2,1,2,41,46
1229811822,Stories We Tell,0,0,0,0,7,7
1229862115,Documentary of the Week,0,0,0,0,1,1
1229906424,"Murder, Myth & Mystery",16,6,5,8,158,193
1229936240,Thirty Love: Conversations About Tennis,0,0,0,0,4,4
1229949501,Podcasting On A Plane,0,0,0,0,29,29
1230073640,Liz's Healthy Table,0,0,0,1,22,23
1230090911,Let's Argue About Plants,3,4,2,1,38,48
1230115329,Six States One Podcast - A Show About The New England Revolution,0,0,0,0,26,26
1230116944,The Doug Gottlieb Show,20,4,0,2,30,56
1230144270,The Calcioland Podcast,2,1,2,4,196,205
1230148653,Pod Save the People,8,0,3,2,37,50
1230272889,The Addiction Podcast - Point of No Return,7,4,1,0,18,30
1230279792,"FactFruit | Daily News, Information, Current Events",0,0,0,0,7,7
1230372957,The Liz Earle Wellbeing Show,1,0,2,1,93,97
1230490941,NOCTURNAL TRANSMISSIONS : short horror story podcast,0,0,1,3,46,50
1230604702,El Show de Raul Brindis,4,1,0,0,14,19
1230637311,Sight Unseen,14,4,8,7,55,88
1230642052,HACKERHAMIN,6,0,0,1,50,57
1230647935,Whitetail Instinct Podcast,0,0,0,0,1,1
1230806692,Cloud Engineering – Software Engineering Daily,1,0,0,0,0,1
1230953658,Your New Puppy: Dog Training and Dog Behavior Lessons to Help You Turn Your New Puppy into a Well-Be...,1,0,1,1,47,50
1231095568,Attention HellMart Shoppers!,1,1,3,2,43,50
1231126178,How To Talk To Kids About Anything,0,0,0,0,50,50
1231174561,NAR’s Center for REALTOR® Development,0,0,0,0,9,9
1231213240,The Successful Fashion Designer,0,0,0,4,85,89
1231214743,"Fletch, Vaughan & Megan on ZM",1,1,0,2,43,47
1231221600,Pint O' Comics,1,0,0,0,40,41
1231248537,Sober Cast: An (unofficial) Alcoholics Anonymous Podcast AA,0,0,2,1,44,47
1231267110,Classic Wrestling Memories,0,0,0,0,3,3
1231454703,Strawberry Letter,1,0,2,4,23,30
1231454883,The Steve Harvey Morning Show,3,2,3,8,34,50
1231455072,Run That Prank,1,2,1,3,20,27
1231472946,Intermediate French Podcast,0,0,0,0,50,50
1231521180,Really Famous with Kara Mayer Robinson,4,1,0,2,20,27
1231612850,"Bribe, Swindle or Steal",0,0,0,1,32,33
1231680638,The D2D Podcast,0,0,0,2,36,38
1231992070,"Los Angeles County, CA: Board of Supervisors Archives Video Podcast",0,0,0,0,1,1
1232001338,The First Cut Golf,5,6,7,4,149,171
1232009882,True Crime Obsessed,64,24,10,8,180,286
1232052284,So You Wanna Be A Witch,0,0,0,1,51,52
1232059835,Mysterious Circumstances,4,2,0,1,43,50
1232131110,Let's Talk About Sets!,0,0,0,0,40,40
1232273542,Relationships Uncomplicated,0,0,0,1,26,27
1232389532,The On-Premise IT Roundtable,0,0,0,0,7,7
1232423349,Suiting Up with Paul Rabil,1,1,2,3,353,360
1232428553,The Breakfast Club,132,58,84,104,356,734
1232498158,TRIVIALITY - A Trivia Game Show Podcast,1,0,0,2,47,50
1232686397,The Infinite Inning,1,0,1,0,54,56
1232738132,Illumina Genomics Podcast,0,0,0,0,2,2
1232787673,Blunt Business,1,0,0,0,4,5
1232835205,OTHERVERSE,0,0,0,0,9,9
1233041825,The Dear White People Podcast,0,0,0,0,3,3
1233212546,Joette Calabrese Podcast,0,0,0,0,14,14
1233359606,Radio Wonderland,3,1,0,1,45,50
1233482206,Audrey Helps Actors Podcast,1,0,1,1,197,200
1233541837,GrippingGolf,0,0,0,0,15,15
1233548691,Dawson's Speak: A Podcast About Dawson's Creek,1,0,1,3,61,66
1233772510,My Child & ADDICTION,1,0,0,0,11,12
1233834541,Wow in the World,22,10,16,34,498,580
1233966392,Planner Girl Chatter,2,0,3,0,12,17
1234029554,THOR: The Lightning and the Storm,0,0,0,1,24,25
1234030579,Medita Podcast,0,0,0,0,13,13
1234095738,Selling the Sandler Way Podcast,0,0,0,0,1,1
1234118106,Post2Post Hockey Podcast,0,0,0,0,10,10
1234185718,Newscast,8,6,3,2,30,49
1234304336,Deer University,0,0,0,1,52,53
1234320525,WSJ’s The Future of Everything,9,2,5,2,45,63
1234376424,IsraelCast,0,0,0,0,40,40
1234419401,"Plantrama - plants, landscapes, & bringing nature indoors",0,0,0,2,43,45
1234433429,DEER HUNTER,5,2,5,2,134,148
1234462477,The Art of Bombing,0,0,0,0,17,17
1234973013,Golf Betting System Podcast,0,1,0,2,54,57
1235151546,"Self Publishing School : How To Write A Book That Grows Your Impact, Income, And Business",0,1,2,21,176,200
1235694853,Psychedelic Salon,0,0,0,1,25,26
1235736128,IVFML,2,0,1,1,69,73
1235768753,Heritage Explains,6,0,0,0,48,54
1235785829,Dish Nation,0,0,0,0,7,7
1235826100,JAAPA Podcast,0,0,0,1,2,3
1235895808,"Casually Baked, the potcast: Discover hemp and cannabis 420 style",1,0,0,2,29,32
1235917132,Grant Writing & Funding,0,0,0,0,29,29
1236253646,Oliver Heldens presents Heldeep Radio,0,0,0,0,25,25
1236351314,Comedy Fight Club,4,0,1,1,19,25
1236360826,Love & Light Live Crystal Healing Podcast,3,0,0,0,93,96
1236390557,On Margins,0,0,0,0,15,15
1236400835,Zigbits Network Design Podcast,0,0,0,0,3,3
1236481679,Ry Rant Radio,0,0,0,0,6,6
1236513422,Black Lightning Podcast,0,0,0,1,6,7
1236527720,Talking with TK,0,0,0,0,1,1
1236567443,"Wine, Women and Words",0,0,0,0,3,3
1236581365,Dumb-Dumbs & Dragons: A Dungeons & Dragons Podcast,0,0,0,0,14,14
1236584605,Vermont Dog Trainer Show,0,0,0,1,29,30
1236592764,BACK TALK- The Podcast,0,0,0,0,4,4
1236633267,The Brohio Podcast,36,6,4,10,444,500
1236778275,VIEWS with David Dobrik and Jason Nash,138,64,56,64,678,1000
1236818554,PFF Fantasy Football Podcast with Ian Hartitz,13,8,16,16,447,500
1236845161,Happier in Hollywood,3,4,1,2,190,200
1236901698,Play Like A Jet: New York Jets,9,3,4,2,32,50
1236907421,Y Combinator,0,2,0,0,10,12
1236912044,THE FROTHCAST,0,0,0,0,4,4
1236941416,Ebro in the Morning Podcast,14,2,10,12,132,170
1236963001,This Paranormal Life,1,0,0,1,48,50
1237073374,Why We Do What We Do,1,0,1,1,8,11
1237205092,"The Affiliate Guy with Matt McWilliams: Marketing Tips, Affiliate Management, & More",1,0,0,1,48,50
1237389947,Keeping It Real Podcast • Secrets Of Top 1% REALTORS ® • Interviews With Real Estate Brokers & Agent...,0,0,1,1,10,12
1237401284,JavaScript Jabber,2,0,2,1,2,7
1237619606,74 Seconds,8,5,4,8,175,200
1237636223,The Clip Out,3,5,2,4,36,50
1237796990,History Unplugged Podcast,34,31,26,35,240,366
1237931798,Where Should We Begin? with Esther Perel,18,3,3,9,423,456
1238026111,Trust the Bachelor Process,0,1,0,0,29,30
1238028226,A+ Anime Podcast,0,0,0,0,15,15
1238352496,LOMAH Disability Podcast,0,0,0,0,39,39
1238355247,The Ben and Ashley I Almost Famous Podcast,187,50,53,36,174,500
1238384423,Femlore Podcast (formally Feminist Folklore),5,5,0,3,53,66
1238559006,Love and Sex Today,1,0,0,1,42,44
1238559008,Epic Success with Dr Shannon Irvine,0,0,0,0,50,50
1238639514,Authentic Jewish Living with Yiscah,0,0,0,0,5,5
1238801741,"Sincerely, X",49,29,20,16,128,242
1238898901,PerformHappy with Rebecca Smith,0,0,0,0,3,3
1238902672,Join the Party,0,1,1,1,47,50
1238939513,SOFLETE,0,0,0,1,21,22
1239059110,Conversion To Orthodox Judaism,0,0,0,0,1,1
1239060536,Exploring Judaism with Rabbi Michael Skobac,0,0,0,0,1,1
1239068188,The King In The Field with Rabbi Manis Friedman,0,0,0,0,1,1
1239111298,"Audioface: Music News, Reviews, & Culture",0,0,0,0,4,4
1239189458,The World Of Buddy Pegs Children's Podcast,0,0,0,1,14,15
1239217007,Trace Evidence,24,11,31,26,408,500
1239293215,Paisa Vaisa,0,0,0,3,10,13
1239473998,Appalachian Mysteria,2,3,5,23,183,216
1239520331,The Shark Tank | A Sale Sharks Podcast,1,0,0,0,0,1
1239568910,What's Good Games: A Video Game Podcast,2,0,0,1,47,50
1239595469,The Element of Inclusion,0,0,0,0,14,14
1239888602,School's In,0,0,0,0,1,1
1239901676,Discovery Mountain,0,0,0,1,49,50
1240002929,Best Case Worst Case,143,38,30,41,234,486
1240056193,Deconstructing Yourself,0,1,0,0,85,86
1240313984,Dr. James Dobson's Family Talk,1,0,0,1,11,13
1240420549,Off The Vine with Kaitlyn Bristowe,119,28,32,27,294,500
1240435608,Law360's Pro Say - News & Analysis on Law and the Legal Industry,4,0,1,0,45,50
1240482999,"""There I was..."" An Aviation Podcast",0,0,1,1,12,14
1240623065,Margaritaville Podcast,0,0,0,1,11,12
1240834066,Stansberry Investor Hour,15,6,0,3,59,83
1240841298,Ear Hustle,4,0,6,3,487,500
1240842781,Master Your Mix Podcast,0,0,0,0,5,5
1240882207,Start a Local Small Business | Advice to Help You Take Your Business Idea from Concept to Open for B...,0,0,0,1,8,9
1241016182,SFF Yeah!,1,2,0,3,24,30
1241054855,The Spark Creativity Teacher Podcast | Education,0,0,0,0,47,47
1241094874,Commander Cookout Podcast,1,0,0,0,49,50
1241195252,Deconstructor of Fun,0,1,1,1,10,13
1241197566,Berlin Briefing,0,0,0,1,3,4
1241361067,The Far Meridian,2,2,1,1,44,50
1241386674,Cold Case Files,118,97,124,41,120,500
1241536480,Buddhist Boot Camp Podcast,0,0,0,1,22,23
1242028887,Southern Fried True Crime,45,23,31,17,384,500
1242126464,The Barcelona Podcast,2,1,1,1,32,37
1242155321,Australian Birth Stories,0,0,1,3,121,125
1242347126,Seahawks Man 2 Man: A show about the Seattle Seahawks,1,1,1,1,20,24
1242394336,Shameless Sex,2,3,4,1,40,50
1242537529,What Trump Can Teach Us About Con Law,9,2,3,1,35,50
1242630512,Escape This Podcast,1,0,0,0,46,47
1242690345,"Tales from the pits, a Texas BBQ podcast featuring trendsetters, leaders, and icons from the barbecu...",0,0,0,1,33,34
1243077660,The Purple Rocket Podcast,1,0,2,0,47,50
1243130823,John and Ken on Demand,22,2,7,6,39,76
1243134878,Jesus Christ Show,0,1,0,0,2,3
1243138014,The Mo'Kelly Show,1,0,0,1,5,7
1243181579,The Plant Path,0,0,2,0,25,27
1243247464,Binge Mode: Marvel,66,33,34,21,346,500
1243523397,The Breaking Muscle Podcast,0,0,1,1,6,8
1243635889,Johnjay & Rich On Demand,15,5,5,7,18,50
1243706783,The Broadway Cast,1,1,0,1,23,26
1243712798,Mike Tyson: Bite the Mic with Peter Rosenberg,8,6,4,7,125,150
1243930008,The Future of Health,0,0,0,2,6,8
1244148167,The No-Rank Zendo Podcast,0,0,0,0,2,2
1244244730,The Korn Ferry Channel,0,0,0,0,1,1
1244297911,Lynching In America Podcast,0,0,0,0,7,7
1244331156,Journeywomen,1,1,3,4,491,500
1244348213,A Date With Dateline,30,6,3,7,454,500
1244361804,Queer as Fact,0,2,0,3,45,50
1244492651,The Cinema Clash,0,0,0,0,2,2
1244558092,Imagineer Podcast,0,0,0,1,49,50
1244568998,Inside the Disney Vault,2,3,3,5,90,103
1244644906,Highest Self Podcast,1,2,2,6,489,500
1244649384,LeVar Burton Reads,4,2,3,6,485,500
1244784611,30 For 30 Podcasts,95,25,30,30,319,499
1244794198,Neurocritical Care Society Podcast,0,0,0,0,5,5
1244862657,POLITICO's EU Confidential,2,1,0,0,6,9
1244912234,"The Smart Nutrition, Made Simple Show with Ben Brown",0,0,0,1,23,24
1244946489,Fortune's Wheelhouse,0,0,2,0,60,62
1244959034,The Fall Line,27,32,20,20,387,486
1244991969,Confessions of a Train Wreck,0,0,0,1,4,5
1245331505,The joe gardener Show - Organic Gardening - Vegetable Gardening - Expert Garden Advice From Joe Lamp...,0,0,1,0,49,50
1245353218,News & Views with Joel Heitkamp,0,0,0,0,1,1
1245411599,EMBody Radio,2,0,0,1,47,50
1245512568,Player Development Project Podcast - Learning Tools for Soccer Coaching,0,0,0,1,0,1
1245711275,Mat Chat with David Mirikitani,0,0,0,0,1,1
1245763628,The Rachel Hollis Podcast,93,10,12,4,81,200
1245783895,APTA Podcasts,0,3,0,0,0,3
1245809419,Prime Time with Sean Mooney,7,2,5,10,227,251
1245946410,The Throwback Podcast,2,0,1,0,47,50
1245983321,The Nutrition Show,0,1,0,1,20,22
1245995247,In Defense of Plants Podcast,1,0,3,5,112,121
1246009609,Authentic Sex with Juliet Allen,1,3,1,1,44,50
1246042223,Reading Glasses,4,3,5,3,185,200
1246072214,Advanced Talmud Study (Audio),0,0,0,0,2,2
1246293875,Complete The List,0,0,1,1,20,22
1246402780,"Now, What’s Next?",1,0,0,0,8,9
1246443751,Circle Round,2,1,0,1,46,50
1246494475,The mindbodygreen Podcast,4,4,5,3,34,50
1246868105,Beyond the Studio - A Podcast for Artists,0,0,0,1,47,48
1246991088,Epigenetics Podcast,0,0,0,0,6,6
1247146656,Mogul,2,1,0,1,46,50
1247160843,Poorly Educated,2,0,0,1,32,35
1247300054,Cleared Hot,3,1,5,4,487,500
1247309897,Eat For The Planet with Nil Zacharias,1,0,1,2,53,57
1247311946,Cooking the Books with Frances Cook,3,0,0,1,16,20
1247343210,Kinda Funny Games Daily,20,3,4,4,19,50
1247366170,Speak N' Destroy - Interviews About METALLICA,0,0,0,0,50,50
1247425397,Fun Kids Science Weekly,0,0,2,3,45,50
1247519960,Move Forward Radio,0,0,1,0,1,2
1247583410,Feel Good Effect,0,0,0,1,49,50
1247615493,Herpetological Highlights,0,0,0,0,5,5
1247619396,Talking Tax,1,1,1,0,2,5
1247628265,Vedanta Talks,0,0,0,0,10,10
1247691746,Life With Herpes,0,0,0,1,3,4
1247694648,Spike's Car Radio,20,6,3,4,17,50
1247812750,Light On Conspiracies,2,0,0,0,9,11
1247821845,Extraordinary Stories Podcast,1,0,1,1,143,146
1248029578,Saffron and Peri,0,0,0,1,6,7
1248086475,36 Questions – The Podcast Musical,3,1,1,1,44,50
1248468814,The Daily EDGE,0,0,0,0,26,26
1248742174,Open Goal - Football Show,1,1,0,0,0,2
1248852299,Neil Sperry's GARDENS,0,2,0,0,2,4
1248862589,Worldly,38,48,32,36,202,356
1248994688,The Long Game,2,1,1,0,18,22
1249005448,VS,2,1,1,0,49,53
1249064357,Rocky Mountain National Podcast,0,0,0,0,15,15
1249144291,The Michigan Insider,6,6,12,2,111,137
1249189650,The HoopsHype Podcast with Michael Scotto,2,2,2,0,44,50
1249219269,Trace,5,4,7,5,102,123
1249486443,Human Hope with Carlos Whittaker,0,0,0,0,274,274
1249754020,Let's Not Meet: A True Horror Podcast,29,17,23,30,401,500
1249834293,Tape Notes,0,0,0,0,11,11
1249840359,Low-Budget Rebels: An Indie Filmmaking Conversation with Josh Stifter,0,0,0,0,4,4
1250155987,The Modern Bar Cart Podcast,0,0,0,0,17,17
1250180134,It's Been a Minute with Sam Sanders,10,5,4,5,476,500
1250592268,Heels Down Happy Hour,1,1,0,0,26,28
1250599915,RedHanded,68,22,28,23,359,500
1250651733,Horror City Radio,0,0,0,0,5,5
1250656472,Five Hole Fantasy Hockey,0,0,0,1,17,18
1251078708,KSR,7,3,0,6,220,236
1251156926,Truu Stowray,1,0,0,1,21,23
1251196416,Self-Helpless,4,1,1,1,43,50
1251197422,Desert Oracle Radio,1,0,1,2,59,63
1251213764,Petros And Money,2,1,1,2,82,88
1251238874,Keto For Women Show,13,5,1,2,29,50
1251371805,Project Management Happy Hour,0,0,0,1,31,32
1251501033,The Two Shot Podcast,0,0,0,0,8,8
1251546502,Analog Talk,3,0,1,3,29,36
1251557201,Tandem Legends: a Legend of Zelda Podcast,0,0,0,1,74,75
1251624136,Coin Mastery - Building Your Cryptocurrency Empire,1,0,0,0,31,32
1251760537,The Atlanta Foodcast: A Food Podcast,0,0,0,1,15,16
1251908120,The Architecture Firm Marketing Podcast,0,0,0,0,1,1
1252043410,IANDS Presents NDE Radio,9,2,3,1,13,28
1252277802,Made for Profit,0,0,0,0,50,50
1252416553,Bespoken Bones  Podcast,0,0,0,0,25,25
1252417787,Malicious Life,2,0,2,1,267,272
1252488987,The Mind4Survival Podcast,2,0,0,1,38,41
1252503888,Meet the Creatives,0,0,0,0,8,8
1252520163,The OddsBreakers,3,0,2,1,34,40
1252638476,Brooke and Jeffrey: Second Date Update,13,2,6,5,24,50
1252669203,The Infinite Bad,0,1,0,0,39,40
1252771442,Women Inspiring Women,0,1,0,0,199,200
1252845277,The Wellness Business Podcast,0,0,0,1,99,100
1252851787,Octavia E. Butler Studies: Convergence of an Expanding Field,0,0,0,0,1,1
1252855301,Zen Nova Scotia,0,0,0,0,4,4
1252877095,Know Your Gear Podcast,0,0,0,1,15,16
1252878262,The Landscape Photography Podcast,0,0,0,0,12,12
1253053148,The Power Trip,5,1,1,0,50,57
1253059324,Stream Key Podcast: Twitch Streaming Tips,0,0,2,0,17,19
1253076484,Randy Lemmon's GardenLine,0,0,0,0,1,1
1253076699,The Michael Berry Show,2,1,2,2,66,73
1253110409,House of Carbs,13,8,7,6,166,200
1253151066,The Weird Tales Podcast,1,0,1,0,11,13
1253186678,Syntax - Tasty Web Development Treats,1,1,3,5,136,146
1253210160,The Egg Whisperer Show,1,0,0,0,13,14
1253262859,Got it Memorized? A Final Fantasy X Recap Podcast,1,0,0,2,48,51
1253457826,Soccer City presented by LouCity,0,0,0,0,1,1
1253490111,Nomads at the Intersections,2,3,0,3,95,103
1253570474,Your Daily Prayer,8,4,3,2,76,93
1253579121,Kiss 95-7's War of the Roses,10,3,4,4,8,29
1253584901,Elliot In The Morning,3,2,0,3,14,22
1253589026,War Of The Roses,11,2,4,7,13,37
1253593015,Mojo In The Morning,13,3,4,3,27,50
1253595455,Flowerland Garden Show,0,0,0,1,0,1
1253597385,Tarot for the Wild Soul with Lindsay Mack,2,0,1,0,47,50
1253599771,Empire Show,0,0,1,0,88,89
1253622346,Unhappy Hour with Matt Bellassai,4,2,3,2,39,50
1253678242,Physical Attraction,0,0,0,0,27,27
1254001472,Constitutional,3,3,3,2,39,50
1254061093,Typology,2,2,5,7,34,50
1254073246,/Film Daily,20,13,15,10,158,216
1254075020,Popcorn Finance,1,0,0,1,45,47
1254145906,Secret Feminist Agenda,0,0,0,0,76,76
1254488006,Away Message,0,0,0,0,37,37
1254596349,What Does This All Mean?,0,0,0,0,34,34
1254613855,Video Games Weekly,1,0,1,0,16,18
1254720112,The Game w/ Alex Hormozi,1,1,0,0,69,71
1254763503,The Stepmom Club,0,0,0,0,14,14
1254836234,The Transfer Window,11,3,1,1,29,45
1255009497,The Low Carb Cardiologist Podcast,0,0,0,0,23,23
1255032859,Barbell Logic,5,4,1,0,40,50
1255038682,The Art of Decluttering,0,0,0,0,36,36
1255052408,Capture The Magic - Disney World Podcast | Disney World Travel Podcast | Disney World News & Rumors ...,10,6,7,3,115,141
1255186737,Blake and Spencer Get Jumped! An Anime Podcast,1,0,0,1,36,38
1255187573,Left Behind Game Club: A Video Game Podcast,0,0,0,0,7,7
1255329049,Murder and Such,26,15,9,4,203,257
1255334566,True Crime Couple,18,16,18,16,311,379
1255383039,Treks and the City,6,4,9,6,126,151
1255388551,Lords of Limited,0,1,1,1,47,50
1255413349,Legendary Creature - Podcast,0,0,1,0,26,27
1255631614,GI Pearls Podcast,0,0,0,0,50,50
1256010493,The Best & Worst of Walt Disney World - A Weekly Podcast About the best and worst of all things Walt...,2,4,4,4,59,73
1256091892,NerdWallet's Smart Money Podcast,2,2,1,1,17,23
1256093382,Issa Rae Presents...FRUIT,0,1,4,5,109,119
1256141111,The Medium Matters,1,1,1,0,32,35
1256299658,Snowfall Reviews and After Show - AfterBuzz TV,3,2,1,0,0,6
1256311646,House of Strauss: An NBA Podcast,3,3,1,2,58,67
1256553977,A Piece of Work,4,6,4,11,175,200
1256660459,Down in Alabama with Ike Morgan,2,0,1,0,23,26
1256754097,Inside of You with Michael Rosenbaum,0,0,0,1,49,50
1256849644,Ahead Of The Curve with Jonathan Gelnar,0,1,0,0,27,28
1256857855,Constructed Criticism,0,1,0,0,6,7
1257126028,Journey To Launch,0,0,1,2,197,200
1257202425,Tides of History,3,4,3,1,39,50
1257212726,Reid This Reid That,2,1,4,9,34,50
1257232208,Hackable?,4,3,3,8,65,83
1257234332,The Daily 202's Big Idea,16,4,12,4,14,50
1257299775,Isle Seat Podcast,1,1,1,1,95,99
1257440830,The Rambling Runner Podcast,0,0,2,1,83,86
1257569536,Mr. Bedtime Stories,4,3,4,5,34,50
1257574791,Fearless Presentations,2,0,1,0,15,18
1257613192,The Pool Guy Podcast Show,0,1,0,0,18,19
1257621596,155,2,1,0,1,31,35
1257860405,Best BBQ Show,5,0,1,0,23,29
1257913963,Cover 3 College Football,83,8,6,8,395,500
1257987923,Swallow Your Pride Podcast,1,2,3,1,43,50
1258020108,Espirational with Diana Espir,1,0,1,1,106,109
1258130540,Behind The Glass,1,0,0,1,20,22
1258273678,The Taproot,0,0,0,1,5,6
1258275406,The Vegan Fitness Podcast,0,0,0,1,49,50
1258330953,The Knicks Wall Podcast,3,2,1,1,43,50
1258365194,Cannabis Cultivation and Science Podcast,1,0,0,0,116,117
1258388821,For The Love With Jen Hatmaker Podcast,22,8,16,16,438,500
1258471951,Taringa Podcast,0,0,0,1,20,21
1258525394,Karl Morris - The Brainbooster,0,0,0,0,7,7
1258635512,The Ticket: Politics from The Atlantic,13,5,6,6,20,50
1258988092,The American History Podcast,9,2,1,2,36,50
1259053911,BLACK HANDS - A family mass murder,3,5,2,6,54,70
1259075142,The MxU Podcast,0,0,0,1,34,35
1259258251,Hip Hop Current,0,0,1,1,8,10
1259261034,Private Practice Workshop,1,0,0,2,34,37
1259394657,AIN's Tales from the Flight Deck,0,1,0,0,0,1
1259425519,You're Missing Out,0,0,0,0,4,4
1259427044,RealTuners Radio,1,0,1,1,6,9
1259438987,Armstrong & Getty On Demand,7,5,5,2,106,125
1259505930,Steal the Stars,7,9,6,10,18,50
1259520237,Bloomberg Business of Sports,4,4,3,2,11,24
1259582449,BHA Podcast & Blast with Hal Herring,2,1,3,3,79,88
1259689715,"Less Stressed Life : Upleveling Life, Health & Happiness",0,0,0,0,50,50
1259875019,Golf's Next Wave,0,0,0,0,5,5
1260073690,Conversation & Pronunciation: Learn English with The Rachel's English Podcast,1,0,0,1,43,45
1260099852,Cosmic Crit: A Starfinder Actual Play Podcast,1,0,1,1,47,50
1260118015,TLDCast Podcast,1,0,0,0,1,2
1260181429,Stay Wealthy Retirement Show,1,0,0,1,56,58
1260186482,An American Workplace | A 'The Office' Podcast,1,1,3,2,115,122
1260211382,Podcast | ice age farmer,1,0,0,0,11,12
1260262855,The Alisa Childers Podcast,14,3,0,3,233,253
1260372382,The Chlorine King Pool Service Show,0,0,0,0,6,6
1260431411,Buffalo Rumblings: for Buffalo Bills fans,3,1,3,3,226,236
1260471553,Holly Randall Unfiltered,1,2,1,1,45,50
1260504024,Shut Up & Sit Down,0,0,1,0,49,50
1260662757,The Drug Classroom,0,0,0,0,15,15
1260717243,Filmmaking Conversations Podcast with Damien Swaby,0,0,0,1,2,3
1260742293,HerbRally | Herbalism | Plant Medicine | Botany | Wildcrafting,0,0,0,0,10,10
1260800644,Life and Crimes with Andrew Rule,11,2,5,7,69,94
1260808808,Dropping Bombs,2,2,0,0,196,200
1260809937,Teen Mom Trash Talk,33,14,11,9,433,500
1260908468,The Right Reality Podcast | MTV's The Challenge,12,2,2,1,96,113
1261036909,Literaticast,0,0,0,2,37,39
1261133600,The Bad Crypto Podcast,14,7,5,3,171,200
1261213501,Golflandia,3,1,0,1,96,101
1261477215,Stitchery Stories,0,0,1,0,10,11
1261486723,Gone,5,1,3,6,82,97
1261511114,KFBK Outdoor Show,0,0,0,0,1,1
1261515078,Kids Bible Stories,5,0,3,8,217,233
1261623294,Station to Station,1,2,2,1,12,18
1262088595,DHARMA FIELD,0,0,0,0,1,1
1262100467,Curiosity Daily,3,0,4,4,39,50
1262148655,Silicon Slopes,0,0,0,0,5,5
1262213009,What's Next! with Tiffani Bova,0,0,0,0,41,41
1262231136,My Favorite Theorem,1,0,0,1,5,7
1262311599,Not Your Mom's Romance Book Club,0,0,0,0,30,30
1262351840,CRYPTO 101,7,2,3,5,99,116
1262456047,The Music Box,1,0,0,0,8,9
1262594123,Houston We Have a Podcast,2,3,3,5,72,85
1262809028,No Simple Road,0,0,1,0,108,109
1262820672,Planetary Union Network: The Orville Official Podcast,3,2,0,1,26,32
1262838966,Botanical Brouhaha Podcast,0,0,0,0,21,21
1262869310,On The Bench,0,1,0,0,13,14
1262899883,Hollywood Crime Scene,8,2,2,2,36,50
1262926738,Never Binge Again,1,1,0,1,13,16
1262965655,Another Lousy Millennium: A Futurama Fan Podcast,0,0,0,1,13,14
1263129264,CanesCast,1,0,0,2,103,106
1263259044,"Birds, Booze, and Buds Podcast",4,1,0,4,96,105
1263289980,Pick Six NFL,40,12,13,9,426,500
1263295815,Free Man Beyond the Wall,4,1,1,1,85,92
1263343396,"Keto Lifestyle with Jessica Tye, NTP",5,2,1,2,35,45
1263364594,Station 71: A Walt Disney World Podcast,2,0,2,1,28,33
1263650555,Canes Country: for Carolina Hurricanes fans,0,1,0,0,10,11
1263714410,Method Podcast from Google Design,0,0,0,0,5,5
1263783350,The Dirty Duner Show,0,0,0,1,43,44
1263842780,Leaders in Supply Chain and Logistics,0,0,1,1,4,6
1263974582,Run Eat Repeat,4,1,1,0,22,28
1263992083,HR Leaders,0,0,0,1,16,17
1264193508,Rework,0,0,2,2,29,33
1264240302,The Theatre of Tomorrow,0,0,0,0,20,20
1264366241,Fanatical Fics and Where to Find Them: A Harry Potter Fanfiction Podcast,0,1,0,0,49,50
1264424015,Criminology,44,20,26,32,378,500
1264427749,Cracked Interviews,0,0,0,0,23,23
1264449047,"Let's Talk About Myths, Baby! A Greek & Roman Mythology Podcast",13,6,8,6,167,200
1264451677,RV Miles Podcast,1,4,2,1,142,150
1264579243,Manchester Is Red,1,0,4,2,2,9
1264659520,The Courtney Sanders Podcast,1,0,3,2,91,97
1264706714,The Curious Girl Diaries,0,0,1,0,26,27
1264843400,Oprah’s SuperSoul Conversations,348,132,222,282,1986,2970
1265002699,The After On Podcast,1,2,3,3,379,388
1265161973,The Routes Aviation Podcast,0,0,0,0,1,1
1265215925,Arrowhead Pride: for Kansas City Chiefs fans,10,3,4,6,252,275
1265272527,Indie Film Grit Podcast,0,0,0,0,3,3
1265289056,Problem Solvers,0,0,0,0,11,11
1265323809,"Like Mind, Like Body",3,1,0,4,42,50
1265384284,Struggle Session,11,2,2,1,37,53
1265632650,Starting 9,28,5,13,13,286,345
1265633252,The Training For Ultra Podcast,5,4,3,1,67,80
1265697819,Make It Happen Mondays - B2B Sales Talk with John Barrows,0,2,1,0,16,19
1265826589,Gardening With Angelo,0,0,0,0,2,2
1265831764,Swish and Flick: An All Potter Podcast,17,11,13,12,147,200
1265845136,Stay Tuned with Preet,33,13,20,27,407,500
1265940397,BiOptimizers - Awesome Health Podcast,0,0,0,0,11,11
1265979257,The P.T. Entrepreneur Podcast,0,0,0,0,4,4
1266098697,Sounds Fake But Okay,0,1,1,0,29,31
1266106879,It's a Hard Knicks Life,2,1,0,1,69,73
1266115884,Always Pressing PGA DFS POD,0,0,0,1,5,6
1266305764,Miss Information: A Trivia Podcast,1,0,0,1,48,50
1266398652,The Hair Game,0,1,0,2,197,200
1266428284,Open Space Radio: Parks and Recreation Trends,0,0,0,0,3,3
1266540593,Lorehammer - A Warhammer 40k Podcast,12,0,2,1,35,50
1266577963,The Michael Knowles Show,40,12,6,4,220,282
1266711680,E3 Camping Association,0,0,0,0,2,2
1266839739,Design Better Podcast,0,3,0,2,39,44
1266868747,Sequel Rights,0,0,0,0,8,8
1267017328,RomaPress Podcast,0,1,1,0,33,35
1267097148,Hacking Your Leadership Podcast,0,0,0,2,39,41
1267110967,Torah Thinking,0,0,0,0,1,1
1267161825,Swift by Sundell,0,0,0,0,16,16
1267174750,The Kevin David Experience (Ninja PodCast),1,0,0,0,38,39
1267375227,Marsfall,5,6,2,5,32,50
1267403046,Blaze and Melfunsky Wrestling Podcast,0,0,0,0,2,2
1267540234,Moderate Rebels,8,0,2,1,34,45
1267710858,Band Room Podcast,0,0,0,0,2,2
1267804666,Charge or Die,0,0,0,0,1,1
1267896538,Fantasy Football Weekly,10,5,3,5,195,218
1267958765,The Totally Football Show with James Richardson,25,10,16,10,78,139
1267959712,G.A.S.P.™ GraphicAudio Story Podcast,0,0,0,1,17,18
1268007996,All Angels Podcast,0,0,0,0,20,20
1268047665,Rough Translation,10,2,7,5,476,500
1268052847,My Anime Podcast,0,0,0,0,37,37
1268172276,Heart Doc VIP with Dr. Joel Kahn,0,0,0,0,23,23
1268264582,Stronger U Radio with Mike Doehla,0,0,0,0,27,27
1268282458,Badass Breastfeeding Podcast,0,2,2,0,46,50
1268297079,The Money Case & The Money Growth,0,0,0,0,4,4
1268337036,The Faith & Mental Wellness Podcast with Brittney Moses,0,0,0,0,12,12
1268442696,Elements of Ayurveda,0,1,1,0,42,44
1268465332,Rev Real Estate School | Real Estate Agent Podcast,0,0,0,0,4,4
1268507895,Nursing Uncensored,0,0,1,5,11,17
1268527882,The Rewatchables,61,29,47,58,305,500
1268632042,The Addicted Mind Podcast,1,2,1,2,44,50
1268657199,The Buckeye Weekly Podcast,4,1,2,1,61,69
1268717106,The Consciousness Podcast,0,1,0,0,7,8
1268732400,Everyday Art Room,0,0,1,2,12,15
1268826768,The Next Right Thing with Emily P. Freeman,6,4,6,6,478,500
1268919812,Killer Queens: A True Crime Podcast,45,25,20,23,387,500
1268927525,Earful of Dirt - The Major League Rugby Podcast,0,1,2,0,7,10
1269106709,101 Part Time Jobs hosted by Giles Bidder,0,0,0,0,1,1
1269129234,The Allstarcharts Podcast on Technical Analysis Radio: Current Market Analysis For Traders,0,0,2,0,6,8
1269131240,Baseball Beyond Batting Average,0,0,0,1,15,16
1269163379,The Stories We'd Tell in Bars Podcast,4,3,2,2,21,32
1269232436,Unfocused Podcast,0,0,0,0,1,1
1269253764,Girl Tales,1,1,3,2,43,50
1269255343,Fantasy Footballers DFS - Fantasy Football Podcast,15,7,10,17,451,500
1269337267,The Rag Company Podcast,0,0,0,0,32,32
1269340850,The Kill Shot podcast by Johnny Battle,2,0,0,0,0,2
1269395072,Charlotte Mason Poetry,0,0,1,0,18,19
1269489189,The Thoughtful Travel Podcast,0,0,0,0,12,12
1269563925,Get It Right with Undercover Architect,0,0,0,0,9,9
1269656076,Wrestlenomics Radio,0,0,0,0,2,2
1269830487,Preferred Altitude Podcast:  Unique and Timeless Aviation Podcast,0,0,0,0,1,1
1269872857,Smart Social Podcast: Keeping students safe so they can Shine Online,0,0,0,2,48,50
1269894106,Learn Japanese w/ Manga Sensei,2,0,0,2,31,35
1269900144,The Hoop Ball Los Angeles Clippers Podcast,0,0,0,0,16,16
1270140701,Fashion Revolution Podcast,0,0,0,0,7,7
1270179063,Fake Teams,0,0,0,0,10,10
1270217870,Red Moon Roleplaying,0,1,1,2,9,13
1270288526,Your Favorite Thing with Wells & Brandi,55,11,21,11,402,500
1270311538,Hashivenu,0,0,0,0,3,3
1270453166,Pray the Word with David Platt,0,0,2,2,75,79
1270490074,Jew Oughta Know,0,0,0,1,5,6
1270570754,The Sleeping At Last Podcast,1,0,1,1,254,257
1270577225,CMDR Central,1,0,1,2,19,23
1270581396,Grassfed Life,0,0,0,0,22,22
1270681468,Dr. Matt and Dr. Mike's Medical Podcast,1,0,0,1,22,24
1270712731,Growin' Up Rock,1,0,0,0,25,26
1270813772,Alpinist,1,2,1,1,10,15
1270828261,Gun Funny,3,1,0,4,246,254
1270852096,MoreThanCultr: The PodCast,0,0,0,0,5,5
1270914458,Shoulder of Orion: The Blade Runner Podcast,2,0,0,0,16,18
1270922382,Fictional,1,0,1,3,195,200
1270942356,Charting Pediatrics,0,0,0,1,22,23
1271073009,Love and Luck,0,0,0,0,26,26
1271087930,The Playbook,1,1,0,0,198,200
1271147429,Exploring My Strange Bible,1,0,0,2,496,499
1271167671,Love to Sew Podcast,6,0,1,2,41,50
1271184502,The Strange Sessions,7,8,6,5,52,78
1271212128,Main Street Magic - A Walt Disney World Podcast,0,2,2,7,86,97
1271236770,bomBARDed - A Musical Dungeons & Dragons Adventure,0,0,0,0,50,50
1271247767,The Max Maxwell Podcast,0,0,0,0,200,200
1271249164,Two Girls One Ghost,5,1,1,3,40,50
1271261548,Small Town Dicks Podcast,64,30,21,12,373,500
1271270819,Farm Small Farm Smart,0,0,0,1,35,36
1271388065,Social Media Lab,0,0,0,0,23,23
1271472217,The Loudini Rock and Roll Circus,0,0,0,0,5,5
1271691895,FYI - For Your Innovation,0,0,0,2,16,18
1271840754,The Betchelor,210,49,36,18,187,500
1272011505,WARDROBE CRISIS with Clare Press,1,0,1,1,26,29
1272025702,The Extramilest Podcast,0,0,1,2,104,107
1272103213,Motherfocloir,0,0,1,4,22,27
1272221023,The Higher Practice Podcast for Optimal Mental Health,0,0,0,1,12,13
1272398195,HyperChange,0,0,1,0,10,11
1272398411,Fantasy Fast Track,2,1,4,2,67,76
1272423047,Honey! I'm Homeschooling The Kids,0,0,1,0,23,24
1272460524,All Things Catholic with Dr. Edward Sri,0,0,0,1,58,59
1272742064,NYYST - Yankees Podcast,4,3,1,1,81,90
1272795209,Greg & The Morning Buzz,0,1,0,0,9,10
1272803477,Boom: A Serial Drama,6,4,1,8,31,50
1272852250,Hurry Slowly,1,0,1,0,48,50
1272911285,Granger Smith Podcast,2,0,0,0,48,50
1272970334,Dirty John,0,0,0,1,22,23
1272973183,Inside The Exorcist,21,20,8,19,193,261
1272976620,Growing Up Punk,0,0,0,1,4,5
1273037507,"Let's Talk Fish -  Weekly show talking all things fishing anchored by Bryan Thrift, Matt Arey, and J...",1,1,2,2,22,28
1273079673,Zach Sang: Just The Interviews Podcast,0,0,1,1,24,26
1273238279,Ag Future: Innovation in Agri-Food,0,0,0,0,2,2
1273294635,"HIST 119: The Civil War and Reconstruction Era, 1845-1877",1,0,0,0,16,17
1273444999,Nourishing Women Podcast,0,1,1,2,46,50
1273538324,Talking Taker,0,0,0,0,7,7
1273544623,The Durenda Wilson Podcast,1,0,0,1,48,50
1273569463,Filmstudy - Baltimore Ravens Talk,1,1,2,1,49,54
1273573417,Counter Apologetics,1,1,0,1,27,30
1273575302,ABorderPrince Warhammer Lore and History,0,0,0,1,8,9
1273580812,Political Beats,0,2,4,9,35,50
1273583699,Eyes on Isles Podcast on the NY Islanders,0,1,0,2,16,19
1273606075,Growth Mindset Podcast,1,1,3,0,29,34
1273612861,Scary Mysteries,6,0,4,5,60,75
1273612905,Opera For Everyone,1,2,1,1,17,22
1273619588,The NewsWorthy,8,1,3,1,37,50
1273620817,Chair of Swords,0,0,1,0,2,3
1273625203,Best of Both Worlds Podcast,8,11,9,8,87,123
1273652102,How Good It Is,0,0,0,0,8,8
1273722751,Against The Grain Podcast,3,0,1,2,40,46
1273840231,Corporate Lunch,9,5,7,4,39,64
1274020794,Hostile Worlds: Exploring Space,0,0,0,2,21,23
1274113137,Cricket Badger Podcast,0,0,0,0,1,1
1274188453,New England Legends Podcast,0,0,0,3,103,106
1274217512,The Ken Coleman Show,18,6,2,6,126,158
1274228164,Knowing Faith,0,2,1,6,118,127
1274250823,Jews You Should Know,0,0,0,0,15,15
1274489817,One Heat Minute Productions,0,0,0,0,21,21
1274615583,The Critical Thinking Initiative,0,0,0,0,3,3
1274635046,Eagle's Eye View: Your Weekly CV Update From ACC.org,0,0,0,1,2,3
1275078406,Uncivil,2,1,0,1,46,50
1275089191,Wrestling Omakase,3,0,0,0,6,9
1275153998,The Virtual Couch,0,0,0,2,48,50
1275172907,DISGRACELAND,83,25,30,19,343,500
1275596861,Packernet Podcast: Daily Green Bay Packers Podcast,2,1,3,0,44,50
1275677375,Angel - hosted by Jason Calacanis,0,0,0,0,50,50
1275684922,The Complete Podcast,0,0,0,0,6,6
1275705867,Accelerate Your Success with Amanda Tress,0,0,0,0,6,6
1275775528,User friendly,0,1,0,0,7,8
1275907518,Splintered Caravan,0,1,0,0,17,18
1275942045,IDP Nation,0,0,0,0,17,17
1275945112,The Auburn Undercover Podcast,2,1,1,5,26,35
1275946076,SteadyTrade,0,1,2,1,46,50
1275967624,The Alina Show,0,0,0,0,21,21
1276011417,Cult Podcast,31,14,15,7,209,276
1276042346,The Evolution of Horror,0,0,0,0,71,71
1276320132,The Woodworking Morning Show (Audio),0,1,0,0,4,5
1276340470,LBJ and the Great Society,1,0,0,1,48,50
1276414335,Happy Mind: Meditations from the Ancient World to Modernity,0,0,0,1,17,18
1276416050,Beyond Clean Podcast,0,0,0,1,15,16
1276423566,Solutions to Problems,0,0,0,0,16,16
1276435746,That SEC Football Podcast,0,1,0,0,499,500
1277078956,Happy Mum Happy Baby,2,3,4,0,38,47
1277088229,The Bow Tie Chronicles – Atlanta Falcons,0,0,1,1,3,5
1277091516,Compliance Mastermind: Strategies for your healthcare compliance program and your career,0,0,0,0,10,10
1277166741,Vegas Nation - Raiders Football,6,1,0,2,7,16
1277226274,Going Deep,60,8,12,8,139,227
1277424411,"Ladies, We Need To Talk",0,0,1,0,15,16
1277873664,First Things First,57,19,28,32,133,269
1277969212,Barstool Pick Em,13,2,11,2,94,122
1278047404,Spark Joy,0,0,0,2,48,50
1278187891,Andrew Talks to Chefs,2,1,0,3,77,83
1278260011,Art Side of Life,0,0,0,0,19,19
1278341165,Triathlon Taren Podcast,2,1,2,3,158,166
1278345733,Tumanbay,3,2,2,2,41,50
1278405987,Feed The Ball,0,0,0,0,30,30
1278457181,Change Lab: Conversations on Transformation and Creativity,0,0,0,0,17,17
1278501610,Bengals Booth Podcast,1,0,1,0,27,29
1278663589,LOVELINK,1,0,0,2,38,41
1278676027,Larkspur Underground,0,0,1,3,22,26
1278684468,shunned,0,1,0,2,42,45
1278687237,Through the Wire,5,4,4,6,480,499
1278694210,Dyking Out - a Lesbian and LGBTQIA Podcast for Everyone!,2,0,0,0,48,50
1278767162,The Gut Loving Podcast: All about IBS & the low FODMAP diet,1,2,0,3,10,16
1278783469,The Narcissist in Your Life Podcast,0,1,0,0,27,28
1278785366,Tesla: The Life and Times Podcast,1,1,1,3,33,39
1278815517,Ologies with Alie Ward,6,2,3,5,484,500
1278958831,crunch,0,0,0,1,3,4
1278993781,Girls Night with Stephanie May Wilson,0,0,3,5,492,500
1279015480,Strange Indeed a Fancast for The Stand,5,2,3,5,35,50
1279125838,Dark Side Of Psychology,1,0,1,0,1,3
1279138774,Magickando,0,0,0,0,1,1
1279361017,Snap Judgment Presents: Spooked,7,10,24,26,133,200
1279366432,I Only Listen to the Mountain Goats,0,2,4,2,42,50
1279384082,What's The Frequency?,2,1,3,2,26,34
1279389859,Dr. Bond’s Life Changing Wellness,0,0,0,0,15,15
1279389864,It Makes A Sound,4,2,3,3,38,50
1279398284,"RealiTV Recaps Married at First Sight, 90 Day Fiance & Sister Wives",21,4,7,4,273,309
1279409241,Half Hour of Heterodoxy,3,0,0,1,11,15
1279414575,The Learning Scientists Podcast,0,0,0,0,11,11
1279516571,Lights Camera Barstool,14,5,5,2,467,493
1279562874,Everything Iconic with Danny Pellegrino,13,2,8,9,468,500
1279595968,Every Horror Movie On Netflix,0,2,0,2,20,24
1279717987,Couch Wisdom,0,0,1,1,9,11
1279724711,Three Guys Before The Game,1,1,1,1,68,72
1279731673,Dark Histories,2,1,1,4,42,50
1279955329,Scrubbing In with Becca Tilley & Tanya Rad,86,23,23,11,357,500
1279981104,"Horns247 Podcasts: Longhorn Blitz, The Flagship, and State of Recruiting",2,2,2,4,113,123
1280094011,TDN Fantasy,0,2,0,0,17,19
1280117161,WNBA Nation,1,0,1,1,29,32
1280162641,Greatest Show on Dirt,0,0,0,0,24,24
1280221048,The Hockey Podcast Network,0,0,1,0,3,4
1280468643,The Filmmakers Podcast,0,0,0,0,17,17
1280469178,The Week in Art,0,0,1,1,6,8
1280497332,Planet FPL - The Fantasy Football Podcast,0,0,0,0,8,8
1280556958,Merely a Setback: A Podcast about Storytelling in the World of Warcraft,8,4,1,2,54,69
1280796141,Paranormal Almanac,6,1,0,2,38,47
1280957415,The Totally Football League Show,2,0,0,0,11,13
1280961263,Pat Gray Unleashed,4,1,3,1,41,50
1281080662,Dog Works Radio,0,0,1,1,21,23
1281089527,The Great Books,9,0,5,5,100,119
1281119166,Guided Meditations by One Mind Therapy,0,0,1,0,1,2
1281261434,Canucks Central,1,0,0,0,0,1
1281270865,The Humble Mechanic,1,1,2,0,11,15
1281285953,Chasing Scratch: A Golf Podcast,0,0,2,4,197,203
1281287693,Girl In Space,1,2,0,2,45,50
1281312822,Words On Water,0,0,0,1,3,4
1281369972,Spoken Garden Podcast,0,0,0,0,1,1
1281383089,The Cryptid Cases,0,0,3,0,13,16
1281543429,The American War,10,7,6,7,20,50
1281645489,AsianBossGirl,1,3,3,3,139,149
1281666719,Mindfulness+ with Thomas McConkie,0,1,0,0,76,77
1281676586,Birds With Friends: A show about the Philadelphia Eagles,17,12,9,7,455,500
1281701749,Hey YA,0,4,3,2,11,20
1281735525,Corruption Crime & Compliance,0,0,0,0,3,3
1281767970,Short Story,8,0,0,0,0,8
1281790712,Calm Parenting Podcast,1,0,1,0,24,26
1281824139,Redefining Wealth with Patrice Washington,0,0,0,3,306,309
1281824751,Grief and Rebirth: Finding the Joy in Life Podcast,0,0,0,1,9,10
1281853816,The Couples Therapist Couch,1,0,0,1,42,44
1282002114,"Rebel Traders™ Podcast - Stock Market Trading Strategies, Insights & Analysis with Sean Donahoe & Ph...",1,0,1,1,32,35
1282044290,Mark Groves Podcast,3,2,4,5,486,500
1282093659,"Building HVAC Science -Comfort, health & energy efficiency",0,1,0,0,6,7
1282100393,Power Problems,0,0,1,0,9,10
1282106249,WagerTalk,7,3,4,9,12,35
1282116646,Boom! Lawyered,1,0,1,0,48,50
1282158773,The Migraine Miracle Moment,2,1,0,0,19,22
1282188788,Speaking Brazilian Podcast,0,0,0,0,5,5
1282433611,The Annex Sociology Podcast,0,1,0,1,4,6
1282440200,Inside INdiana Business,0,0,0,0,1,1
1282619020,Space Cats Peace Turtles,0,0,0,1,49,50
1282637717,The Silicon Valley Insider Show with Keith Koo,0,0,0,0,12,12
1282660404,Trauma-Informed Lens,3,0,0,1,3,7
1282786304,Neon Brainiacs (80s Horror Podcast),0,0,1,0,34,35
1282838969,The Long Run with Luke Timmerman,1,0,3,1,10,15
1283057166,Listen Out Loud with The Loud House,5,0,3,1,41,50
1283211411,Autzen Audibles: DuckTerritory's Oregon athletics podcast,1,1,3,2,37,44
1283511798,THE HISTORY OF FOOD,3,1,1,0,22,27
1283599727,ReMade,1,3,0,7,2,13
1283651682,Ghostpuncher Corps,0,1,1,0,13,15
1283653370,The Jim Jefferies Show Podcast,39,4,2,0,5,50
1284562064,The Embodiment Podcast,4,0,1,2,21,28
1285390773,Motivation Minute,0,0,0,1,18,19
1285444706,2 Girls 1 Podcast,0,1,3,1,22,27
1285537944,Techtonic with Mark Hurst | WFMU,0,0,0,0,3,3
1285608909,Big Data Beard,0,0,0,0,8,8
1285788731,Future Cities,0,0,0,0,2,2
1286343419,Together Live Presents: Do it on Purpose,0,0,0,0,16,16
1286350614,Level Design Lobby,0,0,0,0,6,6
1286376614,BoxTrick: A Retro Gaming Podcast,1,1,1,1,16,20
1286391157,Mommin' Ain't Easy the Podcast,1,0,1,0,36,38
1286485146,"Sex, Birth & Trauma with Kimberly Ann Johnson",2,0,2,1,31,36
1286546938,Mercury: A Broadcast of Hope,0,0,1,0,15,16
1286571114,Professor Slots,1,0,0,1,6,8
1286689775,The Cross Stitch Podcast,0,0,0,1,17,18
1286770630,The Dave Ryan Show,5,2,4,1,21,33
1286818575,Cults,69,54,63,63,195,444
1286870871,Dr. Joseph Mercola - Take Control of Your Health,3,4,1,1,31,40
1286870904,Legal Speak,0,0,1,0,4,5
1286906615,Intelligence Matters,32,13,17,8,201,271
1286933381,Better in Bed | A Sex & Sexuality Podcast,0,0,1,0,3,4
1286962819,Inside Selling,0,0,0,1,17,18
1287081706,Reasons to be Cheerful with Ed Miliband and Geoff Lloyd,5,1,5,7,121,139
1287117198,Technado with Don Pezet (Audio),0,0,0,0,11,11
1287125533,The Wild Life,0,1,0,0,12,13
1287185296,Other Men Need Help,0,0,0,2,69,71
1287202221,HACKED: Into the minds of Cybersecurity leaders,0,0,0,1,6,7
1287225837,Entrepreneur Stories 4⃣ Inspiration,1,0,0,1,98,100
1287267219,What Have You,2,1,2,0,88,93
1287269357,This Naked Mind Podcast,0,1,5,5,39,50
1287369343,Wahaj Tarin,0,0,0,0,2,2
1287748328,American Suburb,4,0,1,1,21,27
1287751932,"Help! I Suck at Dating with Dean, Jared & ....",113,57,45,53,232,500
1288069795,Palimpsest,2,2,3,4,39,50
1288308609,Project Upland Podcast,3,1,1,2,228,235
1288323368,The Greatest Discovery: New Star Trek Reviewed,4,0,3,2,228,237
1288412022,Sum of All Parts,0,0,1,1,15,17
1288418637,How Success Happens,0,0,1,0,62,63
1288654389,Ad Age Ad Lib,0,1,1,1,6,9
1288782723,RealTalk MS,1,1,0,0,23,25
1288819011,51 First Dates,2,2,3,6,174,187
1289012156,Enlightenment Radio,0,0,0,0,3,3
1289041154,"The ""Daily Call"" From Option Alpha",0,0,0,0,48,48
1289047409,Periodic effects Cannabis Business & Science,0,0,0,0,30,30
1289048825,Clients on Demand,1,0,4,3,42,50
1289057826,RotoViz Overtime,0,0,0,3,29,32
1289057827,College Football Fantasy Pod,1,0,0,0,1,2
1289058019,Dynasty Tradecast,1,0,1,1,18,21
1289058031,RotoViz Fantasy Football Show,0,0,1,0,4,5
1289060513,Around the World in 80s Movies,0,0,0,0,8,8
1289062927,ChinaTalk,3,0,5,1,16,25
1289070669,Court-Side with Beilinson Tennis,0,0,0,0,4,4
1289089021,Veggie Doctor Radio,0,0,0,1,33,34
1289105668,Roll For Combat: Paizo's Official Pathfinder & Starfinder Actual Play Podcasts,2,1,2,0,45,50
1289105780,Deadly Manners,8,7,2,2,31,50
1289289851,Living Proof with Beth Moore,2,4,1,6,46,59
1289384685,The Daily Zeitgeist,34,16,18,12,420,500
1289446956,Benevolent Dictator with Jordan Raybould,1,0,0,0,49,50
1289545645,Quest Friends!,0,0,0,0,18,18
1289739388,The Art of ...,0,0,0,0,1,1
1289897902,Runners On Trail,0,0,0,0,1,1
1290245147,Talking About Cars with Randy Kerdoon,0,0,0,0,6,6
1290280716,Experience This!,0,0,0,0,18,18
1290393786,The Speaking Club: Mastering the Art of Public Speaking,0,0,0,0,12,12
1290400188,The Modern Retail Podcast,0,0,0,0,7,7
1290455782,PFT PM,13,2,4,3,100,122
1290486596,Locatora Radio [A Radiophonic Novela],1,0,1,0,122,124
1290551803,DLWeekly Podcast - Disneyland News and Information,4,4,4,5,76,93
1290605993,The Perfectionism Project,3,0,0,3,24,30
1290618412,Great Shot Podcast,0,1,0,0,22,23
1290655065,"Reality NSFW with Jonny Fairplay: Survivor, Big Brother, The Amazing Race, The Challenge",10,6,4,3,49,72
1290847550,Force Material: A Star Wars Podcast,0,1,0,0,11,12
1290937161,The Sarah Prout Podcast,0,0,1,1,48,50
1290968293,The One Who Got Away,0,0,1,0,6,7
1290971833,Heat Rocks,0,0,1,0,49,50
1291003393,Financial Residency with Ryan Inman,1,0,0,0,42,43
1291017961,Enlightened Empaths,3,5,1,3,95,107
1291058235,Hit Parade | Music History and Music Trivia,16,2,3,2,27,50
1291078410,Bisexual Real Talk,3,0,0,1,4,8
1291110514,Bacon and Eggs: A Movie Lover's Podcast,1,0,4,2,99,106
1291144720,The Remnant with Jonah Goldberg,5,0,3,0,42,50
1291423644,The Diary Of A CEO by Steven Bartlett,1,1,1,1,355,359
1291429350,The Science of Sex,0,0,2,2,22,26
1291541349,Sundial,0,1,0,0,1,2
1291579828,History That Doesn't Suck,2,0,4,3,41,50
1291591394,"Clean Eating for Women with Carrie Forrest, MPH in Nutrition",0,0,0,2,38,40
1291613912,Success is a Choice,0,0,0,0,16,16
1291631666,UMSO,1,0,2,0,47,50
1291645304,The Lucky Die,0,0,1,1,48,50
1291684547,CharlaGolf podcast,0,0,0,0,1,1
1291726367,The Death of Dr. John Parker,14,8,4,1,23,50
1291758449,Boys In The Cave,0,0,0,0,5,5
1291778248,The Garden Log,0,0,0,0,9,9
1291807221,The Phenomenon,1,1,3,4,41,50
1292006878,Chasing the Horizon - Motorcycles and the Motorcycle Industry In Depth,0,0,0,0,8,8
1292020504,Pinna Originals Playlist,11,4,4,2,11,32
1292066715,Strong Mind Sports with Clint McGill,0,0,0,0,9,9
1292069401,Heaven's Gate,2,3,4,6,35,50
1292084760,The Fierce Marriage Podcast,2,6,10,18,464,500
1292089107,The Funk'tional Nutrition Podcast,1,0,1,2,46,50
1292298048,"Austin Anthem Podcast: Austin FC, Soccer, and Supporters Group News, Interviews, & Updates",1,0,0,0,14,15
1292338852,When to Jump,1,1,0,1,30,33
1292346467,Explain Me,0,0,1,0,6,7
1292353638,Dementia Matters,1,0,0,0,2,3
1292363943,Fistaz Mixwell,0,0,0,2,8,10
1292365156,The Raw Dog Food Truth,1,3,2,1,10,17
1292370916,Wretched Radio,7,2,3,5,250,267
1292412065,The Racing Writer's Podcast,2,0,1,0,28,31
1292475588,Birth Kweens,3,1,3,1,42,50
1292603914,The Full 60 with Craig Custance,1,0,0,1,186,188
1292638162,Millennials Are Killing Capitalism,2,0,0,1,8,11
1292665011,Crooked Minis,11,7,4,7,235,264
1292714064,Modernist BreadCrumbs,0,1,0,0,6,7
1292749928,Speak the Language,1,0,0,4,258,263
1292753999,Talk About the Passion,0,0,0,0,8,8
1292780693,Hotline League,0,0,1,1,11,13
1292808742,Child Care Rockstar Radio,0,0,0,0,39,39
1292819540,WSJ Secrets of Wealthy Women,4,7,2,5,62,80
1292834258,Superduperstitious,0,0,0,0,35,35
1292950516,The Enneagram Journey,1,0,7,1,201,210
1293184351,Victoriocity,0,0,1,2,47,50
1293270353,The School of Morton Podcast with Ricky Morton and Scotty Campbell,3,1,0,3,16,23
1293313890,Let It Roll,0,0,0,0,8,8
1293347824,Voir Dire: Conversations from the Criminal Justice Policy Program at Harvard Law School,0,0,0,1,9,10
1293420681,Tax Notes Talk,0,0,1,0,0,1
1293534096,Unplaced | an audio drama,1,0,2,5,26,34
1293860614,Haunted Places,33,31,39,25,372,500
1293896506,StarDate Podcast,2,0,1,1,8,12
1293899173,Collective Insights,0,0,9,11,136,156
1294058924,Thankful Homemaker: A Christian Homemaking Podcast,0,1,1,2,140,144
1294059882,The Buzz About Bees,0,0,0,1,4,5
1294068639,2298,1,0,1,4,37,43
1294108032,Brilliant Balance,0,0,0,0,90,90
1294115422,Siim Land Podcast,0,0,1,0,32,33
1294131221,Off-Nominal,0,0,0,0,3,3
1294325824,The Impact,9,9,0,6,232,256
1294379929,The Florida Roundup,0,1,0,0,1,2
1294403698,Mediums in Action,0,0,0,0,7,7
1294461271,GZero World with Ian Bremmer,4,0,0,0,8,12
1294505998,The How-To Heretic,3,2,1,2,156,164
1294529089,The Great Song Podcast,0,1,0,1,20,22
1294529191,GraveYard Tales,2,4,6,9,479,500
1294702451,Heaving Bosoms: A Romance Novel Podcast,1,0,1,1,197,200
1294731030,Pretend Friends - Tabletop RPG Adventures,0,0,2,0,48,50
1294811374,2 girls talking about sex,0,0,3,1,4,8
1294853719,Jesus is Better: Bible Stories with Gospel Joy,0,0,2,1,22,25
1294885433,Lead to Win,4,1,5,6,184,200
1294938797,The  Period  Party,0,1,0,0,21,22
1294949607,Supreme Court Audio Podcast,0,0,0,0,2,2
1295275185,POLITICO Money,2,6,3,5,16,32
1295289140,Astral Codex Ten Podcast,0,0,0,0,11,11
1295458667,Marriage Therapy Radio,4,0,6,1,39,50
1295718287,Mindful In Minutes,1,0,0,0,49,50
1295773682,The 1-3-20 Podcast,0,1,0,2,13,16
1295933261,The Big Ones,0,0,0,0,50,50
1296022564,Hack or Slash - A Horror Movie Review Podcast,1,0,2,0,19,22
1296074241,Another Kingdom,3,0,4,1,42,50
1296155915,CLAIMED — Feminine/Masculine Polarity. Femininity. Embodiment.,2,1,1,0,105,109
1296350485,Darknet Diaries,6,0,0,0,216,222
1296396379,FReality - VR Podcast,0,0,0,2,10,12
1296411814,Light Years: A Golden State Warriors Pod,11,2,3,1,67,84
1296508174,The Aloha 360,0,0,0,0,23,23
1296570107,Flightsim Community Podcast,0,0,1,0,3,4
1296575067,Hagerty Sidedrafts: Cars | Classics | Racing,1,0,0,0,4,5
1296592213,Gang Green Nation: for New York Jets fans,0,0,0,0,11,11
1296610610,Make Money as a Life Coach,0,0,0,0,50,50
1296621306,The Art of Film Funding,0,0,0,0,1,1
1296627876,3 in 30 Takeaways for Moms,0,1,0,0,49,50
1296636702,Podcast: The Ride,1,0,0,0,49,50
1296639476,"Seven: Disturbing Chronicle Stories of Scary, Paranormal & Horror Tales",65,46,33,23,245,412
1296672480,My Favourite Elliott Smith Song,0,0,0,0,8,8
1296676213,Sean of the South,0,0,0,0,36,36
1296679572,The Sopranos Show,1,1,0,3,78,83
1296680421,The Night Owl Podcast,1,0,1,2,164,168
1296680768,Restaurant Fiction,0,0,0,0,11,11
1296708933,Behind the Racquet Pod,1,0,2,1,17,21
1296708934,Dungeons and Demogorgons - A Stranger Things Podcast,6,1,4,1,96,108
1296736740,Your Own Magic,6,3,5,1,422,437
1296866918,The New Yorker Comment,0,0,0,1,5,6
1296938673,Lez Hang Out | A Lesbian Podcast,0,0,2,2,49,53
1297027145,#YourTorah,0,0,0,0,1,1
1297042038,The Broadswords,0,0,0,2,48,50
1297101235,The Grow Guide,1,0,1,0,6,8
1297133414,Dying Alive,1,2,0,1,7,11
1297180610,Slow Radio,9,1,1,2,6,19
1297225403,The Unexplored Places,0,1,1,0,27,29
1297355695,Book Marketing Show Podcast with Dave Chesson,0,0,0,0,35,35
1297423020,"Hey, Beautiful! A How I Met Your Mother Podcast",0,0,1,1,60,62
1297439270,I Don't Have Enough FAITH to Be an ATHEIST,13,5,1,3,446,468
1297791208,Core IM | Internal Medicine Podcast,0,1,1,2,46,50
1297825851,The World Nomads Travel Podcast,0,0,0,0,5,5
1298055025,A Killing On the Cape,26,16,28,24,120,214
1298070041,Valuetainment Episodes,5,1,3,3,113,125
1298103854,Brooklyn Buzz: A Brooklyn Nets Podcast,0,0,1,2,14,17
1298314174,Southern Mysteries Podcast,0,0,2,0,48,50
1298330359,The Ethics Podcast - With Rabbi Yaakov Wolbe,0,0,0,0,2,2
1298413099,Pitch List,2,0,3,1,22,28
1298547341,Raising a Powerful Girl,0,0,0,0,13,13
1298703768,The Angry Therapist Podcast,1,5,2,2,40,50
1299131209,Projectified,0,0,1,1,6,8
1299287572,XO Marriage Podcast,0,1,0,0,28,29
1299380344,Dragon Ball Super Dope,1,0,1,0,16,18
1299443864,Marketing Your Business - Marketing Strategies for Business Owners,0,0,0,1,49,50
1299483397,Taco the Town,0,0,0,0,8,8
1299580753,"Fascinating Gadgets, Gizmos, and Gear Based Technologies",0,0,0,0,2,2
1299826850,Ridiculous History,9,5,8,7,21,50
1299863834,Why Theory,2,0,0,2,36,40
1299915173,This Podcast Will Kill You,42,21,17,12,408,500
1299976859,Memory in Top 40 Music,0,0,0,0,8,8
1300031596,Energy Week,2,0,0,0,5,7
1300374274,The Witch Wave,1,0,0,1,143,145
1300382225,The Paris Review,1,0,1,1,74,77
1300435924,Negotiations Ninja Podcast,1,0,0,2,29,32
1300454244,Clean Break with Matt Gondek,0,0,1,1,22,24
1300752150,Dude Grows Show Cannabis Podcast,2,0,1,1,8,12
1300757042,We Met At Acme,34,14,12,17,379,456
1300947212,This is My Bourbon Podcast,2,0,2,0,36,40
1301069333,Shojo & Tell: A Manga Podcast,1,0,0,0,7,8
1301132213,Casual Cinecast: Blockbuster Movies to Criterion & Classic Film,2,0,0,0,46,48
1301616136,I Guess That's Why They Call It The Elton John Podcast,0,0,1,1,8,10
1301796230,Lonesome Pine Podcast,9,5,6,4,18,42
1301814786,ABA Banking Journal Podcast,0,0,0,0,2,2
1302281912,"What Next: TBD | Tech, power, and the future",6,4,5,5,28,48
1302295524,The Big Loop,2,1,3,2,42,50
1302311533,Watch What Happens Live with Andy Cohen,19,2,4,5,93,123
1302798536,The Authentic German Learning Podcast: Deutsch lernen wie ein Baby | Learn German online | Personal ...,0,0,0,0,10,10
1302914946,Everything Trying to Kill You,0,0,0,0,25,25
1303288133,The Ultra Stories Podcast,3,1,2,0,10,16
1303300874,Pimped: Ob/Gyn,0,0,0,0,14,14
1303318652,Down The Garden Path Podcast,0,0,1,0,0,1
1303578261,Pop Culture Man Children,0,0,0,0,3,3
1303617644,3.55,0,0,0,0,2,2
1303627740,Andy Rasool - Talking Supercars With SupercarTribe.com,0,0,0,0,3,3
1303660358,The FOX News Rundown,28,3,4,5,10,50
1303668524,The Tiny Meat Gang Podcast,4,1,0,0,45,50
1303870112,Behavioral Grooves Podcast,0,1,0,2,24,27
1303951242,20 Minute Fitness,1,3,3,4,39,50
1304030110,SANDCAST: Beach Volleyball with Tri Bourne and Travis Mewhirter,0,0,1,1,16,18
1304192102,Cocaine & Rhinestones: The History of Country Music,2,0,1,0,47,50
1304225814,Wine & Spirits with Monica the Medium,1,0,2,4,493,500
1304361213,General Intellect Unit,0,0,0,0,8,8
1304449021,Theory of Content,1,1,0,1,25,28
1304455384,Movie Crush,24,22,14,32,208,300
1304457657,Things I Learned Last Night,1,0,0,0,49,50
1304476231,Froning and Friends,5,5,6,7,109,132
1304525940,60 Mindful Minutes,0,0,0,0,12,12
1304740533,Class Bravo,0,0,0,0,3,3
1304781389,Dark Poutine - True Crime and Dark History,22,11,11,11,340,395
1304874265,Inside Running Podcast,0,0,0,0,4,4
1305228910,Table Manners with Jessie Ware,32,30,54,41,343,500
1305291387,Attachment Theory in Action with Karen Doyle Buckwalter,0,1,0,1,13,15
1305309644,Immune,3,0,0,0,18,21
1305381419,Classical Stuff You Should Know,2,2,1,1,44,50
1305546061,Coffee Convos Podcast with Kail Lowry & Lindsie Chrisley,64,16,30,42,494,646
1305631801,Weekly Motivation by Ben Lionel Scott,0,0,0,1,12,13
1305652820,Britney's Gram,14,2,6,2,70,94
1306461859,Cameron Chronicles,0,0,0,0,3,3
1306616741,The Beatles Naked,0,1,0,3,23,27
1306625292,"The Fairer Cents: Women, Money and the Fight to Get Equal",3,1,0,4,87,95
1306697084,Evolve with Pete Evans,2,1,0,0,11,14
1306811815,Motion Hatch: Helping Motion Designers Do Better Business,0,0,0,3,23,26
1306904582,Tracks,0,0,1,1,8,10
1307053842,For The Many,12,5,7,13,61,98
1307059191,Kifarucast,4,1,4,12,479,500
1307152020,First Team Podcast,0,0,1,0,0,1
1307153574,Feminist Frequency Radio,20,1,0,3,46,70
1307252136,The Holistic Herbalism Podcast,0,0,0,0,50,50
1307296053,Better Faster Podcast,0,1,0,2,44,47
1307353864,The Selby Is Godcast: A Cleveland Indians podcast,0,1,2,0,79,82
1307457770,Buddhist Chanting,0,0,0,1,0,1
1307570207,The Casual Birder Podcast,1,0,0,0,22,23
1307838447,The Option Genius Podcast: Options Trading For Income and Growth,9,0,1,0,25,35
1307921241,Me And My Golf Podcast,0,1,1,3,17,22
1308062825,Tudors Dynasty Podcast,2,1,3,2,42,50
1308141699,The Founder Hour,0,0,0,0,18,18
1308222298,Middle:Below,1,0,1,0,17,19
1308460981,GEAR:30,1,0,0,2,63,66
1308482259,Our Pets Health: with Dr Alex,0,0,0,0,2,2
1308612589,SouthBound,0,0,0,1,25,26
1308641246,Photo Geek Weekly,1,0,0,1,13,15
1308692838,Switchblade Sisters,1,0,1,0,124,126
1308717668,Swindled,113,46,38,21,282,500
1309256060,Teaching with Madly Learning®,0,0,0,0,1,1
1309278375,The Ice Garden,1,0,0,1,4,6
1309285684,The Empowering Neurologist Podcast,1,0,0,1,2,4
1309354521,Majority 54,2,2,1,3,42,50
1309361042,The Art of World Building: Creating Breakout Fantasy and Science Fiction Worlds In Stories and Gamin...,0,0,0,1,5,6
1309369783,Backpacking & Blisters,2,0,0,5,62,69
1309483683,The Unexpectables,0,2,2,2,44,50
1309723167,NOAA Ocean Podcast,0,0,0,0,6,6
1309888040,Lawful Stupid: A DnD 5e Actual Play Podcast,0,0,1,1,48,50
1309939090,Grappling Rewind: Breakdowns of Professional BJJ and Grappling Events,0,0,0,0,3,3
1309939843,Billy Yang Podcast,0,0,0,1,108,109
1310165230,Outliers - Stories from the edge of history,0,0,0,0,14,14
1310192007,Animal Spirits Podcast,3,3,5,5,184,200
1310261707,Residence of Evil Podcast,0,0,0,0,3,3
1310770477,The Modern Therapist's Survival Guide with Curt Widhalm and Katie Vernoy,0,0,0,1,30,31
1310884160,PA Power Podcast: College Edition,0,0,0,0,1,1
1310941905,Dads Drinking Bourbon,1,1,0,1,147,150
1311004083,"Broken Record with Rick Rubin, Malcolm Gladwell, Bruce Headlam and Justin Richmond",27,20,16,22,153,238
1311040782,All Creatures Podcast,1,1,1,2,91,96
1311062310,Group Chat,0,1,1,1,47,50
1311275904,The Weekly Typographic,0,0,0,0,1,1
1311847871,NATURE on PBS,0,0,0,0,3,3
1311856064,The Chad Prather Show,1,0,0,0,49,50
1311872824,The Confident Single Woman,2,1,1,2,80,86
1312460765,Cloud Accounting Podcast,0,0,1,0,49,50
1312707548,"Broken, Alaska",0,0,0,0,4,4
1312801401,The Outer Limits Podcast,0,0,0,1,19,20
1312875502,Story,1,0,1,2,11,15
1312957138,The Exam Room by the Physicians Committee,1,1,0,2,46,50
1312969389,Sail On: The Beach Boys Podcast,0,0,0,0,50,50
1313000372,The Insurance Guys Podcast,1,0,0,0,40,41
1313004515,The AIAS Game Maker's Notebook,0,0,0,0,7,7
1313060210,Raising Your Paws- Your resource for dog & cat pet parents,0,0,0,0,23,23
1313077481,Toure Show,2,0,1,3,83,89
1313152833,Millionaires Unveiled,4,1,2,0,84,91
1313421754,Straight from the Stands : An Unapologetic LA Galaxy Podcast,0,1,0,0,3,4
1313469284,The SG Tour Report from Secret Golf,0,0,0,0,3,3
1313479611,Personality Junkie Podcast,3,3,0,0,2,8
1313512668,Fox Sports Radio Weekends,1,0,1,0,20,22
1313519159,Bloom and Grow Radio,1,2,1,2,44,50
1313564465,The College Investor Audio Show,0,1,1,0,2,4
1313596069,American History Tellers,5,2,2,2,39,50
1313611947,The Daily Signal Podcast,7,1,2,2,38,50
1313647764,Sunday Night's Main Event,1,1,2,0,8,12
1313660749,The freeCodeCamp Podcast,0,1,0,1,47,49
1313678234,IYAGI - Natural Korean Conversations For Learners,0,0,0,0,3,3
1313792383,FreshNP's podcast,1,0,0,2,1,4
1313948227,Norma Kamali Life,0,0,0,1,22,23
1313996383,U Up?,6,2,3,3,36,50
1314073750,Speak English with Tiffani Podcast,0,0,0,0,3,3
1314136455,Around The Block,2,0,0,0,1,3
1314138109,Learn English with EnglishTVLive,0,0,0,0,3,3
1314139416,The Biology of Superheroes Podcast,0,0,0,3,23,26
1314170606,All In with Chris Hayes,21,7,10,19,141,198
1314172351,The ReidOut with Joy Reid,47,13,21,37,123,241
1314224547,Mastering Diabetes Audio Experience,0,0,3,2,45,50
1314513244,The Kink Academy Podcast,0,0,0,0,1,1
1314667752,The Amelia Project,4,0,2,4,40,50
1314750545,The California Report Magazine,0,0,1,0,6,7
1314759544,Why Won't You Date Me? with Nicole Byer,13,4,6,10,467,500
1315040130,Slow Burn,10,4,2,1,33,50
1315130618,The Marketing Secrets Show,2,1,0,0,45,48
1315152652,Weekly Energy Boost,0,0,0,0,34,34
1315327179,Scale Model Podcast,0,0,1,2,3,6
1315335688,Listing Agent Lifestyle - Real Estate Marketing,1,0,0,0,6,7
1315352438,ElkShape,3,1,1,0,45,50
1315449534,Wild Flower (Half) Hour,0,0,0,1,0,1
1315531685,We Watched A Thing,2,0,0,1,60,63
1315652782,You Must Remember Manson,4,3,5,6,32,50
1315718369,Deviate with Rolf Potts,0,0,0,0,20,20
1315817340,Solid Joys Daily Devotional,0,0,1,1,53,55
1315888074,The Final Word Cricket Podcast,0,0,0,0,5,5
1316084734,The Last Word with Lawrence O’Donnell,18,4,6,10,120,158
1316200737,The Bob Lefsetz Podcast,6,3,3,1,29,42
1316294579,Woman Evolve with Sarah Jakes Roberts,0,0,0,1,7,8
1316743025,Living Skin by Dermalogica,0,0,0,0,10,10
1316769266,Village Global's Venture Stories,1,2,3,1,8,15
1316781477,My First Time,0,2,0,1,3,6
1316809169,So Very Wrong About Games,5,4,4,2,16,31
1316933734,The Franciska Show,0,0,0,0,28,28
1316938642,The Doctor's Kitchen Podcast,2,2,3,3,81,91
1317098904,First Ring Daily,0,0,0,0,2,2
1317356120,What Bitcoin Did,4,0,2,2,192,200
1317416071,Kowabana: 'True' Japanese scary stories from around the internet,1,1,1,0,57,60
1317426645,The Wheelhouse with Jerry Dipoto,0,0,1,2,12,15
1317478907,Medicine Stories,0,0,2,2,200,204
1317493077,Duolingo Spanish Podcast,65,25,45,60,525,720
1317575455,A Message to Lightworkers,0,0,0,0,2,2
1317603155,Bravo Happy Hour,38,13,17,9,120,197
1317613282,The Orisha Wisdom Podcast,1,0,0,0,12,13
1317678570,Guerrilla Social Work Podcast,1,1,0,1,16,19
1317823455,The Mindvalley Podcast with Vishen Lakhiani,4,0,0,2,24,30
1317853625,The Mismatch,29,5,11,13,359,417
1317906223,New Player Has Joined,13,4,10,3,222,252
1317929691,MURDERISH,52,38,28,26,196,340
1318073346,Animals To The Max Podcast,0,0,0,0,35,35
1318111081,Tailosive Tech,5,4,3,11,101,124
1318113264,Two Dykes and a Mic Podcast,2,0,0,1,41,44
1318276878,Trillions,2,1,1,1,12,17
1318335827,Omnibus,17,1,0,1,31,50
1318397377,This Podcast Has Fleas,6,3,2,8,31,50
1318406349,Law To Fact,1,0,0,1,14,16
1318445077,Waist Away: The Intermittent Fasting & Weight Loss Podcast,2,2,0,0,46,50
1318465262,The Boo Crew,2,2,1,1,97,103
1318485592,Mind Love ♡ Modern Mindfulness,0,0,0,0,50,50
1318549651,Pink Shade,26,10,12,9,349,406
1318849297,Dave and Dujanovic,1,1,1,0,5,8
1318896337,"Dating, Relationships, and Love (DRL)",0,0,0,1,31,32
1319033389,Garage Gym Athlete,0,0,0,0,50,50
1319123753,The Drone Trainer Podcast,0,0,0,0,17,17
1319179843,The Fortnite Podcast,2,1,0,2,45,50
1319228135,The Intuitive Customer - Improve Your Customer Experience To Gain Growth,0,1,0,0,7,8
1319419913,Hairbrained Conversations,0,1,0,0,16,17
1319433512,The Secret Podcast,0,0,0,1,5,6
1319484661,"Real Talk with Dana | body image, non-diet nutrition and health at every size",2,0,0,0,48,50
1319947289,Command Line Heroes,1,1,5,3,38,48
1320055779,Electrek,9,8,5,1,22,45
1320060107,Better Together with Maria Menounos,1,0,1,0,48,50
1320118593,The Indicator from Planet Money,80,38,74,54,488,734
1320152764,Off the Woodwork,0,2,0,1,8,11
1320169810,Peds Soup: A Pediatrics Podcast,0,0,0,0,7,7
1320173349,Cryptic Chronicles,1,0,0,0,5,6
1320175247,Duggan Hill,1,0,2,2,23,28
1320217739,Celtic Myths and Legends Podcast,0,0,0,1,45,46
1320495341,Love People Use Things,0,0,1,0,21,22
1320620176,Ham Radio Workbench Podcast,0,0,0,1,13,14
1320638747,What'sHerName,2,0,1,1,46,50
1320667234,Only in America with Ali Noorani,0,0,0,1,3,4
1320696072,Manifestation Babe,0,1,1,1,47,50
1320704694,Conspiracy Unlimited: Following The Truth Wherever It Leads,33,6,9,12,126,186
1320900659,Third Pod from the Sun,0,0,0,0,7,7
1320968109,AI with AI: Artificial Intelligence with Andy Ilachinski,0,0,0,0,12,12
1321043863,Let's Talk About It With Taylor Nolan,46,0,0,0,4,50
1321057700,A Podcast with Charlie Swenson - To Hell and Back,0,0,0,0,10,10
1321060753,Endless Thread,39,16,23,17,170,265
1321118314,Women Who Travel,5,4,5,5,27,46
1321205306,Regular Car Reviews Podcast,0,0,1,0,11,12
1321362265,The Mouse and More Podcast - Disney News and Reviews,4,0,1,1,54,60
1321368650,Fashion Unzipped,0,0,0,0,3,3
1321405576,Spiritual Queen's Badass Podcast,0,0,1,0,9,10
1321630019,Big Biology,0,1,0,0,9,10
1321658702,This Week in Immigration,0,0,0,1,2,3
1321759767,Reversing Climate Change,1,0,0,0,61,62
1321782407,CorConsult Rx: Evidence-Based Medicine and Pharmacy,0,1,2,1,38,42
1321808251,Tides,1,1,3,2,34,41
1321861159,The Wire Stripped,0,1,1,0,30,32
1321926387,The Constant: A History of Getting Things Wrong,3,4,1,1,41,50
1322087447,Bitcoin & Crypto Trading: Ledger Cast,1,0,0,0,32,33
1322135070,Pickle,3,1,0,7,39,50
1322200189,Crime Junkie,154,77,91,84,1666,2072
1322283290,Your Favorite Band Sucks,99,18,15,13,355,500
1322471304,The Cricket Ultras Podcast,0,0,0,0,1,1
1322536606,Community Chickens,0,0,0,1,3,4
1322573664,Serendipity City,0,0,0,0,5,5
1322601423,Tips With Toni,0,0,0,0,14,14
1322660776,Capital Weather Gang,0,0,0,0,1,1
1322694506,Problematic Women,5,1,0,0,45,51
1322741272,The Nocturnists,0,0,0,0,46,46
1323113336,Go Fact Yourself,0,0,0,2,48,50
1323180307,Behind The Trial,0,0,0,2,6,8
1323269724,Keto Naturopath,1,0,0,0,11,12
1323538015,The Multiorgasmic Mama: sexuality | motherhood | relationships | spirituality | intimacy | postpartu...,0,1,0,1,31,33
1323580239,Startup Hustle,3,1,1,0,28,33
1323836220,The Secret To Success with Antonio T Smith Jr,0,0,0,0,14,14
1324051563,The Simply Luxurious Kitchen - Seasonal Fare to Elevate the Everyday Meal,0,0,0,0,4,4
1324117928,Gensler Design Exchange,0,0,0,0,1,1
1324118843,Say Your Mind,1,1,0,0,16,18
1324125876,Pit Lane Parley,0,1,1,0,30,32
1324249769,Atlanta Monster,171,78,67,45,139,500
1324256724,Make it Stop: A Bad Music Podcast,2,2,0,0,13,17
1324297751,The Back of the Range Golf Podcast,1,0,1,0,69,71
1324498249,Golazzo: The Totally Italian Football Show,0,0,0,0,33,33
1324606666,Keep It!,91,50,53,36,270,500
1324727092,Kalila Stormfire's Economical Magick Services,1,0,0,2,39,42
1324744423,The Insight,2,4,5,3,74,88
1324758369,Station Blue,10,5,4,0,31,50
1324765509,The Financial Samurai Podcast,9,1,0,2,36,48
1325018583,Podnews podcasting news,1,0,0,0,16,17
1325197667,Punch Up The Jam,4,3,4,2,37,50
1325216139,Morning Report,0,0,0,0,9,9
1325242284,Sunday Basket Paper Organization Podcast,0,2,0,0,7,9
1325256647,15-Minute Matrix,1,0,0,1,24,26
1325288920,Science History Podcast,0,0,0,0,10,10
1325375899,Sports? with Katie Nolan,15,6,9,6,464,500
1325401931,Otis Jiry's Scary Stories Told in the Dark: A Horror Anthology Series,1,1,5,2,41,50
1325638028,The Episodic Table of Elements,0,0,0,0,15,15
1325646988,The Sheepspot Podcast,0,0,0,0,21,21
1325750806,No One Can Know About This: A Podcast Where We Play Every Final Fantasy,2,0,1,1,109,113
1325753838,The Golfers Journal Podcast,4,0,0,0,15,19
1325823631,March Madness 365 with Andy Katz,4,1,0,2,16,23
1326095526,Great Disasters,1,0,2,1,33,37
1326102413,Sweat Elite Podcast,0,0,0,0,3,3
1326225706,The Eco Well podcast,0,0,1,0,7,8
1326393257,Dan Carlin's Hardcore History: Addendum,5,1,3,1,40,50
1326561112,CreepyPasta Reading,4,2,10,9,41,66
1326818971,Marketer-to-Marketer - #M2M,0,0,0,0,2,2
1326865967,"Pod Save The Queen - Royal family news, interviews and fashion",52,7,8,11,77,155
1326974796,Another Zelda Podcast,0,0,0,1,49,50
1327121536,Dynasty Trades HQ Podcast,0,2,0,2,98,102
1327149893,Plain English Podcast | Learn English | Practice English with Current Events at the Right Speed for ...,0,0,0,0,8,8
1327156219,Your Day Off @Hairdustry; A Podcast about the Hair Industry!,0,0,0,0,137,137
1327196317,"2 Black Girls, 1 Rose: A Bachelor Podcast",12,1,1,7,337,358
1327208777,The Kara Goldin Show,0,0,0,0,12,12
1327426491,When Meghan Met Harry,5,0,4,2,48,59
1327477438,The Hortoccult: A Horticulture Podcast,0,0,0,0,5,5
1327533952,University of Dutch: The Dutch Mantell Show,4,1,4,2,26,37
1327548312,Uncensored Tactical Podcast,1,0,0,1,7,9
1327602180,The Collective Evolution Show - With Joe Martino,1,1,0,0,23,25
1327642994,History is Gay,2,0,0,0,48,50
1327651489,Atlas Avenue Beat,0,0,1,1,4,6
1327658470,The Knowledge and Mileage Podcast,0,0,0,1,49,50
1327660465,Love Your Life + Law of Attraction,0,0,0,1,49,50
1327711830,Adult Bedtime Stories,4,0,1,1,1,7
1327729036,All Crime No Cattle,18,10,9,15,448,500
1327769095,Talk To Me In Korean - Core Grammar Lessons Only,0,0,1,8,13,22
1328076836,Nintendo Power Podcast,7,1,3,3,36,50
1328142065,Mark of the Maker,0,0,0,1,49,50
1328332258,POST Wrestling w/ John Pollock & Wai Ting,14,2,1,3,156,176
1328561705,Still Watching: WandaVision,30,11,13,15,131,200
1328733796,Just Thinking Podcast,10,1,2,4,363,380
1328791677,The Dennis Michael Lynch Podcast,4,0,0,2,76,82
1328797847,Eat To Live Daily,0,0,0,1,3,4
1328799919,Stand Partners for Life,0,1,0,1,44,46
1329151772,The Official Vue News,0,0,0,0,4,4
1329164008,The You-est You™ Podcast,0,0,1,0,72,73
1329229319,Forever35,14,6,5,2,173,200
1329304951,M*A*S*HCast,1,1,1,1,28,32
1329414094,Get Pregnant Naturally,0,0,0,1,17,18
1329415244,Satura Lanx,0,0,0,0,11,11
1329425337,Make-Believe Heroes,0,0,0,0,50,50
1329431572,An Idiom a Day,0,0,0,0,1,1
1329524900,Global GoalsCast,1,0,0,0,16,17
1329598889,Gup's Corner Podcast Network #FFG,3,2,3,2,490,500
1329622860,Sober Speak-  Alcoholics Anonymous Interviews,0,0,1,0,14,15
1329800657,Straight from a Scientist Medical Research Education and Discussion Podcast,0,0,0,1,3,4
1329830361,The Sustainable Minimalists Podcast,0,1,0,0,49,50
1329973865,Better Sex,0,0,0,0,49,49
1329995882,Positive University Podcast,0,0,0,2,198,200
1330001815,Calmer You Podcast: Anxiety & Confidence,0,0,0,1,14,15
1330004517,The 10 Minute Entrepreneur,1,0,1,0,15,17
1330031134,Talking To Teens: Expert Tips for Parenting Teenagers,0,1,0,0,9,10
1330124393,Dear Premed,0,0,0,0,4,4
1330196974,"Eat This, Not That!",6,12,9,5,18,50
1330224581,Bachelor Party,129,46,35,33,257,500
1330225136,BiggerPockets Money Podcast,29,24,23,20,104,200
1330252360,MENTOR360,0,0,0,0,13,13
1330272056,She Thrives Radio,1,0,1,1,47,50
1330279268,AXE TO GRIND PODCAST,1,0,2,1,68,72
1330329512,CoRecursive: Coding Stories,1,0,0,0,10,11
1330349535,3 Pagans and a Cat,4,3,6,3,24,40
1330350047,Drawing From Experience,0,0,0,1,14,15
1330359266,Hollyweird Paranormal,8,4,1,2,53,68
1330388600,Roast and Reason: A Coffee Podcast,0,0,0,0,24,24
1330416898,Kick in The Creative's Podcast,0,0,0,0,16,16
1330434098,Hurdle,2,0,0,0,48,50
1330438881,500 Greatest Films Podcast,2,0,1,1,29,33
1330521653,‎One-Hit Wonders of the World,0,0,0,1,2,3
1330521952,My Hero Academia: Afterwatch,2,0,0,2,38,42
1330525122,Your Home Story,1,0,0,0,27,28
1330534712,The Fighter Pilot Podcast,0,0,0,0,50,50
1330665690,Purple Patch Podcast,0,0,1,0,49,50
1330684764,It's Wood - A show about all things woodworking,0,0,1,0,4,5
1330698152,Rotor Riot: UNRESTRICTED,2,0,0,1,3,6
1330707800,Other Record Labels - Starting & Running a Record Label,0,0,0,0,9,9
1330765447,Decanted Wine Podcast,0,0,0,0,12,12
1330833158,Wet Fly Swing Fly Fishing Podcast,2,1,1,2,42,48
1330842798,An Unexpected Podcast: Talkin' Tolkien,1,1,5,3,121,131
1330865695,Opposing Bases: Air Traffic Talk,0,0,0,0,50,50
1331142581,New Horror Express,0,0,0,1,1,2
1331165107,CAUTIONARY TALES with Jason Pettigrew,0,0,1,1,0,2
1331204679,Comic Lab,0,0,0,0,43,43
1331255622,Life on the Outside,0,0,0,1,49,50
1331283666,Hello Sport Podcast,0,0,0,0,2,2
1331340228,Bible Beaters,1,2,0,0,3,6
1331429260,The Positive Pants Podcast,0,0,0,0,6,6
1331500430,Just What You Needed,0,0,0,1,73,74
1331528750,The Evidence Based Rheumatology Podcast,0,0,0,0,12,12
1331672119,AP Cardiology,0,0,0,0,8,8
1331747343,Trapping Today,0,0,0,1,68,69
1331809865,Work/Life Imbalance,0,0,0,1,47,48
1331816080,9to5Mac Daily,5,5,1,3,43,57
1331978126,Nature & Nourish with Becky Cole,0,0,0,0,9,9
1332021431,e-flux podcast,0,0,0,0,5,5
1332089061,Is This Real Life? With Mandy Slutsker,5,1,0,1,41,48
1332111459,This Week in Bitcoin,1,0,0,0,9,10
1332150124,31 Thoughts: The Podcast,2,1,5,4,106,118
1332196350,Stand Out,0,0,0,0,27,27
1332221101,BIG MONEY STYLIST,3,3,1,0,39,46
1332383970,Mile Higher Podcast,53,25,24,14,384,500
1332402254,Slay Girl Slay,0,0,0,1,49,50
1332489679,A Farmish Kind of Life,0,0,0,1,16,17
1332565102,Crypto Basic Podcast: Teaching You The Basics of Bitcoin and the World of Cryptocurrency. CryptoBasi...,2,0,0,1,47,50
1332566161,Jase & PJ,4,0,0,0,142,146
1332572879,The Product Boss Podcast,0,1,0,0,49,50
1332583916,Every Movie Reviewed & Ranked - Kinda Funny In Review,10,1,6,8,51,76
1332760646,Somebody Somewhere,4,6,8,4,171,193
1332788588,ADHD Essentials,0,0,0,1,39,40
1332798686,SportsLine DFS Podcast,1,0,0,0,11,12
1332841133,"It's Not About the Food: Intuitive Eating, Anti-Diet, Body Positivity with Dr. Stefani Reinold",1,4,1,2,42,50
1332851444,The Enoch Saga,2,0,3,1,5,11
1332863910,Bonsai Mirai: Asymmetry,0,1,1,1,20,23
1332873362,Power To The Ground Podcast,1,0,0,0,0,1
1332890826,Waiting To Dry,4,2,1,1,34,42
1332908950,CzabeCast,20,4,6,5,181,216
1332994031,Not So Random Facts,1,0,0,0,12,13
1333127700,The Proceedings Podcast,0,0,0,1,8,9
1333153992,The Amazing Nerd Show,1,0,0,3,93,97
1333179029,The Afro Beets Podcast,0,0,0,0,2,2
1333185866,Sailing Doodles Podcast,0,0,0,1,17,18
1333193523,Unladylike,15,7,8,12,305,347
1333234062,Locked On Yankees - Daily Podcast On The New York Yankees,19,3,4,3,22,51
1333234563,Locked On Cubs – Daily Podcast On The Chicago Cubs,3,3,0,3,35,44
1333249096,The Ross Bolen Podcast,12,0,0,2,36,50
1333316223,Small Doses with Amanda Seales,2,0,2,1,45,50
1333434168,GHT Overland - Overlanding Adventure,0,0,0,0,4,4
1333513250,The Best Pick movie podcast,0,0,1,0,13,14
1333552422,"Feel Better, Live More with Dr Rangan Chatterjee",5,0,0,5,355,365
1333553774,The Going Scared Podcast with Jessica Honegger,0,0,0,4,496,500
1333620068,Classic Lenses Podcast,0,0,0,0,1,1
1333621434,Skullduggery,14,5,5,6,20,50
1333665531,Bunny Ears,7,1,2,2,38,50
1333711260,DOOMED with Matt Binder,1,2,0,3,74,80
1333722346,Next Level Human with Dr. Jade Teta,0,0,0,0,50,50
1333795919,Unstress with Dr Ron Ehrlich,0,0,0,0,3,3
1333863338,Bedtime Explorers,4,0,1,3,42,50
1334001706,Garage Guys Fantasy Sports Podcast,2,0,0,0,52,54
1334164416,The Empowered Principal Podcast,0,0,0,0,19,19
1334232884,The Ready State Podcast,0,0,0,0,28,28
1334257580,Kubrick's Universe - The Stanley Kubrick Podcast,0,0,0,0,4,4
1334328470,Future Hindsight,1,0,0,0,5,6
1334359794,The Sword & The Trowel,0,1,0,1,30,32
1334435410,The Lipstick Panel,0,0,1,0,3,4
1334467437,Cool Facts About Animals,2,2,2,1,43,50
1334701895,Orange and Brown Talk: Cleveland Browns Podcast,7,4,9,6,27,53
1334704177,Relics Radio show,0,0,0,0,5,5
1334758163,Leafs Hour,0,0,0,0,1,1
1334767397,CLEANING UP THE MENTAL MESS with Dr. Caroline Leaf,48,24,24,44,368,508
1334808138,Evidence Based Birth®,3,1,2,2,42,50
1334808236,Eat with Confidence,1,0,0,0,49,50
1334818411,Black Girl Experience,0,1,0,0,41,42
1334878780,The Daily Show With Trevor Noah: Ears Edition,160,4,36,36,216,452
1334886108,A F*ckup's Guide To Self-Help,2,2,1,3,42,50
1335069754,"On A Dark, Cold Night",0,0,3,1,37,41
1335196851,I'm Listening : A Frasier Podcast with Anita Flores,5,1,0,1,19,26
1335251466,We Only LOOK Thin,1,0,0,0,49,50
1335323307,Raising Lifelong Learners,0,0,0,0,20,20
1335337319,"Not Your Average Runner, A Running Podcast",3,2,2,3,93,103
1335340277,Not A Podcast ASOIAF Re-Read Podcast,1,2,4,4,120,131
1335343525,Sub 70 Golf Podcast,0,0,0,0,2,2
1335405828,RISE AND GRIND with Daymond John,2,0,1,1,58,62
1335489383,Get In My Garden,0,0,1,1,2,4
1335814741,Business Wars,12,32,32,28,364,468
1335837661,NotiPod Hoy,0,0,0,0,1,1
1335843384,Very Really Good,0,0,0,0,50,50
1335846794,Thriving Stylist Podcast,0,0,0,0,50,50
1335892956,Psychiatry & Psychotherapy Podcast,3,1,4,0,134,142
1336060206,Five On The Floor: Miami Heat/NBA,6,0,3,6,60,75
1336069813,Inside Julia's Kitchen,1,0,1,1,7,10
1336107529,Evolving for the Next Billion by GGV Capital,3,0,2,0,21,26
1336150688,DataFramed,0,0,2,2,39,43
1336174427,Women at Work,2,1,4,1,69,77
1336185129,Ask Me About Kpop,0,0,0,1,23,24
1336219866,Pot and Cloche Garden Podcasts,0,0,0,0,1,1
1336222571,Stoic Coffee Break,0,0,0,0,13,13
1336279499,Out of Bounds Podcast,1,0,1,0,53,55
1336306636,"Actually, You Are a Real Runner",0,0,0,1,10,11
1336384602,the fastlife podcast,0,0,0,0,33,33
1336581302,The Art Law Podcast,0,0,0,0,5,5
1336643980,The Grit! with Chas Smith,1,2,2,1,19,25
1336653389,Peer to Peer,0,0,0,0,50,50
1336692606,The Subtext,0,0,0,1,8,9
1336816083,The Noco Moto Motorcycle Podcast,0,1,1,0,48,50
1337100398,This is Love,7,7,9,16,461,500
1337151390,Podcasting Simplified,0,0,0,1,21,22
1337184561,#RunPainFree Podcast,0,0,0,0,1,1
1337188302,"Confessions of a Top-Producing Real Estate Agent, the Agent Grad School Podcast",0,2,0,1,15,18
1337195586,Conspiracy Theories,246,106,96,64,230,742
1337245532,Stay Paid - A Sales and Marketing Podcast,0,0,0,1,49,50
1337320735,This Movie Changed Me,2,0,0,6,61,69
1337408467,The Elevator,0,4,4,2,207,217
1337670733,The Extra Inch (Spurs Podcast),0,0,0,0,76,76
1337718773,How to Money,3,1,4,3,189,200
1337886873,Choiceology with Katy Milkman,4,2,1,7,136,150
1337888247,Battleground Podcast,0,0,0,0,17,17
1337977178,The Everyday Sniper,1,0,0,0,43,44
1338152676,Deida.live,0,0,0,0,1,1
1338192409,NFL Draft Bible Podcast Network,0,0,1,0,25,26
1338300738,Disgorgeous,2,1,0,0,14,17
1338469780,The Mother Like a Boss Podcast,2,1,1,0,46,50
1338540646,The Boat Galley,2,0,1,2,9,14
1338558972,Abroad in Japan,5,9,5,6,136,161
1338562905,Neurodiversity Podcast,0,2,0,1,13,16
1338596015,Cog Hill Farm Podcast,1,0,0,0,34,35
1338659369,The Echo Chamber,0,0,0,0,2,2
1338725618,Pod To Pluto,0,0,0,0,10,10
1338732915,Persian night story,0,0,1,5,26,32
1338891894,"Drop-Tine Podcast -The official deer management, food plot & habitat podcast",0,0,0,0,34,34
1338907745,Application Security Weekly (Audio),0,0,0,0,1,1
1338908396,Application Security Weekly (Video),0,1,0,0,0,1
1338929065,NICTalks,0,0,0,0,1,1
1338931307,Learn French Conversation,1,0,0,0,8,9
1339025840,American Toffee Podcast,0,0,0,1,32,33
1339028551,Backpacker Radio,10,4,9,4,356,383
1339203435,Growth Experts with Dennis Brown,1,0,0,2,47,50
1339219119,De Dag,0,0,1,0,0,1
1339259790,Suburban Dharma,0,0,0,0,3,3
1339316995,THE STREET CONSERVATIVE PODCAST,2,0,0,0,7,9
1339405050,Hoovering,1,0,2,0,46,49
1339451218,The Business of Content,0,0,0,0,2,2
1339492752,People of the Pod,1,0,2,0,11,14
1339636919,The QUARTERDECK Sailing Podcast,1,0,0,0,21,22
1339770338,I Am In Eskew,0,0,0,0,40,40
1339914977,There Will Be Dungeons,1,0,1,4,36,42
1339952977,Dear HBR:,10,2,4,3,26,45
1339966878,Lightworkers Lounge,7,4,1,2,71,85
1339976762,Dr. Berg’s Healthy Keto and Intermittent Fasting Podcast,3,4,0,1,42,50
1340196987,Moneycontrol Podcast,7,1,0,4,6,18
1340277737,Fantasy Football Podcast,2,1,0,2,81,86
1340368142,The PFF Forecast,9,4,4,5,78,100
1340435871,The Body Image Podcast,0,1,0,0,20,21
1340458856,Spiritual Swingers,2,0,1,0,15,18
1340460508,Business of Home Podcast,0,2,0,1,27,30
1340505607,The Science of Happiness,6,3,4,2,63,78
1340679758,Nonprofit Jenni Show,0,0,0,1,43,44
1340801064,Shoot Fast Podcast,0,1,0,3,81,85
1340895033,Adoption Hacks,1,0,0,0,27,28
1340970714,EV News Daily - Electric Car Podcast,0,0,1,1,48,50
1340999161,England Rugby Podcast: O2 Inside Line,0,0,0,0,4,4
1341040591,Interior Design with Kandrac and Kole,0,0,0,0,40,40
1341076079,Everything Happens with Kate Bowler,3,0,5,9,412,429
1341346059,Mark Bell's Power Project,4,1,1,1,43,50
1341376118,Just Wanna Quilt,8,1,6,3,25,43
1341478446,The Home Service Expert Podcast,1,1,0,2,46,50
1341507777,The Robby Row Show Baseball Podcast,0,0,0,0,50,50
1341515131,Customs Out of The Closet,0,0,0,0,3,3
1341747815,The 59th Minute FPL Podcast,0,0,0,0,8,8
1341785066,Teaching Hard History,0,0,0,1,37,38
1341848099,The Natural State with Dr. Anthony Gustin,0,0,1,0,49,50
1341900209,Play Guitar Podcast,0,0,0,1,50,51
1342003491,The Anthropocene Reviewed,4,1,2,6,487,500
1342021363,The WW Bro Podcast w/ Anthony DiDomenico,0,0,0,0,50,50
1342032280,Rock Candy,4,1,0,0,39,44
1342228212,Ladies of the Fright,0,0,1,0,7,8
1342285788,BIG Life Devotional | Daily Devotional for Women,0,0,1,0,60,61
1342297320,The Power of Us,0,0,0,2,48,50
1342305295,We Hunt the Keepers!,0,0,0,0,5,5
1342314653,The Pan Dulce Life,0,0,0,0,15,15
1342317197,Sound of the Loons,3,2,1,0,10,16
1342372520,Mafia,14,18,18,28,167,245
1342374347,Weave,1,1,2,2,15,21
1342485047,Design Tribe Podcast,0,0,0,0,5,5
1342503128,Retropod,3,3,2,8,34,50
1342503754,Duck Gun Podcast,4,3,2,0,88,97
1342674932,You'll Hear It - Music Advice,1,0,0,0,122,123
1342754239,Loving Well,0,0,0,0,10,10
1342810565,TCBCast: An Unofficial Elvis Presley Fan Podcast,0,0,0,1,13,14
1342857653,Late Night Whenever,0,2,0,3,45,50
1342868490,This Cultural Moment,3,1,0,7,380,391
1342933455,Washington Post Live,1,0,0,1,1,3
1342957627,The Betches Sup Podcast,1,0,0,0,49,50
1342962270,Watch And Listen,2,0,4,4,16,26
1342998141,TomoChoco Podcast,1,0,0,0,4,5
1343288276,Art Matters,0,0,0,1,6,7
1343499710,Marvel's Wolverine,5,7,10,16,162,200
1343507855,Miraculous Mamas,4,3,1,2,40,50
1343646999,The RunOut Podcast,2,0,1,0,18,21
1343850006,"Threads Magazine Podcast: ""Sewing With Threads""",0,0,1,1,9,11
1343918203,The Healthy Christian Women Podcast,0,0,1,2,25,28
1343991618,Fit Strong Women Over 50,0,0,0,1,4,5
1344003690,Not Another D&D Podcast,2,0,1,1,46,50
1344226066,Spurs Insider,4,0,1,2,22,29
1344242713,The Stepbrothers Podcast,0,0,0,0,3,3
1344288346,The Productive Muslim Podcast,0,0,0,1,1,2
1344357698,Chilluminati Podcast,3,0,4,3,40,50
1344367350,Assyrian Podcast,0,0,0,0,17,17
1344384300,Talking Buffalo Podcast,1,0,0,0,35,36
1344394501,Sage Family,1,0,2,1,46,50
1344584110,Northern Myths Podcast,1,8,6,2,25,42
1344624354,Junior Golf Blueprint,0,0,0,0,29,29
1344681226,Fast Keto with Ketogenic Girl,0,0,2,4,44,50
1344741001,The Dog Health & Happiness Podcast | Bella & Duke,0,0,0,0,1,1
1344867307,DayWeather Podcast,0,0,0,0,7,7
1344894187,"Trump, Inc.",2,3,1,5,39,50
1344913966,Cultaholic Wrestling,3,0,0,1,22,26
1344937378,Let Me Tell You...With Joan Hamburg,0,0,0,0,3,3
1344999619,The Jordan Harbinger Show,1,1,0,2,46,50
1345050660,AvGeek Chronicles,0,0,0,0,6,6
1345057591,Astros Baseball,0,0,0,0,52,52
1345075933,The Divorce Survival Guide Podcast,4,2,2,0,42,50
1345104153,Spanishland School Podcast: Learn Spanish Tips That Improve Your Fluency in 10 Minutes or Less,0,0,0,0,50,50
1345136168,To 50 and Beyond,0,0,0,0,50,50
1345444704,VR Flight World Podcast,0,0,0,0,3,3
1345523077,Witness History: World War 2 Collection,0,0,1,0,6,7
1345547675,Skimm'd from the Couch,12,8,14,21,80,135
1345633548,The Voice of Social Sales,0,0,0,0,21,21
1345643457,The Sacramento Bee Daily Flash Briefing,6,3,1,0,2,12
1345644349,The Kansas City Star Daily Flash Briefing,1,0,0,0,0,1
1345682353,Armchair Expert with Dax Shepard,53,23,42,40,341,499
1345690082,The Southern Outdoorsmen Hunting Podcast,1,0,0,5,304,310
1345709834,Tales,28,12,14,15,131,200
1345737203,Happiness Spells,0,0,0,1,49,50
1345755593,Simple. Handmade. Everyday.,1,0,0,0,49,50
1345840002,Tasteless,1,1,0,1,109,112
1345966330,"MudTalk Podcast – Pottery, Ceramics, Art and Business – Expert Clay",0,0,0,0,1,1
1346062517,7 Good Minutes Daily Self-Improvement Podcast with Clyde Lee Dennis,0,0,0,0,3,3
1346207297,"Today, Explained",73,40,40,39,308,500
1346227100,The After Gambling Podcast,0,1,0,0,39,40
1346262634,The Hunting Collective,55,11,15,9,382,472
1346314086,WorkLife with Adam Grant,15,5,20,45,865,950
1346327591,The Jungle Room,1,0,1,0,11,13
1346804716,"The Examen with Fr. James Martin, SJ",0,0,1,0,28,29
1346820645,The Fundamentalists,3,4,13,8,119,147
1346852560,Ready Set Love!,0,0,0,0,41,41
1346854349,The Green Building Matters Podcast with Charlie Cichetti,0,0,0,0,10,10
1346866422,Horror Hill: A Horror Anthology and Scary Stories Series Podcast,1,0,1,1,47,50
1346903603,HatCast - A Podcast About Hats,0,0,0,0,2,2
1346950913,Redvolution Rampage,0,0,0,0,5,5
1346953754,Global Seducer Quickie Podcast,1,0,0,2,64,67
1346963040,This is War,18,17,23,17,232,307
1347029952,Local SEO Tactics and Digital Marketing Strategies,0,0,0,0,50,50
1347034981,Satan and Rainbows,0,0,0,1,10,11
1347049808,Unconfirmed,3,1,1,1,21,27
1347072452,Weed + Grub,0,0,0,0,50,50
1347231770,Health Coach Power Community,0,0,0,0,49,49
1347283065,Five Games for Doomsday,0,0,0,0,8,8
1347286418,From Hostage To Hero,0,0,0,0,22,22
1347293924,Pounded In The Butt By My Own Podcast,11,0,2,2,35,50
1347332918,Supreme Court decision syllabus (SCOTUS),1,0,0,0,6,7
1347349176,The Bricks King Podcast: LEGO,0,1,0,1,29,31
1347351290,Congeria,2,4,7,1,36,50
1347436922,"The PurposeGirl Podcast: Empowering women to live their purpose with courage, joy, and fierce self-l...",0,0,0,0,50,50
1347626043,Second Life,9,5,12,7,167,200
1347649088,Truth Seekers: Bible Stories for Kids,0,0,0,2,153,155
1347718040,Brilliant Perspectives,0,0,1,1,78,80
1347723528,Tomes & Tentacles - Call of Cthulhu Actual Play,0,0,0,1,37,38
1347735219,The Bible Binge,15,9,8,7,461,500
1347746953,No Bad Dogs Podcast,0,0,0,0,50,50
1347757659,Voices of Your Village,0,1,0,0,40,41
1347789490,The Aquarist Podcast,0,0,0,0,23,23
1347811999,"Dear Men: How to Rock Sex, Dating, and Relationships With Women",0,0,1,0,14,15
1347954357,Breaking Atoms: The Hip Hop Podcast,0,0,0,0,20,20
1348000511,ASCO Guidelines Podcast Series,0,0,0,0,4,4
1348014797,"BreakerCulture Podcast -- Sports Card Insight, Interviews, Investment, Stories, and much more!",2,0,1,2,45,50
1348047791,The Dynasty Baseball Show,0,1,1,0,40,42
1348072190,Order 9066,0,0,0,1,80,81
1348074052,The Female Health Solution Podcast,0,0,1,2,28,31
1348078374,Art History for All,0,0,0,2,26,28
1348134531,Real Talk Kim,1,0,1,0,167,169
1348151802,Ancient History Fangirl,3,1,1,3,37,45
1348188941,Halloweenies: A Horror Franchise Podcast,5,1,5,5,114,130
1348223667,What's Your Sign?,11,4,13,3,304,335
1348392537,Southern Gothic,2,1,4,5,38,50
1348446973,Quoth the Raven,10,2,1,2,35,50
1348469682,The Big Fib,1,1,2,2,44,50
1348470106,Six Minutes,2,1,0,3,44,50
1348529836,Beauty Bytes with Dr. Kay: Secrets of a Plastic Surgeon™,0,0,0,0,50,50
1348530012,Mighty Parenting | Raising Teens | Parenting Young Adults,0,0,0,1,12,13
1348533576,KGI: Innovation in Applied Life Sciences & Healthcare,0,0,0,0,2,2
1348535955,Nobody Told Me!,1,0,1,2,32,36
1348777092,Girls Gotta Eat,8,0,6,1,35,50
1348831124,Transformation Church,0,0,0,0,14,14
1348856817,The Jordan Syatt Mini-Podcast,0,0,0,0,50,50
1349078561,Board Game Barrage,1,0,1,0,48,50
1349106563,Dead Meat Podcast,8,9,7,5,471,500
1349323218,The Freethinking Podcast,0,0,0,0,6,6
1349454032,Professional Troublemaker,3,0,0,3,190,196
1349500084,Marriage After God,4,1,5,10,361,381
1349523628,The Signal,3,1,8,5,72,89
1349600088,Locked On Twins - Daily Podcast On The Minnesota Twins,1,0,1,1,63,66
1349646985,Flower Power Garden Hour,1,1,2,0,24,28
1349914886,Locked On Pirates - Daily Podcast On The Pittsburgh Pirates,1,0,0,3,6,10
1349918061,Yahoo! Finance Daily,6,0,0,0,0,6
1349923893,The Short Porch,34,11,1,4,223,273
1349937827,Tumblehome: A Boundary Waters Podcast,0,0,0,1,22,23
1350018791,The Rhino Podcast,2,0,0,0,17,19
1350039358,Bossed Up,0,1,0,2,112,115
1350043452,The Bay,1,0,4,0,45,50
1350064353,Great Moments in Weed History,1,0,1,1,47,50
1350116193,American Presidents: Totalus Rankium,0,0,2,3,45,50
1350156851,The Virtual Ocean,1,0,0,0,3,4
1350157623,KnockBack: The Retro and Nostalgia Podcast,0,0,0,0,50,50
1350226452,Walford Weekly,0,0,0,0,8,8
1350247761,Profit Maximalist,0,0,1,0,15,16
1350272565,The What Podcast,0,0,1,1,69,71
1350320411,Be There in Five,7,2,2,1,488,500
1350483937,Citizen Bitcoin,0,0,1,0,26,27
1350499924,Warriors In Their Own Words | First Person War Stories,3,0,0,5,25,33
1350576424,The Music Industry Blueprint Podcast,0,0,0,1,186,187
1350581005,Green Beauty Conversations by Formula Botanica | Organic & Natural Skincare | Cosmetic Formulation |...,0,0,1,7,131,139
1350586048,"The Grave Talks | Haunted, Paranormal & Supernatural",41,33,24,17,385,500
1350594046,Good Night Stories for Rebel Girls,0,0,0,2,48,50
1350595015,UX Cake,0,0,0,0,11,11
1350601648,Ninth Avenue Church of Christ,0,0,0,0,2,2
1350627500,Inside Skunk Works,0,0,3,1,39,43
1350637491,Dark and Twisty Tales: folk stories and fairy tales for the unafraid.,0,1,0,0,31,32
1350850605,Dressed: The History of Fashion,7,15,33,14,93,162
1350898717,The Metal Hammer Podcast,0,0,0,0,3,3
1350908714,Physical Therapy Private Practice: Secrets of the Top 10%,0,0,0,0,13,13
1350993450,Second Best: A DnD Adventure,0,1,1,0,48,50
1351025053,The Magpies: A Blades in the Dark Actual Play,0,2,0,1,46,49
1351044991,The A24 Podcast,2,1,4,8,61,76
1351065618,Fierce Girls,4,0,2,8,36,50
1351109676,Ask a Manager,0,1,5,8,52,66
1351131347,The Cricket Mentoring Podcast,0,0,0,0,2,2
1351140297,Steep Life Media,0,0,0,0,24,24
1351389458,Unexplained Mysteries,9,5,9,4,23,50
1351395270,Let's Talk Battle Rap Podcast,0,0,0,0,12,12
1351401625,Anime Out of Context,1,0,1,1,47,50
1351402351,Locked On Angels - Daily Podcast On The Los Angeles Angels,2,1,3,0,16,22
1351443139,Locked On Reds - Daily Podcast On The Cincinnati Reds,2,0,4,2,23,31
1351447720,Tundra Talk Podcast,1,0,1,1,56,59
1351536285,Designed Today,0,0,0,0,9,9
1351594889,You Can't Do That,0,0,0,1,64,65
1351615675,Keelhauled: A Sea of Thieves Podcast,1,0,1,1,47,50
1351749137,"Crypto Weekly | Cryptocurrency, Bitcoin, Ethereum, Altcoin and ICO news from the week",0,0,0,0,13,13
1351960656,The Soundtrack Show,1,2,5,10,188,206
1351965013,Locked On Orioles - Daily Podcast On The Baltimore Orioles,1,0,0,1,16,18
1351990699,Boutique Chat,0,0,1,1,98,100
1352018677,Squat University,0,0,0,1,49,50
1352049776,Reef News Network,2,0,0,1,47,50
1352050241,All Systems Goku,3,0,1,2,44,50
1352135614,The Champions' Cast - Zelda Dungeon Podcast,0,1,2,3,24,30
1352138166,Spread Aviation Podcast,0,0,0,0,2,2
1352155568,Fungi Town,1,0,0,0,5,6
1352182194,RFK Refugees Podcast,0,0,0,1,17,18
1352231546,"The Scuffed Soccer Podcast | USMNT, Yanks Abroad, MLS, futbol in America",5,3,3,8,151,170
1352305461,Explaining Brazil,0,1,0,1,4,6
1352422076,Focused Compounding,0,1,0,0,44,45
1352546554,The goop Podcast,1,0,1,1,1,4
1352559512,"Get Tressed With Us! - Us Weekly Hair, Beauty and Style",0,0,0,0,2,2
1352602663,The Gravel Ride.  A cycling podcast,0,0,0,1,40,41
1352620292,In the Spirit of Horse,0,0,0,0,32,32
1352677425,The ASMR Garden,1,0,4,3,42,50
1352692232,The Rail~Volution Podcast,0,0,0,0,1,1
1352730623,3 and Out with John Middlekauff,12,1,2,7,478,500
1352733984,Undr The Cosh,0,3,8,10,479,500
1352791315,Real Life Pharmacology - Pharmacology Education for Health Care Professionals,1,1,0,1,47,50
1352800687,History Hyenas with Chris Distefano and Yannis Pappas,7,1,0,1,41,50
1352808806,The Physician Assistant Startup Podcast,0,0,0,1,19,20
1352860989,The Michael Shermer Show,11,4,3,1,20,39
1352862928,Reductio: Adventures in Ideas,0,0,0,0,2,2
1352884223,The Triathlete Beat: A Beginner Triathlon Podcast,0,0,0,0,1,1
1352887454,Positive Mindset,0,0,0,1,5,6
1352967778,Countdown To Classic,0,1,0,1,50,52
1353058891,Happy Place,0,0,0,0,6,6
1353250252,The Bettor Life,4,3,3,2,38,50
1353308883,America's National Parks Podcast,2,2,5,1,82,92
1353317451,Warriors Off Court,2,0,4,1,3,10
1353332879,"Space, But Messier!",0,0,0,0,32,32
1353418080,Chompers,3,0,6,7,34,50
1353457276,Sustainable Asia,0,0,1,0,5,6
1353531644,Solosaurus,3,0,0,3,32,38
1353574678,Tom Rowland Podcast,3,0,0,3,320,326
1353720736,SWISSCAST with Suhaib Webb,0,0,0,2,67,69
1353728357,Let's Go To Court!,27,13,12,19,429,500
1353814156,Pilot Episodes,0,0,0,0,1,1
1353825724,Change Agent,5,3,3,4,98,113
1353839801,NASW Social Work Talks,2,3,0,3,1,9
1353881288,Mornings with Mayesh,0,0,0,0,1,1
1353905337,City of the Future,0,1,0,1,20,22
1353975287,Autonomous Cars with Marc Hoag,0,1,0,1,15,17
1354024656,Plugged In Golf Podcast,0,0,0,4,9,13
1354063785,The Succulent FAQ,0,0,0,0,8,8
1354140820,Love Letters,6,2,2,3,64,77
1354154060,Death Is Just Around the Corner,0,1,1,0,22,24
1354195914,Felonious Florida,19,18,29,32,123,221
1354474880,The HeirPod - Royal News & Interviews,18,8,2,4,18,50
1354476540,Let's Learn Turkish,0,0,0,0,2,2
1354538190,Spec Media,0,0,0,0,34,34
1354611827,Deconstructed,8,2,2,2,36,50
1354632347,Horns of a Dilemma,0,2,1,1,1,5
1354647807,The Counsel of Trent,4,4,6,8,186,208
1354722078,Light The Fight- Parenting Podcast,1,1,4,1,43,50
1354780495,Fantastic Geeks (and where to find them),1,4,5,5,335,350
1354791262,Built To Hunt by Huntin' Fool,0,0,0,0,8,8
1354832504,Forever Mighty Podcast: Your Anaheim Ducks Podcast,0,0,0,0,11,11
1355014820,Stop Over-drinking and Start Living,3,1,0,0,37,41
1355066333,Working Class History,0,0,0,0,21,21
1355180130,Start Here,4,1,3,1,41,50
1355191009,School Leadership Reimagined,2,0,1,1,18,22
1355212895,Techmeme Ride Home,5,2,3,2,38,50
1355215424,Hot and Bothered,7,8,4,4,177,200
1355337329,The Curtiss King Podcast,0,0,0,0,14,14
1355458650,The Grey Rooms,5,1,3,4,37,50
1355485207,The Easy Living Yards Podcast,1,0,1,0,19,21
1355495674,VSiN Best Bets,3,2,6,2,14,27
1355506771,Stop Me If I've Heard This,0,0,0,0,8,8
1355515750,The Happy Times,0,0,1,0,49,50
1355526064,"Don't Tell Our Wives: Warm Beer, Cheap Comedy, and News",2,0,0,0,8,10
1355526144,The Edges & Sledges Cricket Podcast,0,0,0,0,4,4
1355643870,God is Dead,0,0,0,0,15,15
1355747985,Aethuran Dark Saga - A Dark Fantasy Audio Fiction,1,0,0,0,22,23
1355846130,How to Get a Meeting With Anyone,0,0,0,0,8,8
1355853948,Taking Back Your Power,1,0,0,0,49,50
1355859570,The Love Drive with Shaun Galanos,0,0,0,1,97,98
1355861946,"Ladies, First",0,0,0,1,4,5
1355862767,All Things Internet's podcast,5,0,2,1,42,50
1355889579,@theBar,0,0,1,0,9,10
1355916629,Drinking Socially - The Official Untappd Podcast,3,1,5,4,33,46
1355965831,La Vuelta Podcast,0,0,0,0,5,5
1356008931,TASKMISTRESS,8,11,12,13,456,500
1356125481,The Transgender Scientist,0,0,0,1,6,7
1356142765,Evil Genius with Russell Kane,18,9,13,9,48,97
1356303465,Asian Not Asian,1,2,1,1,45,50
1356567877,First Class Fatherhood,2,0,0,0,30,32
1356603588,Innovation in Compliance with Tom Fox,0,0,0,0,3,3
1356670998,Good Moms Bad Choices,3,0,4,3,295,305
1356729135,No Putts Given,5,0,0,3,62,70
1356739458,The Panthers Podcast Network,0,0,1,1,11,13
1356795309,Andy Frasco's World Saving Podcast,0,1,1,1,47,50
1357127065,Help I Sexted My Boss,2,0,1,5,400,408
1357202594,"Miles to Go - Travel Tips, News & Reviews You Can't Afford to Miss!",0,0,2,1,35,38
1357251736,"InsideTheBoards Study Smarter Podcast: Question Reviews for the USMLE, COMLEX, and Medical School",0,1,0,0,37,38
1357260772,Weight Loss for Foodies podcast | Ditch the Diet and Lose Weight with Shari Broder | Life Coach Scho...,1,1,0,2,31,35
1357366726,Female Criminals,53,43,44,32,307,479
1357386196,Write Or Die Podcast,0,0,2,1,41,44
1357401021,The Truck Show Podcast,2,1,1,1,45,50
1357630488,Slime Sabatoge,4,0,2,1,1,8
1357715797,WHAT THE TRUCK?!?,3,0,0,2,16,21
1357726888,KUNC's Colorado Edition,0,0,0,0,2,2
1357803588,Bridge the Gap: The Senior Living Podcast,1,0,0,0,15,16
1357882784,Score: The Podcast,0,1,3,2,66,72
1357979104,The Sober Therapist SoberSoul Recovery Podcast,1,1,1,1,46,50
1357998020,Chakra Girl Radio,15,0,2,0,33,50
1358031226,And the Runner-Up Is,3,2,1,2,19,27
1358037939,Breaking Beyond-Guided Meditation,0,0,0,2,15,17
1358056327,Bible Thinker,0,1,1,1,40,43
1358111889,Fowl Front Waterfowl Podcast,5,3,1,3,45,57
1358171138,The Attack On Titan Podcast,1,1,0,3,14,19
1358171705,ON BOYS Podcast,0,0,1,1,12,14
1358177614,The Dance Moms Podcast,1,0,0,0,4,5
1358179910,The Fuller House Podcast,1,0,0,1,1,3
1358187061,The Athletic NBA Show,43,9,4,5,188,249
1358188114,The Real Housewives of New Jersey After Show Podcast,2,1,3,0,3,9
1358188492,The Real Housewives of Orange County After Show Podcast,13,5,3,0,4,25
1358188497,The Real Housewives of Potomac Podcast,0,0,0,0,5,5
1358363335,Democracy Works,0,0,0,0,16,16
1358366637,GotTechED the Podcast,0,0,0,0,5,5
1358381502,Wall Street Breakfast,21,22,23,11,22,99
1358410365,Beauty Bosses,0,3,0,0,22,25
1358420654,Toxic Schlock,0,0,0,0,13,13
1358426248,Difficult Happens; Effective Communication for Bosses,0,0,0,0,24,24
1358453989,Living Corporate,2,0,0,0,56,58
1358557895,The Vegan Gym Podcast,2,0,0,0,48,50
1358570980,The Mark Martin Podcast,0,0,4,0,34,38
1358580617,The OT School House for School-Based OTs Podcast,0,0,0,0,17,17
1358582302,Mid South Wrestling Television Review,3,2,1,3,51,60
1358600318,The Priory Society - Sex Podcast for Swingers,4,2,1,0,43,50
1358688590,The Tim Faller Show,0,0,0,0,8,8
1358692957,Cannon Fodder,0,0,0,1,49,50
1358697135,Marine Conservation Happy Hour,0,1,2,1,8,12
1358713082,Spanish for Beginners,0,0,0,0,5,5
1358733969,Heart of Dating,2,3,3,2,486,496
1358793371,Forensic Files,16,25,17,21,104,183
1358843497,All Ball with Doug Gottlieb,9,1,2,6,31,49
1358926997,Alchemy with Ambi,1,0,0,1,69,71
1358988073,The Perfect RIA,1,0,0,0,37,38
1359249098,Relatable with Allie Beth Stuckey,5,0,0,0,45,50
1359253455,HVAC Know It All Podcast,0,0,1,1,18,20
1359262274,Learning to fly,0,0,0,0,3,3
1359293892,Rockin' Eddy Oldies Radio Show,0,0,0,0,2,2
1359332091,Endurance Horse Podcast,1,0,0,0,6,7
1359424348,The DogBone Pawdcast,0,0,0,0,41,41
1359469323,Ruchi Koval,0,0,0,0,5,5
1359544516,Bitcoin Audible,0,1,0,1,34,36
1359664915,Sibling Rivalry,0,0,0,1,49,50
1359992815,The Intrazone by Microsoft,0,0,0,2,3,5
1360089692,The Uncensored Empath,0,0,1,0,93,94
1360148861,Top End Moto Podcast,0,0,0,1,10,11
1360162037,No Hay Tos (Real Mexican Spanish),0,0,0,0,50,50
1360304023,The Retirement Wisdom Podcast,0,0,0,0,5,5
1360374196,Punk Rock HR,6,0,2,3,39,50
1360406217,MarTech Podcast // Marketing + Technology = Business Growth,0,1,0,0,10,11
1360408159,Wesam's World,1,0,0,0,17,18
1360415190,Joseph: Season 1 - The Revenge of Opus,0,0,0,0,3,3
1360437908,PC Flight Podcast,0,0,0,0,2,2
1360493241,The Last Movie,7,9,7,4,23,50
1360547558,The Good Girls Podcast,1,2,1,0,0,4
1360587089,Star Wars STUFF Podcast,1,0,1,3,78,83
1360642286,Make Do,0,0,0,0,4,4
1360675823,Look Good Move Well,0,0,0,0,21,21
1360692490,Design Voice Podcast,0,0,0,0,8,8
1360813259,Two Vets Talk Pets,0,0,0,0,1,1
1360822996,Dr Duck Waterfowl Podcast,1,0,0,0,37,38
1360863632,Marketing Scoop Podcast,0,0,0,0,11,11
1360912840,State of sportfishing - By Billfish,0,0,0,0,1,1
1360918836,The NBA Daily Ding,2,2,0,1,70,75
1361208631,upNXT: The Unofficial NXT Podcast,0,0,2,0,26,28
1361284886,Girls Gone Boss,0,0,0,0,38,38
1361314459,"Our Farms, Our Future",0,0,0,0,5,5
1361399351,Scoops with Danny Mac,5,6,5,8,34,58
1361401612,Lady Startup Stories,2,0,2,2,76,82
1361462308,Star Wars Spelt Out Podcast,0,0,1,0,10,11
1361582513,Craig & Friends,4,2,2,1,41,50
1361701448,The Fifty One,0,0,0,1,7,8
1361770048,"Somehow I Manage: Rewatching ""The Office""",5,0,0,2,41,48
1361803318,In A Mississippi Minute with Steve Azar,0,0,0,0,3,3
1361879433,Locked On MLB - Daily Podcast On Major League Baseball,6,3,2,3,35,49
1361901051,Holding Space,0,0,0,0,17,17
1361914055,"Essentially You: Empowering You On Your Health & Wellness Journey With Safe, Natural & Effective Sol...",0,0,2,3,45,50
1361935829,Good Sex Bad Sex,0,0,0,0,1,1
1362086807,Behind the Bookshelves,0,0,0,1,3,4
1362164483,The Stacks,1,0,0,1,198,200
1362171518,"Fujoshi Senpai | Boys Love, Yaoi, shojo",0,0,0,0,1,1
1362189106,Time in Flight,0,0,0,0,1,1
1362265400,Tim Pool Daily Show,52,16,10,8,112,198
1362277001,Ancient Wisdom Today,5,3,3,2,423,436
1362576362,Mind Body Garden,0,0,0,0,2,2
1362671817,Habitat Podcast,1,0,0,1,169,171
1362687862,MCHD Paramedic Podcast,0,0,0,0,16,16
1362761080,Zero to Seven Figures Entrepreneur Podcast - Entrepreneur Tips & Entrepreneur Tactics,1,0,1,0,32,34
1362764837,Vince Russo's The Brand,12,1,0,0,30,43
1362881501,Khandaan- A Bollywood Podcast,0,0,0,1,24,25
1362910749,Legends of the Old West,1,2,0,5,42,50
1363051672,BEAUTY NEWS,0,0,0,0,9,9
1363110130,After Hours,3,3,0,2,128,136
1363150272,Be. Scared,3,2,2,5,38,50
1363182054,Cyber Security Today,0,0,0,0,1,1
1363211852,Filmography,0,0,0,1,1,2
1363232295,The Producer's Guide: Todd Garner & Hollywood's Elite,0,0,0,0,40,40
1363370570,Backpacking Light Podcast,0,0,1,1,27,29
1363389413,Human Performance Outliers Podcast,0,2,3,4,41,50
1363536403,Craft Hangout,0,0,0,0,50,50
1363543523,Emotional Badass,0,0,0,1,49,50
1363609926,The History of Vikings,0,0,1,1,48,50
1363764781,3 Yards Per Carry - Miami Dolphins,10,5,2,8,43,68
1363788914,Smash Bros Cast A Smash Bros Podcast,0,0,0,0,24,24
1363790050,Black Millennial Marriage,1,0,0,0,100,101
1363803317,Keeper Chat,1,1,1,2,101,106
1363817503,Dinner Sisters,1,0,1,0,27,29
1363845621,"Slow Italian, Fast Learning",0,0,0,0,1,1
1363963113,The Marx Brothers Council Podcast,0,0,0,1,26,27
1364093026,The Wild Episode,0,0,0,0,13,13
1364109052,TPRS Russian – Effortless Russian,0,0,0,0,17,17
1364113251,The Beat with Ari Melber,20,5,14,14,194,247
1364128350,Velvet's Edge with Kelly Henderson,16,2,3,6,70,97
1364141623,Take Back Time: Time Management | Stress Management | Tug of War With Time,0,0,0,0,7,7
1364171881,The ReWire Podcast w/ Ryan Stewman,1,0,0,0,49,50
1364507626,3 Books With Neil Pasricha,0,1,1,4,51,57
1364539980,Popular Front,4,2,4,0,40,50
1364665348,Uncover,63,67,106,74,190,500
1364701805,Prospective Doctor (from MedSchoolCoach),1,0,1,0,3,5
1364705753,Bulletproof Screenwriting™ Podcast with Alex Ferrari,1,2,4,2,19,28
1364706343,Academy of Ideas,0,0,0,0,20,20
1364708230,The Drunk Mormon Podcast,2,0,1,0,47,50
1364729629,Ask Frank Kern,0,0,0,1,44,45
1364752347,The Cozy Minimalism Podcast,3,2,0,1,9,15
1364764784,Bad On Paper,6,3,5,7,179,200
1364786016,Con Las Bases Llenas Podcast de Beisbol,0,0,0,0,3,3
1364798971,Red Scare,104,20,11,18,182,335
1365129878,Get Up!,33,11,9,9,29,91
1365149586,Critical Update,0,0,0,0,1,1
1365155811,Get Rich Or Get Drunk Trying,0,0,0,0,36,36
1365178782,Montessori Education with Jesse McCarthy,0,0,0,1,49,50
1365234191,LA Podcast,2,0,2,5,41,50
1365312021,Sleep Meditation Podcast: The Podcast That Helps You Sleep 😴Nature Sounds & ASMR Sleep Triggers,3,1,2,6,38,50
1365334446,Royally Obsessed,76,25,25,17,310,453
1365350953,The David Suissa Podcast,0,1,0,0,4,5
1365603174,STABcast,0,0,0,0,6,6
1365643893,Fairways of Life with Matt Adams Golf Show,0,0,0,0,1,1
1365652573,Crossed Up: A Phillies Podcast,0,1,0,0,37,38
1365686897,Snow the Goalie: A Flyers Podcast,2,0,6,2,85,95
1365832190,Alpha Male Buddhist From Brooklyn Podcast,0,0,1,1,9,11
1365972671,Apple Bitz XL w/ Brian Tong,5,0,1,3,212,221
1366344369,Raising Boys & Girls,0,0,0,1,49,50
1366421088,Collider Ladies Night,0,0,0,0,57,57
1366430955,The Femsplainers Podcast,18,5,4,0,23,50
1366490788,Pull Up with CJ McCollum,11,2,8,6,192,219
1366556999,Medical Stuff,6,2,2,1,26,37
1366612500,MINDSET MAGIC & MANIFESTATION Podcast,5,0,2,2,37,46
1366633318,Moms Don’t Have Time to Read Books,3,0,0,0,49,52
1366956841,Unpacking the Power of Power Pack,0,1,0,0,14,15
1366994353,A Paranormal Chicks,9,2,12,8,276,307
1367002506,There Will Be Porn,0,0,0,0,12,12
1367139815,The Health Code,6,3,1,4,36,50
1367181499,The Damage Guild | A D&D Podcast,1,0,1,2,24,28
1367195038,Popcorn Psychology,2,1,0,2,48,53
1367201919,Deadline: White House,20,9,13,19,290,351
1367210511,The Matt Walsh Show,18,2,2,2,172,196
1367223433,The Daily Refresh with John Lee Dumas,1,0,0,0,34,35
1367224519,"Dietitian Boss with Libby Rothschild MS, RD, CPT",0,0,2,0,17,19
1367234288,This Sounds Serious,4,0,2,3,41,50
1367495532,Plane Tales,0,0,0,0,25,25
1367508002,First15 Devotional,1,4,2,5,173,185
1367527936,The Howie Carr Radio Network,3,1,1,1,56,62
1367672340,syzygy,0,0,0,0,2,2
1367736119,Voice of the Victim Podcast,17,6,10,10,117,160
1367773989,Plant Proof -  Evidence based nutrition,0,0,0,1,49,50
1367796922,Discography,1,0,1,6,42,50
1367830700,That One Time On Tour,0,0,0,0,50,50
1367963156,Eye On The Market,2,0,0,1,7,10
1367970103,X Factor Roping Podcast,0,0,0,0,15,15
1367974979,Hothouse,0,1,0,1,4,6
1368053574,Beltalowda - A Podcast for The Expanse,3,0,1,1,47,52
1368074491,Alabama Saltwater Fishing Report,0,0,0,0,91,91
1368081567,The Morning Toast,18,1,6,3,22,50
1368229783,The End of Time and Other Bothers,0,1,0,1,23,25
1368302862,Long Range Pursuit,2,1,2,2,35,42
1368388920,Darko.Audio podcast,2,0,1,2,9,14
1368482721,Stoicism On Fire,0,0,0,0,37,37
1368608676,Lost Notes,4,0,1,4,94,103
1368621724,A Better Peace: The War Room Podcast,0,0,0,0,2,2
1368653994,The Smart Communications Podcast,0,0,0,0,6,6
1368702869,Addiction Unlimited Podcast | Alcoholism | Life Coach | Living Sober | 12 Steps,3,1,1,2,43,50
1368713096,The Ticket Top 10,3,6,8,6,31,54
1368800817,Second in Command: The Chief Behind the Chief,1,0,1,0,45,47
1368888880,Young and Profiting,0,0,0,0,50,50
1368923477,Anime Cherry Bomb,0,0,0,0,1,1
1369206983,The College Football Daily,8,3,2,1,60,74
1369234298,4 Minute Bitcoin Daily News,0,0,0,0,5,5
1369291464,The Sales Hacker Podcast,0,0,0,0,24,24
1369344930,Non Toxic Environments Home Health & Wellness,0,0,0,0,30,30
1369393780,The Habitat,31,46,39,41,220,377
1369567177,GONE,10,8,6,5,21,50
1369617702,TuneDig,0,0,0,0,12,12
1369618540,The Big Honker Podcast,5,1,1,2,489,498
1369624840,Dad Bod Rap Pod,0,0,0,0,12,12
1369649995,Nutrition Coaching Secrets with Jason Phillips,0,0,1,0,10,11
1369719014,Jessie Lee is The People’s Mentor,0,0,0,2,198,200
1369766543,I'm In Love With That Song,0,0,0,0,18,18
1369840253,The Queer Eye Podcast,0,0,0,0,9,9
1369865534,We Need To Talk About Ghosts,3,0,0,3,97,103
1370020827,Anatomy On The Go,0,0,0,0,5,5
1370049232,Kubernetes Podcast from Google,1,0,0,0,8,9
1370092284,American Innovations,18,5,14,20,182,239
1370096738,The Wonderland Murders by Hollywood & Crime,51,38,42,22,131,284
1370122914,Coffee & Kettlebells,0,0,0,0,50,50
1370222496,All the Small Games with Andrew Levins and Jon Valenzuela,0,0,0,0,7,7
1370239824,"Center Stage, with Milfred and Hands",0,1,0,0,2,3
1370438585,Grilling JR,41,27,24,11,397,500
1370507232,Sunday Sitdown with Willie Geist,8,3,0,7,32,50
1370593823,"10,000 Swings - a Minnesota golf show by SKOR North",0,0,0,0,1,1
1370600165,Shit They Don’t Tell You with Nikki Limo and Steve Greene,10,1,0,2,37,50
1370614969,Bisimoto Tech2sDay,0,0,1,0,2,3
1370651486,The Bar Exam Toolbox Podcast: Pass the Bar Exam with Less Stress,1,0,0,2,20,23
1370718758,Match Point Canada,0,0,1,0,1,2
1370723809,"Sweathead, A Strategy Podcast",0,0,0,0,22,22
1370751593,Socialette: Bite-Sized Online Marketing Podcast,1,1,0,0,42,44
1370854773,The LEGO® Technic Podcast,0,0,0,1,10,11
1370982175,Mommy Millionaire,0,0,0,1,49,50
1370986675,Shop Girls on MyTalk,0,0,0,0,1,1
1370987327,Weekly Dish on MyTalk,0,0,0,0,3,3
1371006736,One CA,0,0,0,0,2,2
1371013717,Soberful,0,0,1,0,45,46
1371034395,Locked On Cardinals - Daily Podcast On The St. Louis Cardinals Podcast,4,0,2,3,14,23
1371141768,I Can't Believe That Happened History Podcast for Kids,1,0,0,1,2,4
1371371669,Let's Go Devils Podcast,1,1,0,1,5,8
1371403450,BDGE Fantasy Football,3,0,0,4,226,233
1371532256,How to Love Your Body,2,2,1,1,44,50
1371931450,Latinx Therapy,0,0,1,0,49,50
1371941505,The Southern Charm Podcast,4,0,1,0,40,45
1371964204,Warrior Kid Podcast,1,1,1,0,47,50
1372126575,Kalyn’s Coffee Talk,0,1,8,3,38,50
1372137894,Do It Scared® with Ruth Soukup,1,0,4,0,45,50
1372248881,Love Works with Nicole Moore,0,0,0,2,117,119
1372304901,The Voice of Louisiana Agriculture Podcast,0,0,0,0,2,2
1372323455,Who Cares About the Rock Hall?,0,2,2,2,42,48
1372347504,Malcom Reed's How To BBQ Right Podcast,0,0,0,0,33,33
1372359995,Regenerative Agriculture Podcast,0,0,1,2,26,29
1372478816,"The WealthAbility Show with Tom Wheelwright, CPA",3,3,0,0,52,58
1372481070,Tiny House Lifestyle Podcast,1,0,1,0,30,32
1372481697,Normalizing Non-Monogamy -  Interviews in Polyamory and Swinging,1,0,2,2,40,45
1372481853,Put Me Over Podcast,0,0,0,0,3,3
1372482057,40fit Radio,1,0,0,0,17,18
1372499952,Back To One,4,0,0,0,14,18
1372501679,The Buddy System Co.,0,0,0,0,2,2
1372613288,Worst Seats in the House w/ Michael Russo & Anthony LaPanta - Minnesota Wild Podcast,4,1,1,0,6,12
1372615640,7 Minute Stories w/ Aaron Calafato,0,0,0,0,48,48
1372616784,The Jon Krawczynski Show - Timberwolves Podcast,2,2,3,0,5,12
1372653524,Mystery Team Inc.,1,1,0,0,17,19
1372850008,Outspoken Beauty,0,0,1,0,6,7
1372879808,Deck The Hallmark,6,3,5,9,477,500
1372908592,The Very Serious Crafts Podcast,0,1,0,1,15,17
1372916618,NoBraking,0,0,0,0,7,7
1372957034,I'm Fat Podcast,1,0,1,0,85,87
1372974401,EDHRECast,2,0,0,0,48,50
1373312240,Weather Geeks,0,1,1,3,11,16
1373344935,"Research Insights, a Society of Actuaries Podcast",0,0,0,0,2,2
1373480705,Podcast – The Children's Hour,0,0,0,0,9,9
1373544251,Konor Knows Wrestling,0,0,0,0,3,3
1373572178,Underdog Empowerment,0,0,0,1,99,100
1373747429,The Shape of the World,0,0,0,0,6,6
1373752888,Center For Investment Excellence,0,3,0,0,1,4
1373805078,HER With Amena Brown,2,0,0,0,24,26
1373812661,Behind the Bastards,104,39,46,45,266,500
1373926216,The Place We Find Ourselves,1,2,0,1,122,126
1373931273,"Dice, Camera, Action! – An Official Dungeons & Dragons Podcast",2,1,2,5,22,32
1374007222,Master Passive Income Real Estate Investing in Rental Property,1,5,2,0,26,34
1374027962,The Alternative Investor,0,0,0,0,48,48
1374120281,SladyBoss Radio,0,0,0,0,78,78
1374129288,Podcasts With Park Rangers - A National Parks Podcast,0,0,0,0,17,17
1374373035,Social Proof Podcast,0,0,0,1,77,78
1374560860,The Daily Dive,4,2,0,1,4,11
1374597671,3 Point Perspective: The Illustration Podcast,1,2,2,8,179,192
1374647284,Thriving In Motherhood Podcast,0,0,1,1,48,50
1374716199,Private Practice Success Stories,0,0,0,1,4,5
1374814595,Tacos and Tech Podcast,0,0,0,0,2,2
1374910857,Frugal Friends Podcast,10,6,2,0,182,200
1374942074,Diet Starts Tomorrow,9,3,10,5,23,50
1375263468,Classic Movie Musts,8,2,2,2,267,281
1375287456,Jemjammer,0,0,0,0,5,5
1375339408,You Can’t Make This Up,28,13,8,4,56,109
1375590441,This Week in Linux,1,0,0,0,2,3
1375630453,Inside Trader Joe's,7,2,5,6,180,200
1375676407,The Fallon Taylor Podcast,1,0,0,1,48,50
1375700198,The Shakespeare Sessions,0,0,0,0,4,4
1375714621,Unnecessary Roughness,64,15,16,13,160,268
1375719994,Barstool Confessions,5,1,1,4,196,207
1375765256,Idaho Matters,1,0,1,0,5,7
1375871959,That's Awesome with Steve Burton & Bradford Anderson,0,1,2,8,348,359
1375877915,The Dave Chang Show,8,0,5,4,482,499
1376033669,Mic Drop from CBC Podcasts,0,0,0,0,6,6
1376034481,The Woody Allen Retrospective Podcast,2,0,0,1,2,5
1376100054,The Pam Sowder Podcast,0,0,0,0,7,7
1376100839,Badass Manifester Podcast,0,0,2,1,99,102
1376106678,The Lance Wallnau Show,0,0,0,2,10,12
1376303362,Behind the Money,1,0,1,0,10,12
1376384137,Bad Science,7,6,0,1,81,95
1376412132,Androids & Aliens,0,1,0,2,47,50
1376577202,Decoder Ring,14,5,7,11,120,157
1376577916,Dear Joan and Jericha (Julia Davis and Vicki Pepperdine),14,4,8,8,287,321
1376641140,Eagle Eye: A Philadelphia Eagles Podcast,8,5,2,6,101,122
1376688021,Everything Under the Sun,0,0,1,0,4,5
1376784774,Deadbeats Radio with Zeds Dead,0,0,0,0,15,15
1376842008,"Sex, Love, and Addiction",2,0,0,1,14,17
1376884817,Design Thinking 101,0,0,0,0,2,2
1376929139,This Jungian Life,1,0,2,1,46,50
1377207293,Upchukar Podcast,3,0,1,0,39,43
1377247052,The FEMA Podcast,1,1,0,0,2,4
1377422544,Sr Plus,0,0,0,0,2,2
1377448815,Quicktake by Bloomberg,2,1,0,0,6,9
1377471911,Replicon radio,0,0,0,0,5,5
1377478658,Generation V,0,0,0,0,50,50
1377498224,From the Wastes...,0,0,0,0,5,5
1377843908,The Weirdest Thing I Learned This Week,31,13,24,15,296,379
1377854858,What Would My Shrink Say?,0,0,0,2,39,41
1377869557,Phoenix Radio,1,0,0,1,12,14
1377919407,Sex for Saints,0,0,0,1,49,50
1378040733,Nothing much happens; bedtime stories to help you sleep,3,9,6,12,258,288
1378291519,Secrets to Marketing your Wellness MLM,3,0,0,0,37,40
1378325120,cpp.chat,1,2,0,0,0,3
1378389941,Uncommon Knowledge,2,3,1,1,38,45
1378433981,Talent Development Hot Seat,0,0,1,1,65,67
1378436227,NDE Podcast,4,3,5,3,86,101
1378518168,Blue Collar Bourbon,0,1,0,0,18,19
1378618386,Crazy/Genius,6,6,3,6,67,88
1378621306,Whine Down with Jana Kramer and Michael Caussin,84,37,27,24,328,500
1378639998,Weirdly Magical with Jen and Lou - Astrology - Numerology - Weird Magic - Akashic Records,1,0,0,2,39,42
1378662885,The Keys and Anklets Podcast,1,1,1,3,19,25
1378670805,Tech Buzz China by Pandaily,1,0,3,2,62,68
1378685290,Business Unusual with Barbara Corcoran,1,0,1,5,186,193
1378693754,California Now Podcast,0,0,1,0,9,10
1378725018,The Holderness Family Podcast,1,0,1,0,48,50
1378763987,Happier & Healthier with Maria Marlowe,1,0,0,1,48,50
1378774536,Master Self Love,1,0,0,0,4,5
1378801806,Find the Path Podcast,0,2,0,1,47,50
1378862255,Saving Sex and the City 3,0,0,0,1,49,50
1379018341,Love Sober Podcast,0,0,0,0,4,4
1379040585,The Dallas Morning News,2,1,2,0,5,10
1379050662,The Genius Life,1,0,0,0,49,50
1379856848,Blanchard LeaderChat,0,0,0,0,16,16
1379928882,Talk Murder To Me,10,3,1,1,485,500
1379942034,The Colin and Samir Show,1,0,0,0,54,55
1379959217,Morbid: A True Crime Podcast,162,66,48,38,656,970
1380008439,You're Wrong About,114,62,54,46,714,990
1380012146,C**t Talk,1,0,0,1,48,50
1380237302,Let's Get Metaphysical,1,0,0,0,11,12
1380244364,NEJM Resident 360 - Curbside Consults Podcast,1,0,0,2,10,13
1380252026,Couples Therapy with Candice and Casey,37,16,18,19,410,500
1380281467,83 Weeks with Eric Bischoff,1,2,6,1,48,58
1380303490,Not Real Art,0,0,0,0,24,24
1380328220,SportsTalk Mississippi,1,0,0,0,3,4
1380336613,The Trade Guys,3,0,2,1,11,17
1380372501,Rick & Bubba Show,1,0,0,2,47,50
1380536578,The Goal Digger Girl's Podcast,0,0,0,2,38,40
1380538707,The Cryptonaturalist,0,0,0,0,9,9
1380554029,Car Ride Stories for GIGI Kids - christian stories for kids,0,0,0,0,3,3
1380588512,How I Survived,0,2,5,2,48,57
1380732480,New Construction Marketing Podcast,0,0,0,0,9,9
1380995935,The Movement System podcast,0,0,0,0,11,11
1381228499,Crrow777Radio.com,5,0,1,3,39,48
1381257272,Broken Brain with Dhru Purohit,2,0,3,5,40,50
1381507437,Unspooled,63,44,43,30,300,480
1381529961,The Thriving Christian Artist,0,0,0,1,124,125
1381546475,Kyle Meredith With...,0,0,0,0,7,7
1381561571,WorkWell,0,0,1,0,10,11
1381606551,Weird Science Marvel Comics,2,1,0,0,26,29
1381616065,Queens of Adventure,0,0,0,0,50,50
1381777751,Get Your Fit Together The Podcast,0,0,0,0,50,50
1382010337,Mind Body Medic,0,0,0,0,9,9
1382078279,The Crown Podcast,10,7,2,1,4,24
1382118155,The Handmaid's Tale Podcast,5,2,5,1,2,15
1382244741,Committed,26,15,17,9,152,219
1382371884,Green Dreamer: Sustainability and Regeneration From Ideas to Life,1,0,2,1,114,118
1382407225,Free Cookies,1,0,2,2,165,170
1382421636,Dialed Podcast,0,0,0,1,16,17
1382438394,Locked On Braves - Daily Podcast On The Atlanta Braves,6,0,2,0,10,18
1382453932,Salt & Spine,2,1,0,0,27,30
1382490464,SelfishBabe SelfishTalk Podcast,0,0,0,0,50,50
1382789861,Smash Boom Best,1,1,0,4,44,50
1382804627,"The Doctor's Farmacy with Mark Hyman, M.D.",36,24,36,14,88,198
1382898254,Psychcast,0,0,0,0,6,6
1382983397,Why Is This Happening? with Chris Hayes,53,6,21,24,396,500
1383143636,The Backwoods Radio Show,0,0,0,0,16,16
1383270948,Strong By Design Podcast,1,0,0,1,48,50
1383315809,Feed Your Wild with Venessa Rodriguez,1,0,1,0,48,50
1383377400,Self-Care for Extremely Busy Women,0,0,0,0,20,20
1383382893,Sound Only,15,8,6,1,29,59
1383546363,We Drink And We Know Things,0,0,0,0,50,50
1383597541,What A Rush with Road Warrior Animal,0,0,0,0,9,9
1383599078,"New Mindset, Who Dis?",2,0,0,1,47,50
1383766697,We Are West Ham Podcast,1,0,0,0,1,2
1383848680,The Fall Podcast,0,0,0,0,22,22
1384009171,Healthy Hormones for Women Podcast,0,1,1,1,43,46
1384259595,The Greatest Season That Was Presents...,0,0,0,0,1,1
1384301001,Earth911.com: Sustainability In Your Ear,1,1,0,0,1,3
1384305390,Kinks with KeKe,0,1,1,0,5,7
1384360585,The Black Love Podcast,0,0,0,0,3,3
1384454323,The Young n Muslim Podcast,0,0,0,0,27,27
1384508634,The Modern Manager: Create and Lead Successful Teams,0,0,0,0,21,21
1384622194,On the Job with PORAC,0,0,0,0,5,5
1384657797,Mule Deer Foundation - Talking Mule Deer Podcast,0,0,1,2,2,5
1384700179,Room 77 | Podcast: A Swinger Podcast,5,1,0,1,43,50
1384700781,Hungry Girl: Chew the Right Thing!,5,2,4,2,187,200
1384767525,R2C2 is UNINTERRUPTED,5,1,3,6,436,451
1384819415,my millennial money,7,2,3,0,81,93
1384867713,Failed Architecture,0,0,0,0,1,1
1385018796,Kaleidotrope: A Romantic Comedy,2,3,0,2,19,26
1385048193,Confessions of a Bikini Pro,0,1,1,0,48,50
1385062988,Noclip,0,0,1,1,32,34
1385118894,Best In Faction,3,0,1,2,23,29
1385121981,Himeros LIVE,4,1,0,1,11,17
1385379989,The Teacher's Pet,74,10,0,12,80,176
1385666070,Dead End Hip Hop,0,0,0,0,5,5
1385696878,Voice of Design,0,0,0,1,0,1
1385700943,ZigZag,7,6,6,10,171,200
1385741676,Hockey Training: Become a Better Hockey Player,0,1,0,0,24,25
1385864210,Dodgers Nation: Blue Heaven Podcast,4,1,3,1,42,51
1385908352,Zoo Logic,1,0,0,0,7,8
1385935323,Cars of Carlisle,1,1,0,0,23,25
1385995581,Squiz Today,2,1,3,3,86,95
1386234384,Snacks Daily,133,25,21,8,313,500
1386375601,The Ben Ferguson Podcast,2,0,0,0,48,50
1386400008,Real Estate Disruptors,0,0,1,1,188,190
1386449666,Tom Fitton's Weekly Update Podcast,8,1,2,6,33,50
1386501897,Good Nurse Bad Nurse,3,1,0,2,37,43
1386509499,Dark Ages,0,0,0,0,27,27
1386552794,Speak Up Storytelling,0,1,0,4,94,99
1386630867,The Blaque Tea,5,2,3,2,35,47
1386740882,Tavern Chat,0,0,0,0,5,5
1386771685,ESPNcricinfo Stump Mic Podcast,0,0,0,0,3,3
1386867488,The Symbolic World,0,1,2,0,16,19
1386870428,World Stealers,0,0,0,0,10,10
1387197359,Young Ben Franklin,2,0,1,6,41,50
1387315411,Big Dogs,0,1,0,2,47,50
1387325985,Art and Labor,0,2,0,0,13,15
1387339234,Big Blue Banter: A New York Giants Football Podcast,6,1,3,6,239,255
1387347630,"Leadville: The 100 Mile Mountain Bike Race Podcast, p/b Floyd's of Leadville",0,0,1,0,38,39
1387529624,Two Psychologists Four Beers,1,0,1,0,20,22
1387534637,The Boardroom Podcast,2,0,1,1,13,17
1387670973,Inside Jaws,27,18,21,5,115,186
1387729710,The Uncle Hack Podcast,0,0,0,0,5,5
1387844794,Yoga Teacher Resource Podcast,0,0,0,0,77,77
1387919501,AMERICA'S DOCTOR: The Dr. Oz Podcast,15,1,3,2,29,50
1388002934,The Cosmic Calling,2,0,1,2,88,93
1388130977,Wabi Sabi - The Perfectly Imperfect Podcast with Candice Kumai,0,0,0,2,48,50
1388339671,The USA Weightlifting Podcast,0,0,3,0,17,20
1388494261,Talking Bay 94: Star Wars Interviews,0,0,0,0,50,50
1388517902,Wicked Funny Podcast,0,0,0,0,30,30
1388568002,Codex History of Video Games with Mike Coletta and Tyler Ostby,0,0,1,1,48,50
1388645349,Covert,3,1,3,7,36,50
1388743215,The Good Place: The Podcast,1,0,2,7,149,159
1388761048,Branch Out,0,0,0,0,1,1
1389067304,Earn Your Edge: Decoding Excellence in Golf & Life,0,0,0,0,134,134
1389482015,The Busby Babe: for Manchester United fans,1,0,1,0,2,4
1389626473,Art Class Curator,1,0,0,0,2,3
1389735268,Tales from the Aletheian Society,1,0,0,0,3,4
1389858029,The Michigan DNR's Wildtalk Podcast,0,0,0,0,6,6
1389938599,StarTripper!!,0,1,0,2,47,50
1389951701,The Impossible State,3,1,0,0,7,11
1389955443,True Stories of Good People,0,0,1,3,49,53
1389967499,Fire & Smoke,0,0,0,0,4,4
1390040982,Highlights Hangout,11,4,6,11,18,50
1390128131,The Create! Podcast,1,0,0,1,43,45
1390179599,Baseball Cards Daily,0,0,0,2,48,50
1390616261,Monster Porn: Weird Fiction & Horror Podcast,0,1,2,1,46,50
1390655167,The Good Words Podcast,2,0,0,0,26,28
1390684172,The Awake With Jake Show,0,0,0,1,49,50
1390707588,Music History Monday,0,0,0,0,5,5
1390944329,The Critshow,0,0,0,0,50,50
1390954299,The Military Leader Podcast,2,0,1,0,26,29
1391004216,Mortgage Marketing Expert,0,1,0,0,16,17
1391234259,Gossip,1,3,2,2,192,200
1391255389,The Taekcast: A (mostly) Sports Podcast,7,0,2,3,345,357
1391402772,MLR Kickoff,0,0,0,0,18,18
1391441620,Bubble,1,0,2,0,47,50
1391483100,Sinisterhood,1,1,1,2,45,50
1391657450,Full Marx - A Marx Bros. Podcast,0,1,0,1,11,13
1391782679,The Control Group,3,2,7,3,35,50
1391881620,Woke & Wired - Expanded Consciousness and Entrepreneurship,1,0,0,1,48,50
1391915810,Hacking Humans,1,0,0,1,33,35
1391933145,Row by Row Garden Show,0,0,0,0,3,3
1392010699,Ask Father Josh (Your Catholic Question and Answer Podcast),1,0,2,3,220,226
1392199580,Dispatches from the Multiverse,0,0,0,0,9,9
1392658815,The Left Brain Artist,0,0,0,0,16,16
1392662714,Awesemo Daily Fantasy,4,2,2,2,137,147
1392745950,It's Haunted...What Now?,2,3,5,3,37,50
1392813061,The Road Home with Ethan Nichtern,0,0,0,0,5,5
1392963885,Let's Get Running Podcast,0,0,0,0,1,1
1393106083,Nerdin Out,2,0,4,2,87,95
1393127287,eCommerce Lifestyle,1,0,0,0,41,42
1393141671,Growing the Valley,0,0,0,0,3,3
1393165127,Teachers Need Teachers,0,0,0,0,31,31
1393220238,Rabbi Daniel Lapin's podcast,0,0,0,0,5,5
1393232694,Meru Media,0,0,0,0,1,1
1393265937,"Peak Human - Unbiased Nutrition Info for Optimum Health, Fitness & Living",3,0,0,1,46,50
1393392658,The /r/Anime Podcast,0,0,0,0,3,3
1393713828,Bell to Bell with Bobby Blaze,0,0,0,0,13,13
1393739959,The TASTE Podcast,0,0,0,1,15,16
1393830225,Magic King Dom,2,0,0,0,12,14
1393858741,Cuomo Prime Time with Chris Cuomo,17,2,3,1,27,50
1393861303,Casting Actors Cast,0,0,0,0,16,16
1393867566,The IBJ Podcast,0,0,0,0,1,1
1393911268,What We Said,18,5,4,10,463,500
1394082326,The Janet Jackson Podcast,0,0,0,0,27,27
1394082967,Voices of Wrestling Flagship,0,0,0,1,3,4
1394205032,Pure Skin Talk,0,0,0,2,48,50
1394207706,Reptile n Chill Podcast,0,0,0,0,1,1
1394560607,The Revival Motoring Podcast,0,0,0,0,50,50
1394634381,Sox In The Basement,2,1,0,0,21,24
1394657453,Litzenberger's Sailing Podcast,0,0,0,0,49,49
1394669923,Horror Movie Club,2,2,3,3,44,54
1394742573,The VBAC Link,0,0,0,2,48,50
1395020956,Help for Hashimotos podcast,3,0,0,0,16,19
1395029852,The Quilt Fiction Podcast,0,0,0,0,50,50
1395236879,Ranks FC,0,0,0,1,56,57
1395443141,Engine Noise Podcast,0,0,0,0,50,50
1395495167,With Warm Welcome,0,0,0,1,3,4
1395694681,bluemind ASMR,2,0,1,3,44,50
1396058631,Hard Factor,17,4,2,4,473,500
1396070359,Sam's Army,14,12,3,5,227,261
1396139984,The Women of Illustration Podcast,2,1,2,1,17,23
1396254711,The Gerry Anderson Podcast,0,0,0,1,30,31
1396286340,The Sisterhood Podcast,1,0,2,3,97,103
1396347980,The Black Scholars Podcast,0,0,0,1,11,12
1396353716,The Blunt Report,0,0,0,0,4,4
1396508525,The McCarthy Report,42,18,9,11,270,350
1396524879,De Derde Helft - Eredivisie,0,0,0,0,1,1
1396546917,Aaron Mahnke's Cabinet of Curiosities,3,0,2,5,40,50
1396570035,Enlightened By Dogs with Kathy Kawalec,0,0,0,1,35,36
1396584525,All in a Homeschool Day,0,0,0,0,10,10
1396643434,Straight from the Horse Doctor's Mouth,0,0,0,0,21,21
1396697981,The Bonfire with Big Jay Oakerson and Dan Soder,1,0,0,1,48,50
1396757201,Joe Rogan Experience Review podcast,34,0,1,0,19,54
1396860372,For the Love of Climbing,1,1,0,1,237,240
1397042613,Remote Ruby,0,0,0,0,3,3
1397135764,Dungeon Fables,0,0,0,1,49,50
1397177283,Saturday Morning D&D Show!,0,0,0,0,6,6
1397177307,Sports Gambling Podcast Network,6,1,0,2,144,153
1397188193,This Had Oscar Buzz,3,6,9,7,131,156
1397209446,The Food Medic,7,1,1,2,84,95
1397247771,Your Queer Story: An LGBTQ+ Podcast,0,0,0,0,19,19
1397273982,Mile Marker 181,218,46,42,33,161,500
1397427305,The Lebo Lion Podcast,0,0,0,2,9,11
1397585538,Coming Out with Lauren & Nicole,0,0,1,0,49,50
1397898498,The DigitalMarketer Podcast,0,1,0,1,48,50
1397914186,Spirit Dog Training Podcast,0,0,0,0,14,14
1397924687,Anything Goes with James English,8,1,2,2,74,87
1397963631,About The Cards,0,1,0,1,18,20
1398024769,Green Rush Podcast,1,0,1,1,18,21
1398126760,Throwin' Wrenches Automotive Podcast,0,0,0,0,10,10
1398144394,Rabbi Moshe Weinberger,0,0,0,0,1,1
1398261897,The Basketball Podcast,0,0,0,1,34,35
1398308821,The Horror Virgin,13,10,4,9,332,368
1398347231,PROFIT AND BEAUTY: A Show For Salon Professionals,0,0,0,0,1,1
1398380268,The Joyful Mourning - A Podcast for Women Who Have Experienced Pregnancy or Infant Loss,0,0,0,0,35,35
1398452484,The Witch Bitch Amateur Hour,3,0,2,1,261,267
1398644299,Causepods,0,0,0,0,8,8
1398667202,The Off The Hop Rope Podcast,1,0,1,0,43,45
1398685234,Social Studies,0,0,0,0,50,50
1398691433,The Timeline: A Phoenix Suns Podcast,1,1,0,0,46,48
1398741252,The CRA Podcast with Linda Ezuka,0,0,0,0,1,1
1398753375,Silent Waves,2,4,1,0,58,65
1399009172,Life of an Architect,2,0,1,0,43,46
1399017536,The Jon Taffer Podcast,8,1,1,4,66,80
1399025196,Hysteria,52,37,26,27,358,500
1399030864,That Fallout Show,1,0,0,0,49,50
1399040612,Roots and All - Gardening Podcast,0,0,0,0,5,5
1399053564,Aftereffect,1,2,1,2,37,43
1399159890,The Fitnessista Podcast: Healthy In Real Life,2,1,0,1,46,50
1399177286,The Dane Moore NBA Podcast,3,0,0,2,59,64
1399188573,The David Rubenstein Show,0,1,0,0,1,2
1399330153,The SSR Podcast,0,0,1,1,107,109
1399376631,Pure Hustle Podcast,1,0,1,1,85,88
1399377895,NIGHTLIGHT: A Horror Fiction Podcast,2,1,0,1,46,50
1399378791,Mastering Blood Sugar,1,0,0,1,48,50
1399485424,The Misfits Podcast,0,0,1,0,49,50
1399630680,First Bite: A Speech Therapy Podcast,2,1,0,0,47,50
1399714847,You Up with Nikki Glaser,9,2,2,5,32,50
1399808230,The Process - Sports Recruiting Podcast,0,0,1,1,2,4
1399904994,Controlled Aggression,0,0,1,0,23,24
1399962220,The 443 - Security Simplified,0,0,0,0,2,2
1399969550,Fitness Motivation,0,0,0,3,37,40
1400046208,When in Spain,0,0,0,0,27,27
1400082430,Clear+Vivid with Alan Alda,7,0,7,7,173,194
1400088257,Just Roll With It,0,1,0,1,48,50
1400296642,Film Stories with Simon Brew,0,0,0,0,15,15
1400388997,Baseball & Chill,0,4,1,1,76,82
1400390579,The Latinos Radio Show,0,0,0,0,1,1
1400458362,What We're Tasting,0,0,0,0,1,1
1400547533,MAKE SPACE with Cara Newhart // Home Design + DIY,0,1,1,0,35,37
1400562667,Rosemary’s Ladies: A Horror Movie & Bad Movie Review Podcast,0,1,1,1,42,45
1400597241,Stars and Stripes FC: for fans of USA soccer,0,0,2,0,2,4
1400603504,Wild And Exposed Podcast,0,0,0,0,44,44
1400662665,Urgent Care Basics,1,0,0,0,6,7
1400686733,Physics World Weekly Podcast,0,0,1,0,1,2
1400794852,Ham Radio Crash Course,3,0,2,3,139,147
1400828889,The Peter Attia Drive,3,2,5,1,39,50
1400926647,Gaslit Nation with Andrea Chalupa and Sarah Kendzior,29,15,20,22,338,424
1400988016,"Get Paid: Fantasy, Gambling and DFS",0,0,0,3,16,19
1401061816,The Rabbi Manis Friedman Podcast,0,0,0,0,3,3
1401495860,Standing Post,0,1,0,3,21,25
1401499962,Edifi With Billy Hallowell,0,0,1,0,2,3
1401499990,Today With Jared James,0,0,0,1,36,37
1401506541,The Mineral Rights Podcast: Mineral Rights | Royalties | Oil and Gas | Matt Sands,0,0,0,0,12,12
1401508198,High Rollers DnD,2,1,2,5,40,50
1401612782,Sales Leadership Podcast,0,0,0,0,17,17
1401673317,Spiritual Boss Babe with Stephanie Bellinger,1,0,0,0,59,60
1401810669,Marketing Geeks,2,5,4,0,38,49
1401950194,The Proffitt Podcast,0,0,0,1,34,35
1402043842,They Called This a Movie,0,0,0,0,2,2
1402257437,Everyday Buddhism: Making Everyday Better,1,2,2,2,16,23
1402310626,VinePair Podcast,2,2,6,3,16,29
1402329658,From The Tips,0,0,0,0,6,6
1402329684,A Sober Girls Guide,0,2,1,2,28,33
1402359431,Australian Aviation Podcast Network,0,0,0,0,1,1
1402378177,The Bulletproof Musician,0,0,0,0,7,7
1402381306,Latest In Tech News,0,0,0,0,2,2
1402634817,SquaMates,0,0,0,0,14,14
1402680092,Honest HR: A Podcast from SHRM Spilling HR Truths,1,2,2,1,3,9
1402749634,Beekeeping Today Podcast,1,0,0,1,15,17
1402764168,The Stokecast,0,3,0,2,76,81
1402774310,Access and Opportunity with Carla Harris,0,0,0,0,21,21
1402868957,The Industry,0,0,0,1,25,26
1402903701,Elk Talk,9,5,4,6,117,141
1402924118,"Books Closed: Tattoos and the Internet Collide, Hosted by Andrew Stortz",0,0,0,0,67,67
1403034618,The Laws of Style,0,0,0,0,1,1
1403064308,Hannah and Erik Go Birding,0,1,0,2,35,38
1403189802,History of the World podcast,0,0,0,1,49,50
1403202032,The Bitcoin Standard Podcast,0,0,0,0,10,10
1403363121,The Goodman & Hummel Basketball Podcast,0,0,0,2,30,32
1403428143,History in Technicolor,2,0,0,1,14,17
1403498266,House of Kim with Kim Zolciak,140,11,29,30,290,500
1403561531,Throwing Sheyd,0,0,0,1,5,6
1403562732,Symantec Cyber Security Brief Podcast,0,0,0,1,0,1
1403578549,Self Improvement Daily,0,0,0,1,38,39
1403616027,The Flower Podcast,0,0,0,2,43,45
1403684827,Online Business Building Mamas,0,0,0,1,20,21
1403815619,Daily Emunah Podcast - Daily Emunah By Rabbi David Ashear,0,0,0,0,5,5
1403955889,The WellBe Podcast (getwellbe),0,0,0,0,50,50
1403958345,Manger,0,0,0,0,2,2
1404096650,Design Biz Survival Guide,0,0,0,0,8,8
1404167309,Breaking Through,0,0,0,0,16,16
1404310722,Vortex Nation Podcast,0,1,0,7,492,500
1404380126,This Day in History Class,5,6,5,6,28,50
1404416537,All Things Sensory by Harkla,0,2,0,1,47,50
1404469170,Rekt Podcast: Bitcoin and Cryptocurrency Fun,4,0,0,0,22,26
1404513588,Comic Book Workshop | A Podcast About Making Comics,0,0,0,0,11,11
1404548949,WorkParty,1,2,2,2,27,34
1404576606,Spitballers Comedy Podcast,0,0,0,1,49,50
1404578385,The Brainy Business | Understanding the Psychology of Why People Buy | Behavioral Economics,1,0,1,2,43,47
1404648578,Dynasty War Zone,2,0,0,1,106,109
1404667823,Light The Fuse - A Mission: Impossible Podcast,0,0,0,1,69,70
1404712945,ChasmQuest: a DND 5e Actual Play Podcast,0,0,0,1,49,50
1404726820,The Rookie Fever Podcast,0,0,1,0,15,16
1405001555,The Arthur Brooks Show,2,5,2,0,52,61
1405036377,The Sunday Scaries Podcast,2,2,2,1,43,50
1405059214,East Meets West Hunt,0,0,1,1,144,146
1405070645,That Metal Podcast,0,0,0,0,5,5
1405147985,Goldie On Ice Podcast,0,0,0,0,11,11
1405212692,"Game-Changing Predictive Machine Learning, Presented by SAP",0,0,1,0,0,1
1405332786,Locked On Vols - Daily Podcast On Tennessee Volunteers Football & Basketball,4,1,6,0,141,152
1405333272,The Big Little Lies Podcast,4,5,1,1,4,15
1405341424,The Treasury Update Podcast,0,0,0,1,17,18
1405629617,Daily Inspiration: The Steve Harvey Morning Show,0,0,2,0,38,40
1405655817,Bass University Live,0,0,0,0,13,13
1405703428,P.U.C.L. Plus -More of P.U.C.L. a Pokemon Podcast,0,0,0,0,8,8
1405797630,Photography Daily,0,0,0,0,6,6
1405950854,NZ Everyday Investor,0,0,0,1,17,18
1405972616,F1: Beyond The Grid,2,0,3,6,217,228
1406004700,art for all,1,0,0,0,28,29
1406088965,Style Masterclass,0,0,0,0,10,10
1406150278,Passion City Church DC Podcast,0,0,1,2,43,46
1406152548,Recovery Happy Hour,1,1,0,0,48,50
1406156285,MAKE IT,0,0,0,0,6,6
1406162195,A World Where,0,0,0,0,19,19
1406174660,Catholic Sprouts: Daily Podcast for Catholic Kids,2,0,0,0,47,49
1406195985,CritterCast,0,0,0,0,22,22
1406222390,Growing Patriots,0,0,0,0,7,7
1406231151,Sacred Symbols: A PlayStation Podcast,3,3,3,1,40,50
1406364168,Automators,0,0,0,1,16,17
1406443091,The Rick Shiels Golf Show,2,3,3,2,89,99
1406534739,"Sean Carroll's Mindscape: Science, Society, Philosophy, Culture, Arts, and Ideas",9,6,4,7,202,228
1406537385,Practical AI: Machine Learning & Data Science,1,0,0,1,8,10
1406646456,Chat It U.P. Podcast,0,0,0,0,12,12
1406730235,3 Things,3,0,4,6,16,29
1406834876,"This Particular Album is Very, Very Important to Me",0,0,0,0,39,39
1406837915,On Purpose With Alex Beadon,0,1,0,2,47,50
1406939454,The Bitcoin.com Podcast,0,0,0,0,5,5
1407001199,The Scene Vault Podcast,0,0,0,1,49,50
1407015487,Big Woods Bucks - Deer Hunting -Education & Entertainment,0,0,1,0,52,53
1407041447,Remember The Game? Retro Gaming Podcast,0,0,0,0,19,19
1407056689,Hot Ones: The Classic Interviews,0,0,0,0,10,10
1407064117,"The Black Vault Radio - Hosted by John Greenewald, Jr.",7,2,0,0,26,35
1407320921,The Simplicity Parenting Podcast with Kim John Payne,1,0,0,0,8,9
1407378924,Know Before You Go Travel Show,0,1,0,1,29,31
1407404772,Philip's Apocalypse,0,0,0,1,7,8
1407451189,How To Fail With Elizabeth Day,4,0,2,4,184,194
1407471024,Encounters: A Paranormal Experience,1,0,0,0,18,19
1407481308,Rise Together Podcast,13,3,2,2,30,50
1407484038,The J. S. Bach Files Podcast,0,0,0,0,1,1
1407511382,The Accad and Koka Report,0,0,0,0,9,9
1407584532,BatFlip Crazy Fantasy Baseball,1,1,0,0,98,100
1407606863,"Ghost Town: Strange History, True Crime, & the Paranormal",9,7,4,6,24,50
1407689929,Les Ptites Histoires,0,0,0,0,2,2
1408082097,Build Casters: A Gundam Podcast,0,0,0,0,1,1
1408102830,Earth Rangers,2,0,2,6,40,50
1408141817,Negotiate Your Best Life Podcast with Rebecca Zung,0,2,0,0,48,50
1408585620,Films To Be Buried With with Brett Goldstein,0,0,0,0,53,53
1408740329,Race Chaser with Alaska & Willam,25,16,28,15,416,500
1408807580,"The Vibrant Music Teaching Podcast | Proven and practical tips, strategies and ideas for music teach...",0,0,0,0,11,11
1408856271,Bodies,6,1,2,0,41,50
1408859036,LawNext,0,0,0,1,12,13
1408882599,The DriveTribe Podcast,1,2,0,1,1,5
1408900880,BC the Beatles,0,1,0,1,25,27
1408958605,The News & Why It Matters,14,3,14,7,458,496
1408959075,Crain's Daily Gist,0,0,0,2,4,6
1409087641,What Was That Like,4,1,1,0,48,54
1409173457,Marriage and Martinis,9,6,6,4,355,380
1409245195,WDW Opinion - A Weekly Podcast About Walt Disney World,0,0,1,0,35,36
1409394887,We Need to Talk About Britney,8,5,4,2,40,59
1409420546,The Speech Link: A Speech Therapy Podcast,0,0,0,0,7,7
1409477830,The Vintage RPG Podcast,2,0,1,1,33,37
1409479503,Commune with Jeff Krasno,1,2,4,4,35,46
1409480698,Creature Feature,21,7,4,7,123,162
1409481160,Unobscured,2,3,4,2,39,50
1409526269,Kings of the Ring,0,1,0,1,5,7
1409735368,The Logistics of Logistics Podcast,0,0,0,0,3,3
1409801789,Comments by Celebs,26,14,18,10,432,500
1409930361,Minnesota DNR Prairie Pod,0,0,1,0,10,11
1410001074,While Black,17,0,2,3,28,50
1410298175,Rheuminations,0,0,0,0,10,10
1410549811,The FORT with Chris Powers,1,0,1,0,55,57
1410611499,Nobody Listens to Paula Poundstone,4,1,2,2,41,50
1410627754,Dirt Church Radio,0,0,0,0,1,1
1410824985,The Kelli Show,1,0,2,1,309,313
1410835265,Black Hills Information Security,0,0,0,0,1,1
1410850518,Financial Freedom Podcast,0,0,0,4,46,50
1410851204,Learn Italian with Italy Made Easy,0,0,0,0,9,9
1410858264,Ultrarunning History,0,0,0,1,10,11
1411126232,The Bold and Beautiful Podcast,1,0,0,0,3,4
1411373799,The Big Story,0,0,0,0,1,1
1411444847,The Psoriasis Geek Podcast,0,0,0,0,1,1
1411446648,Business Wars Daily,8,7,4,5,25,49
1411527439,Write-minded Podcast,1,0,0,3,119,123
1411527800,HORSE,1,1,1,1,49,53
1411567786,Innerbloom Podcast,1,1,1,1,103,107
1411700356,Project Woo Woo,0,0,0,0,21,21
1411706853,No Mercy Podcast,49,9,4,8,430,500
1412068550,"Real Happy Mom Podcast - Time-Management, Gentle Parenting, & Self-Care Strategies for the Busy Work...",0,0,0,1,26,27
1412094313,The Movies That Made Me,4,1,5,9,57,76
1412142989,Chicks in the Office,34,15,24,19,408,500
1412162689,Axios Re:Cap,6,4,9,2,29,50
1412164187,Law Firm Autopilot,0,0,0,0,34,34
1412191409,Marvel's Pull List,3,1,1,1,2,8
1412305413,Lessons from a Quitter,0,0,1,0,98,99
1412385746,Dr. Chapa’s Clinical Pearls.,0,1,0,0,1,2
1412477167,Homeschooling Outside the Box,0,0,0,0,1,1
1412479463,Relationship Psych | Love | Marriage | Conflict | Psychology |,2,0,0,1,117,120
1412528674,Black History Buff Podcast,0,0,0,0,35,35
1412570127,Hey Riddle Riddle,0,0,0,0,50,50
1412600833,ibn abee omar,0,0,0,0,3,3
1412679965,Tennish,0,0,0,0,7,7
1412807581,Mothers of Invention,0,0,1,1,28,30
1412813382,Reducing Crime,0,0,0,0,3,3
1412834587,Seek Treatment with Cat & Pat,0,2,2,1,45,50
1412849921,The Disney Dish with Jim Hill,4,0,0,3,62,69
1412905534,The Michael Steele Podcast,14,3,13,29,157,216
1412947410,The BBQ Central Show,1,0,1,1,23,26
1413153126,The Stickbow Chronicles- Traditional Bowhunting Podcast,0,0,0,1,81,82
1413228088,Last Seen,7,4,16,14,203,244
1413255721,Beyond The Valley,0,0,0,0,1,1
1413316512,A’s Plus,0,0,0,0,24,24
1413333566,Tara Tremendous,3,2,1,4,40,50
1413365130,Future Ecologies,0,1,0,0,11,12
1413384728,"Make and Decorate with Stephanie Socha Design: Sew, quilt, decorate",0,0,1,1,9,11
1413420919,TravelPulse Podcast,0,1,0,7,60,68
1413459689,Views from The Porch,5,3,1,0,125,134
1413486309,The Professional Noticer,0,0,0,1,99,100
1413504428,Talking Tudors,0,0,0,2,24,26
1413583065,The Adulting With ADHD Podcast,0,0,0,0,5,5
1413585087,Meditation for Women,0,0,0,0,50,50
1413645643,The My Hero Academia Podcast,0,0,1,0,11,12
1413797628,AGI Podcast,0,0,0,0,3,3
1413850820,Folk on Foot,0,0,0,0,6,6
1414073313,TRAINED,0,1,0,2,47,50
1414114051,Windy City Gridiron: for Chicago Bears fans,0,2,1,1,10,14
1414384043,CoinDesk Podcast Network,1,0,1,0,28,30
1414443925,Daily Study of Jewish Law,0,0,0,0,1,1
1414584931,Without Warning,41,25,29,14,160,269
1414919482,The Final Fourcast - WVU Basketball & Everything Else,0,0,1,1,12,14
1415122204,The Dropcast,1,1,1,0,2,5
1415239995,The Writer's Almanac,3,3,2,2,75,85
1415260941,The Business of Branding,0,0,0,0,8,8
1415381048,With Me Now's podcast,0,0,0,1,0,1
1415381480,Squad Tactica - A Warhammer 40K Kill Team Podcast,0,0,1,1,11,13
1415397360,Logos,1,2,0,5,33,41
1415491130,The Science of Psychotherapy,0,0,0,0,6,6
1415546090,Into the Aether,1,0,0,0,27,28
1415720320,Stephan Livera Podcast,1,0,0,0,62,63
1415808510,Gals on the Go,105,22,22,8,43,200
1416188676,How to Write Fiction: Alone in A Room With Invisible People TM: How to Write Fiction,0,1,1,1,27,30
1416206538,The John Maxwell Leadership Podcast,0,0,0,0,3,3
1416246213,Giants Splash,0,0,0,0,7,7
1416582200,"Intimate Judaism: A Jewish Approach to Intimacy, Sexuality, and Relationships",0,1,0,0,4,5
1416632468,LS11 - Leeds United Podcast,0,0,0,0,2,2
1416696175,Locked On Bulldogs - Daily Podcast On Georgia Bulldogs Football & Basketball,5,2,1,0,41,49
1416911542,REROOT with Eamon and Bec,1,0,3,6,319,329
1417124389,Dyl & Friends,2,0,1,1,91,95
1417290907,Running Divine Podcast,0,0,0,0,5,5
1417305699,The Totally Scottish Football Show,0,0,0,0,1,1
1417326657,Friendly Confines Chicago Cubs Baseball Podcast,0,0,0,0,11,11
1417454868,The 3-0 Take,1,2,0,0,115,118
1417454965,FOMO Sapiens with Patrick J. McGinnis,0,0,2,0,48,50
1417463834,"Look Out, Sir! Warhammer 40k Podcast",1,0,0,0,9,10
1417561991,Angels Recap with Trent Rush,0,0,0,0,14,14
1417616354,Schoolhouse Rocked: The Homeschool Revolution!,1,0,0,0,33,34
1417631716,The Animals at Home Network,0,0,0,0,15,15
1417809615,Commuting the Cosmos,0,0,0,0,1,1
1418015987,Catholic Daily Reflections,0,0,1,0,16,17
1418029100,KidNuz,4,1,0,4,41,50
1418058093,Platts Future Energy,0,0,0,1,0,1
1418097194,Comfort Food,1,0,0,0,25,26
1418240349,Birthday Skin,0,0,0,1,16,17
1418274077,Sorry Mom,2,0,0,2,18,22
1418427866,Alice Fraser Trilogy,0,0,0,0,18,18
1418716181,Your Life Matters,1,0,0,0,49,50
1418794444,Wait Five Minutes,0,0,0,1,22,23
1418837955,Horror Movie Talk,7,3,2,2,92,106
1418870058,"Gardens, weeds and words",0,0,0,0,7,7
1418896892,Gin & Spin with Crafty Housewife Yarns,0,0,0,0,1,1
1418915527,nocrumbsleft table talks,0,0,0,0,91,91
1418960261,Call Her Daddy,288,32,15,14,145,494
1419112823,Milan Weekly Podcast,0,0,0,1,4,5
1419143614,The Belt and Road Podcast,0,0,0,0,2,2
1419165668,The Uncaged Clinician,0,0,0,0,8,8
1419175088,Didn't I Just Feed You,2,0,1,1,96,100
1419253899,Spilling Eve - A Killing Eve Podcast,3,1,0,0,29,33
1419257639,The Radio Ga Ga Podcast,0,0,0,0,29,29
1419275869,Project Nova,0,0,1,2,47,50
1419323770,Hokage Thots,0,0,0,0,50,50
1419386678,The Nose Knows Podcast,0,0,0,1,44,45
1419600544,Attention Pliss! with Arnab Ray,0,0,0,1,4,5
1419689068,Cyber Work,1,0,0,10,45,56
1419700742,The Browns Wire Podcast,1,0,0,0,5,6
1419732648,EXPANDED Podcast with Lacy Phillips,2,2,2,2,42,50
1419742734,Dropping the Gloves,12,1,4,2,103,122
1419772300,Pinstripe Alley: for New York Yankees fans,0,1,0,0,16,17
1419782085,The Research Like a Pro Genealogy Podcast,0,0,1,1,48,50
1419791571,Men’s Health Minute,2,1,0,0,0,3
1419821427,Leading Equity,0,0,0,0,30,30
1419855428,Crime In Music,1,0,3,0,5,9
1419858305,300 Yards To Unknown | By RickRunGood,0,0,0,1,336,337
1420165684,Rogers Waterfowl Podcast,1,0,0,0,4,5
1420190783,Sober in the Sunshine,0,0,0,0,8,8
1420216970,Words Matter,10,4,3,3,30,50
1420223666,KSL Unrivaled,1,1,0,1,5,8
1420631463,Spectrum Autism Research,1,0,0,1,0,2
1420633434,"Sit, Breathe, Bow",0,0,0,1,11,12
1420638794,Today In Jewish History,0,0,0,2,11,13
1420880544,Legal Beagle- Personal Injury Law Podcast,0,0,0,0,3,3
1420985193,Tinsel Tunes Podcast,0,0,0,0,17,17
1421528872,Looking For The Middle: The Christian Girl's Guide to Modern Dating,0,2,1,1,25,29
1421573955,Dr. Death,12,3,12,21,452,500
1421968445,Schwab Market Update Audio,0,0,2,3,2,7
1422064411,Contractor Growth Network,0,0,0,0,16,16
1422394217,Jump Street Podcast,0,0,0,0,88,88
1422483488,Ghost of a Podcast: Astrology & Advice,3,1,0,0,46,50
1422504839,The No Chill Podcast,4,5,5,8,56,78
1422589689,Unexpected Reviews and After Show - AfterBuzz TV,0,1,0,2,1,4
1422779785,Land & Legacy - Sportsmen's Nation,0,0,1,0,37,38
1422799473,Warriors Weekly Rugby Podcast,0,0,0,0,1,1
1422812354,Thunder & Lightning,8,1,3,7,213,232
1422814215,Inside the Strategy Room,1,1,0,0,1,3
1422830638,The Secret History of the Future,2,2,0,3,46,53
1422906504,FRAMED: An Investigative Story,25,39,43,11,146,264
1422970856,The Chewjitsu Podcast,0,0,0,0,56,56
1423288932,Jimmy Akin's Mysterious World,4,1,1,5,175,186
1423417914,Yahoo Sports College Podcast,24,3,2,6,104,139
1423422627,Yahoo Sports NFL Podcast,8,1,4,1,486,500
1423423794,Big Fat Positive: A Pregnancy and Parenting Journey,3,1,1,1,38,44
1423733399,Becoming Mother Nature,1,0,1,2,46,50
1423759123,The First Degree,65,26,45,31,333,500
1423874033,Fixing Healthcare Podcast,1,0,0,1,10,12
1423878408,Pit Life BBQ,0,0,0,0,6,6
1423940128,90 Day Fiance Cray Cray,36,27,18,14,405,500
1423965506,Women's Health By Heather Hirsch,0,0,0,0,12,12
1424241361,Pardon the Mess with Cynthia Yanof,1,0,1,0,118,120
1424348845,The Laura Horn Art Podcast,0,0,1,0,67,68
1424527240,Never a straight answer,0,0,0,0,13,13
1424766141,More Plates More Dates,0,0,0,1,17,18
1425055063,The Punies by Kobe Bryant,1,1,0,0,48,50
1425086337,I Hear Design: the i+s podcast,0,0,0,0,1,1
1425141892,Mega,0,0,0,0,50,50
1425178922,SAPIENS: A Podcast for Everything Human,1,0,0,1,26,28
1425185370,Psychopharmacology and Psychiatry Updates,0,0,0,0,2,2
1425298297,Dlisted: The Podcast,3,0,1,1,121,126
1425350851,Batwoman Podcast,2,1,1,3,2,9
1425544025,"Roots, Rednecks, and Radicals",0,0,0,0,2,2
1425548737,Justa Runners podcast,0,0,0,0,7,7
1425596102,Alliteration Am Arsch,0,0,0,0,1,1
1425696909,The Great Books of Literature Podcast,0,2,0,0,4,6
1425699094,The Passing Shot Tennis Podcast,0,0,0,0,1,1
1425706720,NPTE Studycast | Physical Therapy,0,0,0,3,5,8
1425979262,Fear Initiative: Dungeons and Dragons and Horror,2,0,1,3,27,33
1426026971,Superwomen with Rebecca Minkoff,2,2,1,3,78,86
1426081802,Housing News,0,0,1,0,1,2
1426105733,70 Million,0,0,0,1,10,11
1426176019,getWITit | Women in Technology,0,0,0,0,3,3
1426198805,Real Leaders Podcast,0,0,1,1,37,39
1426522089,Gola,1,0,1,1,14,17
1426530582,The Rational Reminder Podcast,0,0,0,0,31,31
1426679990,The Play's the Thing,0,3,1,0,22,26
1426833479,Defying the Status Quo,0,0,0,0,8,8
1426899436,Hold My Popcorn,1,1,1,0,32,35
1427018681,You Beauty,15,10,12,6,50,93
1427547655,Cidiot,0,0,0,2,14,16
1427714471,Sufi Heart with Omid Safi,0,0,0,0,8,8
1427852570,Nerd Radio,0,0,0,1,6,7
1427857153,"Km42 - Courir, manger, dormir, recommencer",0,0,0,0,1,1
1427888185,My Hero Academia Podcast,0,0,1,0,9,10
1428091619,Navigating Neuropsychology,0,0,0,1,46,47
1428197805,Rogue Ways,0,0,0,0,13,13
1428209307,QAnon Anonymous,82,19,21,16,299,437
1428221350,Living Well with Multiple Sclerosis,0,0,1,0,2,3
1428222910,Seven Stripes Fishing,0,0,0,0,11,11
1428281934,Hit the Bricks,1,0,0,4,11,16
1428327760,Filter Stories - Coffee Documentaries,0,0,0,2,23,25
1428704212,Delicious Ways to Feel Better,12,6,6,12,178,214
1428707261,SojuTalk Kpop Podcast,1,0,1,0,8,10
1428765709,Crime After Crime,1,2,3,2,67,75
1428793369,Move The Line,0,0,0,0,20,20
1428840186,TogetherBHA,0,0,0,0,6,6
1428843394,Horror Tales,5,2,1,3,22,33
1428847455,The Fundamism Podcast,0,0,0,0,29,29
1428856802,#JCsMusicology,0,0,0,0,15,15
1428871702,Mirrors,0,1,2,0,47,50
1428880766,Brain Inspired,0,0,0,0,9,9
1428955560,Smarter Building Materials Marketing,1,0,0,0,12,13
1428964002,Resoundingly Human,0,0,0,0,1,1
1428980937,Jewelry Journey Podcast,0,0,0,0,3,3
1429018964,Under Review Tennis Podcast,0,1,1,0,29,31
1429051512,The Stop Binge Eating Podcast,0,1,1,1,47,50
1429054883,Locked On Sooners - Daily Podcast On Oklahoma Sooners Football & Basketball,2,0,0,0,20,22
1429089178,Producing The Beatles,0,0,0,0,50,50
1429121716,FCCFREE RADIO,0,1,0,0,2,3
1429180675,Fly Fish Food Shop Talk Podcast,1,0,0,0,9,10
1429317218,The Fundraising Talent Podcast,0,0,0,0,3,3
1429808898,The State of The Universe,1,0,0,1,23,25
1429876211,Zero Waste Life Hacks Podcast,0,3,0,0,11,14
1429922419,Awake At Night,0,0,1,0,21,22
1429955052,Squared Circle Psychobabble,0,0,0,0,1,1
1429961108,Locked On Razorbacks - Daily Podcast On Arkansas Razorbacks Football & Basketball,5,0,0,0,11,16
1429993278,Spooky Troop: The Last Halloween,1,1,2,4,18,26
1429998903,Plenary Session,0,1,1,3,88,93
1430037465,Sweaty and Pissed,0,0,0,0,50,50
1430094842,Locked On Cougars - Daily Podcast On BYU Cougars Football & Basketball,3,1,0,1,114,119
1430171257,The B.rad Podcast,0,0,1,1,41,43
1430295246,Chrisley Confessions,11,1,1,2,35,50
1430315931,The Daily Stoic,0,0,0,0,5,5
1430989906,Gag On This...Podcast,0,0,0,0,4,4
1431047194,Cosmonaut Tabletop,0,0,0,0,50,50
1431091834,Pretty Rich,0,0,0,1,51,52
1431121413,American Revolution Podcast,0,0,0,1,49,50
1431370301,The Konnichiwa Podcast - Conversations in English and Japanese,0,0,0,0,4,4
1431615650,The New Hunters Guide,0,0,0,0,15,15
1431698171,The Downbeat,0,0,0,0,29,29
1431698726,"Big Fat Negative: TTC, fertility, infertility and IVF",0,0,0,0,50,50
1431786884,The Fitness Business Podcast with Erin Dimond and Jordan Dugger,0,1,0,1,48,50
1431920149,The Collector’s House,0,0,0,0,2,2
1431934450,The Inspiration Place,0,0,0,0,119,119
1431963108,Screen Drafts,1,1,0,1,70,73
1432053296,Voices of Search // A Search Engine Optimization (SEO) & Content Marketing Podcast,1,0,0,0,11,12
1432096345,Married With Horses,1,0,3,4,89,97
1432138159,The Love Lab Podcast: Sex | Love | Relationship,1,0,0,1,24,26
1432185167,After Adult with Siri Dahl,4,2,0,1,38,45
1432242042,The Lets Read Podcast,4,10,10,13,222,259
1432259450,Monday Match Analysis,0,0,0,0,11,11
1432301616,Gettin' Better with Ron Funches,1,1,0,2,46,50
1432313971,Roommate From Hell,0,0,0,0,15,15
1432369172,People Who Read People: A Psychology Podcast,0,0,0,1,12,13
1432553826,Car Chat,0,0,0,0,6,6
1432612458,Magic on The Inside,1,0,0,0,50,51
1432713243,Design:ED,0,0,0,1,15,16
1432822678,The City,16,12,15,16,131,190
1432842564,Everyone's A Critic,0,1,1,0,48,50
1432888130,"Locked On Bama - Daily Podcast On Alabama Crimson Tide Football, Basketball and Randomness",1,1,0,1,23,26
1432939362,Lone Duck’s Gun Dog Chronicles,1,0,0,1,95,97
1433081360,Cobra Kai Kompanion,1,0,0,0,19,20
1433124605,The FlyLife Podcast,0,0,0,3,8,11
1433176954,The Smiling Homeschooler Podcast,0,0,0,0,18,18
1433556215,The Spawn Chunks - A Minecraft Podcast,0,0,1,1,48,50
1433583146,WhatCulture Gaming,1,2,1,3,9,16
1433675871,The Daily Poem,0,1,0,3,86,90
1433740386,The Royal Rota,11,2,2,5,9,29
1433752118,BTR Boxing Podcast Network,0,0,0,0,2,2
1433807427,Bonded in Bourbon,0,0,1,1,5,7
1433827361,The Born And Raised Audio Experience,1,0,0,0,128,129
1433863917,Cast and Crank Fishing podcast,1,0,1,2,161,165
1433882512,Gut Health Gurus Podcast,0,0,0,0,6,6
1433941876,The Major Wrestling Figure Podcast,1,0,1,2,46,50
1433950979,Secrets of Top Selling Agents Podcast,0,0,0,0,3,3
1433961166,"Fit, Healthy & Happy Podcast",0,0,0,0,50,50
1433966613,The Ryen Russillo Podcast,61,10,10,19,399,499
1433971458,The Snowboard Project,5,0,0,2,73,80
1433973220,In Your Head with Chris Medina,1,1,0,0,48,50
1433974017,WHOA That's Good Podcast,3,3,0,9,261,276
1433989990,The Agora,0,0,0,0,14,14
1433992718,The Devin Nunes Podcast,10,1,3,3,33,50
1434003134,Two Girls One Mic: The Porncast,1,0,2,2,45,50
1434028754,Yellowstone Reviews and After Show - AfterBuzz TV,0,0,0,1,2,3
1434029180,Acting Class Weekly with Sean Whalen,0,0,0,0,23,23
1434060078,The Pomp Podcast,10,5,3,4,178,200
1434068508,"Architecture, Business & Design",0,0,0,1,2,3
1434079616,Front & Nationwide: A show about the Columbus Blue Jackets,1,2,0,0,6,9
1434115281,CRISPR Cuts,0,0,0,1,8,9
1434117877,Global Connected Aircraft Podcast,0,0,0,0,2,2
1434128568,Food Talk with Dani Nierenberg (by Food Tank),0,0,0,0,11,11
1434155196,The FI Show,0,0,0,0,61,61
1434162163,Super Ordinary,0,2,1,1,22,26
1434187894,Thick & Thin,28,3,5,2,115,153
1434200368,Pure Nurture Pregnancy and Birth,0,0,0,0,18,18
1434235197,Primary Care Update,0,0,1,0,13,14
1434240381,Wingnut Social: The Interior Design Marketing and Business Podcast,0,0,0,0,111,111
1434243584,Lex Fridman Podcast,30,6,6,36,672,750
1434249555,Life With Liz,0,0,0,0,4,4
1434273182,The Creative Endeavour,0,0,0,0,40,40
1434306426,Real Estate Agent Success Calls,0,0,0,0,28,28
1434308661,MIMI,6,2,0,1,41,50
1434311712,Cheat Sheet Podcast from The Daily Beast,4,2,2,1,9,18
1434311798,Indiana Sports Beat with Jim Coyle,1,0,1,0,1,3
1434314317,Carlos Pagni en Odisea Argentina,0,0,0,0,2,2
1434321470,School Librarians United with Amy Hermon,0,0,0,1,9,10
1434325875,Erazno y La Chokolata El Podcast,5,0,1,2,42,50
1434327126,The Dog Savant Podcast,0,0,0,0,11,11
1434329967,Worth The Calories - A Great British Bake Off Podcast,0,0,0,1,7,8
1434346405,The Midnight Boys Present: A Free Podcast,0,0,0,0,11,11
1434352450,Forty20 Rugby League Podcasts,0,0,0,0,1,1
1434354911,The Femails,3,0,1,2,96,102
1434360386,Detour To Neverland,0,0,1,1,61,63
1434361384,Peds RAP,0,0,0,0,1,1
1434361386,Primary Care RAP,0,0,1,1,2,4
1434361439,Urgent Care RAP,0,0,0,0,1,1
1434363502,Appaloosa,0,0,0,0,1,1
1434366838,Wonders and Miracles,0,0,0,0,44,44
1434371530,The Dr. Gundry Podcast,3,1,1,1,44,50
1434373989,Mean Book Club,4,0,0,2,36,42
1434403217,We Built A Thing,0,1,0,0,33,34
1434443225,Tai Asks Why,3,1,2,3,41,50
1434454884,The Wise Consumer,0,0,0,0,12,12
1434465245,Wild Thing,7,11,11,16,279,324
1434494214,Bastards of Boston Baseball (Red Sox),8,0,0,1,80,89
1434501650,Emotional Abuse,0,0,0,0,1,1
1434502128,Rivals of Waterdeep,0,0,1,0,6,7
1434527138,Shaun Attwood's True Crime Podcast,1,2,0,0,14,17
1434573267,Just Us Weirdos,0,0,2,3,45,50
1434573399,Consumer Finance Monitor,0,0,0,0,2,2
1434596241,Asimov's Science Fiction,0,0,0,1,4,5
1434603257,Broken Harts,118,85,77,61,159,500
1434643612,Zoo,3,9,2,2,26,42
1434647685,The Hyperfine Physics Podcast,0,0,0,0,2,2
1434649680,Happy Face Presents: Two Face,60,81,116,80,163,500
1434654553,No Bullsh!t Leadership,0,0,0,0,5,5
1434744385,Rewilding Earth Podcast,0,0,0,0,7,7
1434760405,The View,15,5,5,6,19,50
1434773197,Mobile Suit Breakdown: the Gundam Anime Podcast,0,0,0,2,48,50
1434777977,The Fisheries Podcast,0,0,1,0,2,3
1434862668,My DVC Points Podcast,1,0,1,1,82,85
1434863731,Adventures in New America,15,1,3,7,24,50
1434896760,American Greed Podcast,4,2,1,2,28,37
1434904509,The Jeselnik & Rosenthal Vanity Project,8,3,2,5,182,200
1434905449,With Intention,2,1,4,2,41,50
1434924694,USMLE Step 2 Secrets (An InsideTheBoards Podcast),1,0,0,1,17,19
1434927245,The Not For Lazy Marketers Podcast,0,0,0,0,50,50
1434966498,Confidence & Self Esteem Podcast,0,0,0,0,2,2
1434974629,Diet Doctor Podcast,0,0,1,1,40,42
1434981484,Wine Face,0,0,1,0,39,40
1435004662,90 Minutes Or Less Film Fest,0,0,0,0,1,1
1435007518,Her Brilliant Health Revolution with Dr. Kyrin,0,0,0,0,31,31
1435015463,Beth Tikkun Messianic Congregation,0,0,0,0,3,3
1435023391,Gold Goats 'n Guns Podcast,0,1,0,0,3,4
1435024522,MASH Matters,0,0,0,0,53,53
1435078293,Siempre es Lunes,4,0,1,0,45,50
1435091247,I Love Old Time Radio,0,1,0,0,4,5
1435114916,Arden,2,4,3,2,39,50
1435115679,Crypta,0,0,0,1,26,27
1435127508,1994,1,0,0,0,8,9
1435155828,BE THE PEOPLE,0,0,0,0,16,16
1435175817,4:13 Podcast with Jennifer Rothschild,0,1,1,4,253,259
1435183458,The Pat McAfee Show 2.0,24,4,8,6,148,190
1435206744,The Phinsider: for Miami Dolphins fans,4,1,1,3,49,58
1435214303,Everyday Wellness,1,0,0,0,49,50
1435214503,True Tales From Old Houses,0,0,0,0,12,12
1435214757,The Pod,5,3,3,1,38,50
1435217865,Women of Impact,0,0,1,2,47,50
1435233586,Let's talk about the 2000's,0,0,0,0,7,7
1435256709,PCOS and Food Peace,1,0,0,1,5,7
1435273901,The Shotgun Start,5,6,2,2,199,214
1435277410,The Unapologetic Man Podcast,0,0,0,0,50,50
1435314680,"Trading Nut | Trader Interviews - Forex, Futures, Stocks (Robots & More)",0,0,0,0,25,25
1435335050,The Jim Rome Show,4,0,0,1,17,22
1435336663,The Art Business Podcast,0,0,0,0,2,2
1435361544,The Small Nonprofit,0,0,0,0,10,10
1435363675,Currently Reading,15,10,11,7,157,200
1435365252,Eggplant: The Secret Lives of Games,0,1,0,1,20,22
1435373086,Smart Marketing for Small Nonprofits,0,0,0,0,4,4
1435380072,"The Seo Singh Show: Content Marketing, Influencer Marketing and Blogging Tips",0,0,0,0,3,3
1435380678,Beginners Guide to Star Wars: Legion,1,0,1,2,16,20
1435385649,Stanford Steve & The Bear,5,2,7,2,87,103
1435422084,The Fashion Geeks,0,0,0,0,8,8
1435486599,Random but Memorable,0,0,1,1,15,17
1435500798,Pass The Mic,7,0,2,1,328,338
1435502555,Morgan Evans More or Less Pickleball Podcast,0,0,0,0,2,2
1435516849,American Scandal,65,45,20,55,570,755
1435521636,Crystal Paine Show,3,3,2,4,38,50
1435526900,Lightning Radio REPLAY,0,1,0,0,0,1
1435533220,Arabic in 60 Steps Podcast,0,0,0,0,4,4
1435533425,Club Cool,2,2,2,1,193,200
1435534135,Le Run Down,0,0,0,0,2,2
1435679111,The Internet Book of Critical Care Podcast,0,0,0,0,28,28
1435699157,History Storytime - For Kids,0,0,0,1,9,10
1435719708,Pre-Loved Podcast with Emily Stochl,0,2,0,0,13,15
1435720647,The Well Of Sound,0,0,0,0,23,23
1435734461,Oilersnation Radio,0,0,0,0,5,5
1435742899,The Pack Animal Podcast,0,0,0,0,1,1
1435743296,The Dream,85,64,82,25,244,500
1435744971,Bass Fishing Dads's Podcast,0,0,1,0,12,13
1435773903,Sporadically Board with Mike and Dan,0,0,0,0,7,7
1435778021,Unspeakable Crime: The Killing of Jessica Chambers,8,10,12,10,24,64
1435794175,The 4 Phase Cycle Podcast with Zesty Ginger || Hormone Balance | Women's Health | Mindset,0,0,0,5,45,50
1435805049,Locked On Wolverines - Daily Podcast On Michigan Wolverines Football & Basketball,5,1,2,2,10,20
1435806790,Accounting 101 with Jimmy Stewart,0,0,0,0,26,26
1435941205,Big Blue View: for New York Giants fans,8,1,8,1,18,36
1435947281,the talking greenkeeper,0,0,0,0,9,9
1435953168,The Golf Practice Podcast,0,0,0,1,3,4
1435956899,Raising Adults: Future Focused Parenting,0,0,0,1,49,50
1435963965,Haunted Happenstance,0,0,3,1,46,50
1435977386,Beauty Biz Bffs,5,1,1,3,190,200
1435988964,Upzoned,1,0,0,0,6,7
1435996305,Bucher and Friends,6,0,1,4,59,70
1436015273,The Last Round,1,0,0,0,15,16
1436030381,That Peter Crouch Podcast,6,2,6,8,126,148
1436034519,How To Make Friends Podcast,0,0,0,2,6,8
1436048459,Queer America,0,0,0,0,2,2
1436048539,The Sporting KC Show,1,1,0,0,5,7
1436075359,The Adam Rank Podcast,3,0,0,0,12,15
1436101301,Brewbound Podcast,1,0,0,1,8,10
1436104182,Retro Game Guys (A Retro Gaming Podcast),0,0,0,0,4,4
1436111793,Protagonist Podcasts,0,0,0,0,3,3
1436176408,Orbitals,0,0,0,0,1,1
1436177896,Internal Comms Pro: The Podcast,0,1,0,0,3,4
1436183014,Connecting Threads Quilting Podcast,0,0,0,0,1,1
1436189399,JAT Podcasts,0,0,0,1,1,2
1436192969,Saga,0,0,2,4,51,57
1436205188,Our Ludicrous Future,1,1,1,4,65,72
1436210825,"Another Way, by Lawrence Lessig",1,0,1,1,15,18
1436227475,Ghosts In The Night a Hauntings and Paranormal Podcast,0,0,1,1,7,9
1436243608,Dear Albie,8,5,9,5,302,329
1436269131,Gaze At the National Parks,0,0,0,0,28,28
1436358056,The Catholic Talk Show,1,4,1,10,188,204
1436361262,"I Like Your Work: Conversations with Artists, Curators & Collectors",0,0,0,0,50,50
1436376574,Cult Liter with Spencer Henry,6,2,1,3,488,500
1436401528,Bogleheads On Investing Podcast,1,2,0,0,16,19
1436406950,Locked On LSU - Daily Podcast On LSU Tigers Football & Basketball,0,0,0,1,40,41
1436418755,"What's Your Favorite Part? | To All the Boys (TATBILB), High School Musical: The Musical: The Series...",0,0,0,0,3,3
1436439798,Countdown to Capture,7,5,8,9,21,50
1436439833,Predators Official Podcast Presented by Two Rivers Ford,1,1,0,0,49,51
1436450976,Please Explain,10,2,5,10,26,53
1436456683,The Homeowners Show,1,0,0,0,15,16
1436489015,The Social Work Stories Podcast,0,1,0,1,18,20
1436496326,Geeky Retro Nerds Show - Pop Culture Podcast,0,2,0,0,13,15
1436501617,Good Girls Talk About Sex,2,0,0,0,24,26
1436511777,I Love You So Much With Kenzie Elizabeth,11,6,4,0,29,50
1436524071,The Brendan O'Neill Show,0,1,1,1,26,29
1436550736,FOMO,0,0,0,0,2,2
1436553910,Alden's Amazing Roblox Review,3,1,1,3,42,50
1436564690,I am a bit of an Expert: A Peppa Pig Podcast,1,0,1,1,4,7
1436565397,No Feeling Is Final,0,0,0,0,2,2
1436616330,Daniel and Jorge Explain the Universe,10,7,21,11,177,226
1436631686,Creepy Club Podcast,1,0,0,3,27,31
1436632534,Bear Hunting Magazine Podcast,1,0,1,0,135,137
1436651521,"Grimm, Grimmer, Grimmest",4,1,1,1,43,50
1436672214,The Simple Ayurveda Podcast,1,0,0,1,48,50
1436711869,"The Orisha : Right Character, Real Power, and True Tradition",0,0,0,0,6,6
1436735020,Undertaking: The Podcast,1,0,0,0,31,32
1436741305,Calling Darkness Podcast,4,2,1,1,22,30
1436760569,Offshore Wind Insider,0,0,0,0,1,1
1436762206,The Savagely Sincere Podcast,0,0,0,1,1,2
1436790398,Hero Notes: The My Hero Academia Recap Podcast,1,0,0,1,8,10
1436795749,Brat Perversions Podcast,0,0,0,0,1,1
1436812799,The Ozark Podcast,4,2,1,1,6,14
1436836269,The Garden Podcast,0,0,0,0,1,1
1436858854,Nonprofit Lowdown,0,0,0,0,29,29
1436865324,Atlanta Braves Radio Network,0,0,1,0,10,11
1436865539,#ITSNEEDED,0,1,0,0,49,50
1436865572,The Chuck Oliver Show,2,1,0,1,6,10
1436867090,The Pierre T. Lambert Podcast,0,0,0,0,11,11
1436881257,Artful Painter,0,0,0,0,7,7
1436891275,Eat My Globe,1,0,1,1,42,45
1436902528,The Dream Bigger Podcast,0,0,0,3,40,43
1436914471,Way Too Early with Kasie Hunt,4,3,5,3,28,43
1436938686,Awaken With JP Sears Show,9,0,0,0,41,50
1436944769,Plant-Powered People Podcast,0,0,0,0,12,12
1437002676,Threedom,0,0,3,2,45,50
1437004435,How We Run: Tips and Tales of Non-Profit Success,3,1,0,0,4,8
1437006895,Behind the Song,0,0,1,1,2,4
1437029685,The Creative Voyage Podcast,0,0,0,0,8,8
1437068405,Upbringing,0,1,0,0,49,50
1437068547,Hollywood and Beyond,0,0,0,0,5,5
1437080938,Peak of Serenity,0,0,0,2,3,5
1437086160,Wizards After Dark: A Washington Wizards Podcast,0,1,0,0,42,43
1437098146,The Goal Standard,0,0,0,0,32,32
1437100933,Five Minute Feng Shui,0,0,0,0,13,13
1437101388,Puck Bunnies,1,1,0,0,44,46
1437103037,Luke Dunkin's Low Budget Live,0,0,0,0,34,34
1437109285,The Eavesdrop Podcast,1,0,1,0,48,50
1437109535,The Simplicity Sessions,0,0,1,0,13,14
1437118350,The Protagonistas,0,0,0,0,33,33
1437176932,No One Told Me,0,0,0,1,39,40
1437187618,Talking Practice,0,0,0,0,3,3
1437194308,Behind the Braves,0,0,3,5,49,57
1437197205,Professor Theo's Mystery Lab,0,1,0,0,21,22
1437213097,The Naked Marriage with Dave & Ashley Willis,4,0,1,1,305,311
1437218925,The Modern Lady Podcast,0,0,0,0,46,46
1437280705,Overnight Success,1,0,0,0,28,29
1437288075,The Horror of Dolores Roach,1,4,3,4,38,50
1437292920,ClubProGuy Podcast,1,0,0,0,18,19
1437293054,Without Fail,10,6,15,11,158,200
1437306870,The TED Interview,1,0,7,3,156,167
1437315032,Sold In America,31,45,21,16,87,200
1437318487,The Readback,1,2,2,0,13,18
1437333094,Between the Worlds Podcast,11,2,5,3,372,393
1437334078,AIR JORDAN: A FOOD PODCAST,1,1,0,0,65,67
1437348106,A Scary Home Companion,0,0,0,0,14,14
1437360249,Dark Dice,0,0,1,0,45,46
1437402802,A History Of Rock Music in Five Hundred Songs,0,0,0,0,46,46
1437411449,The Course Of Life,0,0,0,0,2,2
1437431785,Homeschool with Moxie Podcast,0,0,0,0,1,1
1437442088,Ghoul Intentions,1,1,0,0,43,45
1437462184,The Problem Was Me,1,0,0,0,16,17
1437522949,How to Start a Podcast,0,0,0,0,50,50
1437525441,Infamous America,3,1,3,0,43,50
1437541488,Woodshop Life Podcast,0,0,0,0,50,50
1437549006,Lionhearted Dentists with Dr. Steve Rasner,0,0,0,0,9,9
1437568729,Read Me a Poem,0,0,0,0,6,6
1437586036,The Creative Rising,0,0,0,2,55,57
1437615836,Queer Dungeoneers,0,0,0,0,12,12
1437647915,The Mina Kimes Show featuring Lenny,7,2,1,4,286,300
1437655480,Locked On Spartans - Daily Podcast On Michigan State Spartans Football & Basketball,3,4,5,3,32,47
1437660565,The Mark Davis Show,3,0,0,1,1,5
1437677219,Wireframe,1,4,5,4,9,23
1437682381,The End Of The World with Josh Clark,12,12,10,16,450,500
1437683662,One to Grow On,0,0,0,0,17,17
1437686021,Fly Maui,0,0,0,0,5,5
1437708666,Curious Kid Podcast,0,1,3,0,46,50
1437715583,Renuncia Feliz Podcast,1,0,0,1,48,50
1437717449,USCHO Weekend Review,0,0,0,0,1,1
1437725786,PensBurgh: for Pittsburgh Penguins fans,0,2,0,0,7,9
1437728907,Sue Larkey Podcast,0,0,0,0,1,1
1437742028,Wild Swim Podcast,0,0,0,0,2,2
1437744535,CREOGs Over Coffee,0,0,0,0,26,26
1437745759,Front Porch Swingers,1,1,1,1,38,42
1437751763,Come Rain or Shine,0,0,0,0,23,23
1437753029,Prep Life,1,1,1,1,46,50
1437795866,It Happened In Hollywood,9,2,0,0,28,39
1437803393,Are Weeb There Yet?,0,0,0,0,8,8
1437805769,A Call to Lead,1,0,0,2,54,57
1437808691,Hell and Gone,116,84,81,54,165,500
1437810211,Riffs on Riffs,0,0,0,1,18,19
1437812041,Net Assessment,3,2,3,0,18,26
1437812269,Death by Dying,0,0,0,0,50,50
1437817730,Jupiter Saloon,1,0,0,0,8,9
1437830902,Chick Chat: The Baby Chick Podcast,0,0,0,0,3,3
1437834171,The Great Indoors,0,0,1,1,70,72
1437839593,The Slowdown,0,0,1,1,68,70
1437840477,Flyest Fables,0,0,1,5,44,50
1437859741,JonBenet Ramsey,4,0,0,0,2,6
1437859766,Olive Hill,0,1,1,5,43,50
1437868374,"THE STEFANIE GASS SHOW - Clarity Coaching, Kingdom Entrepreneurs, Podcasting, Courses, Christian Bus...",0,0,0,0,150,150
1437904233,Dreamboy,4,3,1,4,38,50
1437916048,"Two Minutes in the Garden: Gardening Tips, Science, Myths",0,0,0,0,3,3
1437917069,The Monster Hunters,0,0,0,0,20,20
1437922006,Chaos Agents DND,0,0,1,0,4,5
1437924056,The Dose,0,1,1,1,1,4
1437928702,Dear Murder Street,0,0,1,1,48,50
1437930783,The Insider,0,0,0,0,4,4
1437935588,Gladiator: Aaron Hernandez and Football Inc.,27,11,21,33,408,500
1437949560,The Crappie Connection,0,0,0,0,8,8
1437951495,Book Cheat,1,0,0,0,85,86
1437952572,Behind The Screen,0,1,0,1,1,3
1437953814,"It's Britney, Bitch!",10,3,0,2,119,134
1437955740,Flow Podcast,0,0,0,0,4,4
1437958794,The Darkroom,0,0,1,3,38,42
1437962257,Porcelain Peak,0,0,0,0,21,21
1437964950,Clean With Me,3,1,3,1,42,50
1437965016,Fanimated,0,0,0,1,18,19
1437983368,The Key Nutrition Podcast,0,0,0,0,50,50
1437983503,The Big Story,9,3,1,0,4,17
1438009023,Katie Piper's Extraordinary People,1,1,2,2,42,48
1438017007,Hot Hollywood - The Hottest Entertainment News From Us Weekly,2,1,2,0,23,28
1438018392,House of Rugby,0,0,0,0,7,7
1438024613,The Argument,124,62,62,57,195,500
1438032991,Deconversion Therapy,1,0,1,1,53,56
1438033349,"Heal, Survive & Thrive!",0,0,0,0,32,32
1438044265,LitReading - Classic Short Stories,0,0,1,2,29,32
1438054347,Conan O’Brien Needs A Friend,32,13,19,16,419,499
1438056475,Crafting & Coffee with Amy Latta Creations,0,0,0,0,5,5
1438061488,En 5 minutes,0,0,0,0,1,1
1438063915,TV's Top 5,8,2,1,4,115,130
1438065188,The Horrorble People's Podcast,0,0,0,0,11,11
1438100014,Age of Plastic,0,0,0,0,2,2
1438122194,Detail Therapy with Amy Landino,3,0,1,0,88,92
1438127818,Mature Audiences Mayhem,0,0,0,1,5,6
1438148749,You Bet Your Garden,3,1,1,1,22,28
1438150199,Biceps After Babies Radio,0,0,0,1,49,50
1438157174,Future Perfect,7,2,5,3,52,69
1438158101,Sleepover,0,0,0,0,1,1
1438162222,Something Scary,9,0,8,6,177,200
1438169477,FearScape Paranormal Podcast,0,0,0,0,3,3
1438182646,Pour Minds Podcast,0,0,2,0,48,50
1438244945,The Bloom & Grow Show with Amber Housley,0,0,0,0,21,21
1438251033,Entrepreneurial Thought Leaders Video Series,0,0,2,0,0,2
1438263378,The Power Trip After Party,4,0,0,1,51,56
1438276325,Full Cast And Crew,2,1,2,1,8,14
1438283607,Golden Edge - Vegas Golden Knights Hockey,0,0,0,2,5,7
1438285775,The Bitchuation Room,1,0,0,1,48,50
1438292826,Mom Brain,32,4,3,1,10,50
1438330803,Empowering Women Physicians,0,0,0,1,49,50
1438332614,Green Industry Podcast,2,1,0,1,96,100
1438341462,Sex Magic Podcast,0,0,1,0,15,16
1438350876,Run Farther & Faster — The Podcast with Coaches Lisa Levin and Julie Sapper,0,0,0,1,119,120
1438351534,Boring Books for Bedtime,4,3,2,4,37,50
1438369865,Deliver Us - True Paranormal Stories,0,0,0,0,10,10
1438370053,Carruth,0,0,4,1,96,101
1438422235,The Vietnamese Boat People,0,0,0,0,8,8
1438435120,Runners of NYC,2,2,1,1,52,58
1438449989,FT News Briefing,0,0,0,0,4,4
1438460177,Journey with Story -  A Storytelling Podcast for Kids,0,0,1,0,40,41
1438463053,Young Nails Biz Talk,0,0,0,0,3,3
1438471629,Native Stories,0,0,0,0,5,5
1438472688,The Motivated Mind,2,0,1,2,31,36
1438474274,House Party,0,0,0,1,12,13
1438476672,Pseudo-Intellectual with Lauren Chen,9,3,2,5,31,50
1438483128,Alchemy This,1,1,0,0,48,50
1438546054,Proof,8,7,12,11,126,164
1438547222,The Alert 5 Podcast,0,1,0,0,0,1
1438550053,Kingpins,43,23,25,14,111,216
1438556151,The A Million Little Things Podcast,1,2,0,0,1,4
1438566169,Unspookable,4,1,0,4,41,50
1438582282,GUIDE Culture® Podcast,0,1,1,0,71,73
1438629390,Jereshia Said,0,0,0,0,50,50
1438635902,Commentary Club,0,0,0,0,2,2
1438637287,Racer's Edge Podcast,0,0,0,0,23,23
1438644563,Canadian Prepper Podcast,0,0,0,1,16,17
1438658181,Between the Reps with Brooke Ence & Jeanna Cianciarulo,1,1,0,0,48,50
1438673311,The Writer's Way | How to Market Your Children's Book,0,0,0,0,21,21
1438675837,Time:Bombs,1,0,1,1,59,62
1438697344,The Story Song Podcast,0,0,0,0,10,10
1438698021,Islamic History X,0,0,0,0,12,12
1438704155,Hello Dysfunction,0,0,0,0,50,50
1438755426,That's Pediatrics,0,0,0,0,2,2
1438759061,And She Rises…,6,0,0,1,43,50
1438771346,The Trend Reporter,4,1,1,1,89,96
1438772276,The Other Side of Weight Loss,0,0,0,1,29,30
1438777012,The Weirdness,3,1,1,5,40,50
1438778444,An Arm and a Leg,1,3,1,4,107,116
1438778885,Tantra Made Easy,0,0,0,0,2,2
1438790448,Locked On Utes - Daily Podcast On Utah Utes Football & Basketball,0,0,0,0,29,29
1438797301,Cover Stories with Chess Life,0,0,0,0,1,1
1438804143,Blackwood,1,2,6,6,35,50
1438816586,The Self-Love Club®,1,2,1,2,16,22
1438819994,Simple on Purpose | Intentional living for Christian moms to simplify and live on purpose,0,0,0,0,23,23
1438844072,That's Spooky,1,0,0,2,241,244
1438853608,Next Level Skiing,0,0,1,1,18,20
1438857034,Read Me Romance,11,1,4,4,180,200
1438873656,To The Point - Cybersecurity,0,0,0,1,4,5
1438878323,This Might Get Weird,4,0,1,0,45,50
1438883128,Lethal Lit: A Tig Torres Mystery,1,2,2,3,29,37
1438893378,Consumer Reports Daily,2,0,0,0,4,6
1438904171,Goblet Of Wine: A Drunken British Harry Potter Podcast,0,1,0,1,60,62
1438906889,What Next | Daily News and Analysis,7,5,5,6,27,50
1438918319,Cannabis Tech Talks,0,0,0,0,3,3
1438918399,Wrath & Story,0,0,0,1,36,37
1438935097,My Marvelous Year,0,1,0,0,49,50
1438957527,Ehsanoo,0,0,0,3,46,49
1438982040,Balanced Black Girl,0,1,0,0,49,50
1438995143,NHL Fantasy on Ice,0,0,4,3,117,124
1439008396,D.R.E.A.M.,0,1,0,0,2,3
1439015508,Tao of Our understanding Alcohol Recovery Podcast,0,0,0,0,7,7
1439034317,Knicks Film School,2,2,1,2,73,80
1439038183,The Five Moore Minutes' Podcast,0,0,0,0,1,1
1439047722,"Moonbase Theta, Out",1,0,0,2,25,28
1439075343,Casual Swinger - A Swinging Lifestyle Podcast,4,0,0,1,23,28
1439101884,SHE  with Jordan Lee Dooley,2,3,2,0,193,200
1439111572,Empath's Alchemy,0,1,0,0,40,41
1439159138,Doggie Club,0,0,0,0,24,24
1439173261,You're Booked,0,0,0,3,1,4
1439183765,The Divorce Doctor,0,0,0,0,9,9
1439186876,Meet Me at the Museum,0,0,0,0,1,1
1439204048,Shedunnit,0,0,0,0,71,71
1439226960,State of the Unions,0,0,0,0,9,9
1439247558,Video Palace,2,1,2,4,41,50
1439252196,The Big Picture,79,44,67,53,205,448
1439262274,Setting The Pace: A Pacers Podcast,1,0,1,0,18,20
1439281072,2Legs: A Paul McCartney Podcast,0,0,0,0,3,3
1439283728,Experts on Expert with Dax Shepard,5,2,2,4,37,50
1439317023,Bite Me - A Texas Saltwater Fishing Podcast,1,0,2,2,26,31
1439318864,The CEO Teacher Podcast,1,1,0,1,197,200
1439326983,Husk,1,1,2,1,28,33
1439327697,Podcasting Business School with Adam Schaeuble,0,0,1,0,49,50
1439342903,What's Good with Miniminter and Randolph,17,0,2,6,310,335
1439350579,The Contracting Experience,0,0,0,0,3,3
1439370754,Talk More Talk: A Solo Beatles Videocast,0,1,1,0,0,2
1439372633,The American Mind,2,1,4,0,43,50
1439388131,For the Record: The 70s,1,0,0,1,15,17
1439434022,The Confidence Chronicles,0,0,0,0,32,32
1439471098,The Goal Achievement Podcast,0,0,0,0,14,14
1439503686,Red Pilled America,2,2,8,5,382,399
1439518327,FastTrack Your Fashion Brand Podcast,0,0,0,0,18,18
1439567112,Talk Art,2,1,3,1,43,50
1439580309,"The Cure for Chronic Pain with Nicole Sachs, LCSW",2,0,0,2,46,50
1439617120,Motherhood Simplified,0,1,1,1,33,36
1439621652,Suze Orman's Women & Money (And The Men Smart Enough To Listen),12,1,5,3,179,200
1439624737,My Paranormal Story,0,0,0,0,5,5
1439627405,The Inspirational Runner Podcast,0,0,0,0,1,1
1439627920,Truth Wanted,2,0,0,0,6,8
1439629643,Exeter,0,0,0,0,50,50
1439639387,Authentic Influencer Podcast,0,0,0,1,49,50
1439648040,Farm Food Facts,0,0,0,0,4,4
1439655378,Pretty Basic with Alisha Marie and Remi Cruz,0,0,0,0,46,46
1439663856,Diet Riot,1,0,0,1,34,36
1439688182,PPC Den: Amazon PPC Advertising Mastery,1,0,0,0,49,50
1439693428,"Certified Noonas Podcast - kdrama, kpop, and more",0,0,0,1,0,1
1439709777,Mad Dog Recovery AA Speakers,0,0,0,1,6,7
1439713745,Reverberate,0,0,2,1,6,9
1439725806,The Research Her,0,0,0,0,75,75
1439735906,Drilled,7,9,9,7,196,228
1439737070,OT 4 Lyfe,0,0,0,0,15,15
1439737935,Basic Folk,0,0,0,0,12,12
1439751014,Drum History,0,0,0,0,22,22
1439764868,The Sourdough Podcast,0,2,2,1,34,39
1439800381,Ground Control - The Official Podcast of the Winnipeg Jets,0,0,0,1,0,1
1439810326,Imagined Life,4,1,5,1,39,50
1439817061,Timestorm,0,0,0,0,23,23
1439836108,So You Think You're Intuitive Podcast,3,3,1,2,283,292
1439837349,The Political Orphanage,4,1,1,2,160,168
1439841133,Trail Running Women,0,0,0,1,30,31
1439846715,Rap Radar,1,1,0,0,1,3
1439857536,Keep Calm and Cook On with Julia Turshen,0,0,1,0,49,50
1439864732,The MCAT CARS Podcast,0,0,0,0,3,3
1439869185,Children's Stories Read By Moe Train,1,1,0,0,0,2
1439875031,How To Own The Room,0,0,0,0,3,3
1439883527,Eat Capture Share - a podcast for food bloggers,0,0,0,0,7,7
1439916957,Field Gulls: for Seattle Seahawks fans,3,0,0,0,22,25
1439920596,#MOMTRUTHS with Cat & Nat,10,3,2,3,182,200
1439925809,Architecture Academy,0,0,0,0,1,1
1439929794,Rumors of Grace with Bob Hutchins,0,0,0,0,9,9
1439932215,Vega: A Sci-Fi Adventure Podcast!,5,1,1,3,40,50
1439938902,The MIT Press Podcast,0,0,0,0,1,1
1439942953,Bulldog Mindset Podcast,0,0,1,0,2,3
1439958092,My Best Vintage Life Podcast,1,0,0,0,20,21
1439958213,Design Your Dream Life With Natalie Bacon,2,0,2,0,46,50
1439975046,All In,3,4,4,6,483,500
1439984674,We're Alive - Archive,4,0,0,1,6,11
1440000749,The 500 with Josh Adam Meyers,12,2,8,3,263,288
1440051086,Prognosis: Coronavirus,12,14,24,13,39,102
1440076586,Women in Data Science,0,0,1,0,4,5
1440077454,Radio Ananda con Ricardo Ponce,1,0,0,0,3,4
1440083927,Forever Ago,5,0,2,8,34,49
1440085392,The Agenda,0,0,0,0,1,1
1440087311,Fresh Scoop,0,0,0,0,2,2
1440107092,Murder Book,20,24,22,36,398,500
1440113261,Cryptid Campfire,1,2,1,2,10,16
1440116479,BloombergQuint All You Need To Know,1,1,0,0,6,8
1440128735,The Better Question,0,0,0,0,1,1
1440133626,Today in Focus,0,0,0,0,9,9
1440149171,Confessions Of A Crappy Christian Podcast,10,2,3,4,274,293
1440183372,The Angel of Vine,0,0,3,2,45,50
1440190146,Fated Mates - A Romance Novel Podcast,0,0,1,2,72,75
1440201620,JaM Session,0,0,1,2,49,52
1440209326,Hollywood Raw Podcast,3,2,0,0,45,50
1440228794,The Sex Ed,0,0,1,0,49,50
1440229579,BYU Men's Basketball,0,0,0,0,2,2
1440251673,Chymamusique's Podcast,0,0,0,0,2,2
1440272585,Learning The Tropes: A Podcast for Romance Novel Veterans and Virgins,0,0,1,0,73,74
1440285724,Extra Time,0,0,0,2,46,48
1440292523,Building Utopia: Bhagwan Shree Rajneesh,0,0,0,1,27,28
1440300401,Whiskey Ginger w/ Andrew Santino,4,1,1,2,42,50
1440309246,Beyond The Mask: Innovation & Opportunities For CRNAs,0,0,0,0,8,8
1440310957,The MAJic Hour,0,0,0,0,120,120
1440311441,Ashlee Off-Air,0,0,0,0,1,1
1440323217,DianaUribe.fm,0,0,0,0,50,50
1440326284,The Change Healthcare Podcast,0,0,0,0,1,1
1440327855,Childish,3,1,1,2,43,50
1440333591,LIMBO,0,2,1,0,8,11
1440334876,Intermittent Fasting Stories,3,3,4,2,38,50
1440397001,The Theatre Podcast with Alan Seales,0,0,0,1,7,8
1440399458,Ayn Rand Institute Live!,0,1,0,0,12,13
1440409010,Janus Descending,3,5,4,3,27,42
1440415638,Nox Bedtime Stories,0,0,0,0,50,50
1440433365,Oh K Drama,0,0,0,0,3,3
1440433481,Unapologetically Sensitive,1,0,1,1,47,50
1440436597,Garage Heroes In Training,1,0,0,0,10,11
1440441943,Front Row Material with Jerry Lynn & Mikey Whipwreck,2,1,0,0,37,40
1440446912,Staggars & Jags,0,0,0,0,12,12
1440451256,American Comedy Horror Story,0,0,0,0,4,4
1440505635,Heston's Journey to the Centre of Food,0,0,0,1,2,3
1440513300,The Plain People's Podcast,7,3,1,9,30,50
1440529681,Financial Decoder,0,2,0,1,15,18
1440533170,Curious Neuron,0,0,0,0,7,7
1440561508,Dan Lok Show,2,1,0,2,95,100
1440593516,Real Life Ghost Stories,0,0,1,0,49,50
1440616114,4 Eyes Academia,0,0,0,0,1,1
1440625690,The Integrated Schools Podcast,1,0,0,3,27,31
1440626665,RUDIS Wrestling Podcast,0,0,2,2,15,19
1440655770,Reinforced Running Podcast,0,0,0,0,18,18
1440683403,The Wooden Teeth Show,0,0,0,0,7,7
1440691768,Marx Madness,2,0,1,5,41,49
1440692608,"Witch, Yes!",0,0,1,0,119,120
1440707134,Kou Sopheap's Podcast,0,0,0,0,2,2
1440833267,The Bible Recap,3,0,0,0,276,279
1440841218,Stuff We've Seen with Jim and Teal,0,0,0,0,2,2
1440842265,Space Junk,0,1,0,0,5,6
1440854210,Cultish,65,15,26,22,177,305
1440863621,Sleep Tight Stories - Bedtime Stories for Kids,4,1,2,5,38,50
1440892098,The Declutter Hub Podcast,0,0,0,0,9,9
1440913727,Shadows at the Door: The Podcast,0,0,2,1,47,50
1440929401,Black Flame Immersion: The Diabolist ™,0,0,0,0,8,8
1440929730,Nos Reiremos de Esto!,1,0,0,0,49,50
1440949708,40 and 20: the WatchClicker Podcast,0,1,2,2,15,20
1440987166,The London Necropolis Railway,0,0,1,4,39,44
1441003615,Undefended Dharma with Mary Stancavage,0,0,0,0,2,2
1441018579,The Glossy Beauty Podcast,0,1,0,1,4,6
1441032838,The Bid,1,2,0,0,7,10
1441069489,Psych With Mike,0,0,0,0,33,33
1441095668,The Joe Rogan Experience Experience,29,1,1,0,19,50
1441099644,Rock's Backpages,0,0,0,1,7,8
1441154730,The Hockey Think Tank Podcast,0,0,1,0,41,42
1441164548,Signal To Noise Podcast,0,0,0,0,3,3
1441176049,Assassinations,15,6,5,7,17,50
1441192866,High School Hoops ( Coaching High School Basketball),0,0,1,0,49,50
1441209943,Food For Thought,0,0,0,0,43,43
1441215776,Your PUSH Coach,0,0,0,0,50,50
1441228136,The First Mrs. Claus,6,0,0,4,35,45
1441237423,Hellitalk,0,1,2,2,43,48
1441239824,this is not a podcast the podcast,0,0,0,1,49,50
1441242814,Hello Seven Podcast,0,1,0,0,60,61
1441248423,Fundraising HayDay,0,0,0,0,7,7
1441251826,SciShow Tangents,1,1,2,13,235,252
1441260001,The Underdog,0,0,0,1,8,9
1441260025,The Underdog Sports NFL Show,1,0,0,0,2,3
1441266901,Dark Future Dice | A Cyberpunk 2020 Podcast,0,0,0,1,49,50
1441320419,The Moving Screen,2,2,1,1,85,91
1441323875,Spooky Troop: A Very Scary Christmas,5,2,2,1,15,25
1441326777,Lactation Business Coaching with Annie and Leah,0,0,0,0,27,27
1441333595,The Alpha Male Coach Podcast,0,0,0,0,50,50
1441348407,American Hysteria,73,29,37,27,237,403
1441353614,The Session,0,0,1,1,7,9
1441354564,We've Got Nothing Better To Do,0,0,0,0,2,2
1441376382,"Trail Tales - Thru-Hiking, Backpacking, and Peak-Bagging",0,1,1,5,89,96
1441417628,Beauty Business Babes,24,4,1,0,118,147
1441449809,Bikes or Death Podcast,1,3,0,5,78,87
1441452921,Travel Genius,6,2,3,1,27,39
1441469282,Hammer Dahn,2,0,1,1,46,50
1441471489,Work for Change Podcast,0,0,1,0,49,50
1441474794,The Numberphile Podcast,0,0,0,2,43,45
1441474851,The Six Disappearances of Ella McCray,0,3,2,1,7,13
1441487750,Actor Aesthetic,0,0,0,1,44,45
1441491525,Cash Considerations: A Chicago Bulls Pod,1,1,3,3,10,18
1441496783,Thumb Cramps,0,0,0,1,16,17
1441500378,Pod Goes Punk,2,0,0,1,47,50
1441538919,Changing Minds with Owen Fitzpatrick,1,0,0,1,12,14
1441540511,Buddhism for Everyone with JoAnn Fox,0,0,0,0,22,22
1441555733,The Mind Online,0,0,0,0,1,1
1441557261,Low Carb MD Podcast,3,1,5,2,39,50
1441564787,The Rock & Roll History Show,0,0,0,0,1,1
1441571050,Chatty Broads with Bekah and Jess,1,1,1,0,47,50
1441573078,Into Africa,1,1,0,0,12,14
1441588681,Awaken Your Inner Witch,0,1,0,1,36,38
1441592240,Locked On Hawkeyes - Daily Podcast On Iowa Hawkeyes Football & Basketball,1,1,2,2,17,23
1441595858,Cold,2,2,6,4,176,190
1441643724,The KICK-ASS Stepmom Podcast,0,0,1,1,48,50
1441649707,Straight White American Jesus,0,1,0,2,47,50
1441649924,Tore Says Show,6,1,0,2,41,50
1441650133,Sometimes Dead is Better,0,0,0,2,18,20
1441656192,Ask NT Wright Anything,3,0,0,2,80,85
1441670029,Meteor City,1,3,4,6,16,30
1441696210,Real Moms of Bravo,4,2,1,4,75,86
1441696714,Good Heavens!  The Human Side of Astronomy,0,0,0,0,5,5
1441708044,CYBER,17,3,13,6,30,69
1441708286,Quillette Podcast,4,5,4,4,20,37
1441714224,Reading Teachers Lounge,0,1,0,0,19,20
1441782919,The Orthobullets Podcast,0,0,1,2,16,19
1441789630,Everyday Espionage Podcast,1,1,0,1,35,38
1441793245,Raider Cody Podcast - Las Vegas Raiders Fan Show,7,1,0,1,57,66
1441796764,Chasing Your Best | GOLF SHOW,0,0,0,0,16,16
1441797895,When We Talk About Animals,0,0,0,0,8,8
1441806992,Schnitt Talk,120,22,20,9,329,500
1441807984,The Art of Sales with Art Sobczak,0,0,1,0,35,36
1441809424,Sew & Tell,2,2,1,1,19,25
1441823144,The Better Behavior Show with Dr. Nicole Beurkens,0,0,0,0,27,27
1441824608,Family Secrets,49,45,66,40,200,400
1441840536,Demystifying College Admissions,0,0,0,1,10,11
1441842546,"Salam, Girl!",1,1,0,2,112,116
1441843007,This is the Gospel Podcast,0,0,2,4,494,500
1441876259,Solar Maverick Podcast,1,0,2,0,8,11
1441881918,Slightly Foxed,0,0,1,0,18,19
1441882710,Chasing Kangaroos - For international rugby league fans,0,0,0,0,1,1
1441884346,ALLD20,1,0,0,1,37,39
1441893683,Watch If You Dare,1,0,0,2,410,413
1441960250,Rainmaker Fundraising Podcast,0,0,0,0,10,10
1441968059,From Betrayal To Breakthrough,0,0,1,1,31,33
1441968602,Oeuvre Busters,1,0,0,0,17,18
1441970779,BEHIND THE SCENES,71,26,32,24,347,500
1441974227,Heart of the Home,1,0,1,0,31,33
1441983324,The Prickwillow Papers,0,0,0,2,6,8
1441993160,Capability Amplifier,0,0,0,0,21,21
1441998476,The Opus,4,1,1,1,19,26
1442011300,The Story Corner with Bear,0,0,0,0,7,7
1442025854,David Harvey's Anti-Capitalist Chronicles,0,0,0,0,13,13
1442028587,The Ginsburg Tapes,1,0,0,0,14,15
1442046563,The Truth About Vintage Amps with Skip Simmons,0,0,1,0,91,92
1442049286,Cafe Binge,1,0,0,0,44,45
1442076717,What’s On Disney Plus Podcast,1,0,0,1,5,7
1442123909,#NoFilter With Zack Peter,2,0,1,1,48,52
1442125298,Your Money's Worth,1,4,3,1,20,29
1442147220,Bleav presents On The List with Brett Gursky,0,0,0,0,2,2
1442164847,Impaulsive with Logan Paul,8,1,2,1,37,49
1442171006,Natchez Glen House Stories,0,2,0,1,26,29
1442190118,The No Name RC Podcast,0,0,0,0,9,9
1442257788,Berning In Hell,14,0,0,2,34,50
1442273607,Everything Under The Sun,0,0,0,0,2,2
1442285684,Amazin' Mets Alumni Podcast with Jay Horwitz,0,0,0,1,4,5
1442315151,All Eyes On Fishing's Podcast,0,0,0,0,8,8
1442319066,NORA,0,0,0,1,9,10
1442326978,Get Offset,0,1,1,2,30,34
1442391141,4 Things with Amy Brown,1,0,0,1,48,50
1442461152,Marketing Trends,2,1,0,0,27,30
1442530475,Prime Time with Ravish,1,0,0,0,12,13
1442537044,Beatles City,0,0,0,0,7,7
1442591634,The Fourth Ambit,0,0,0,0,9,9
1442604220,Aria Code,2,2,2,6,320,332
1442629466,Peace Of Mind with Bhi Bhiman,1,0,0,1,35,37
1442642688,The All American After Show Podcast,0,0,1,0,4,5
1442683668,Mike Giant Podcast,0,0,0,0,12,12
1442701736,Drifting,0,1,0,2,28,31
1442852139,Steel Magnolias - Uplifting Conversations About Life in the South,0,1,1,0,70,72
1442892516,School Colors,0,0,0,0,50,50
1442916400,Sports Card Nation,1,2,0,1,20,24
1442929874,Three Rivers Land Trust Campfire Conversations,0,0,0,0,13,13
1442945036,Mythology,3,0,4,3,40,50
1442950743,Off Menu with Ed Gamble and James Acaster,12,4,20,6,186,228
1443011851,The SURVIVAL SHOW,1,0,0,1,26,28
1443122970,Sector 0,0,0,0,0,2,2
1443154886,The Microbiome Report,0,0,0,0,13,13
1443161250,FromThe108: White Sox for the Inebriated,1,0,0,0,22,23
1443174829,The Habershow: Tom Haberstroh’s NBA Podcast,2,2,0,1,25,30
1443198245,Slop City,0,1,0,0,49,50
1443201355,Queers Next Door,0,0,0,0,11,11
1443210934,Parenting Autism,0,0,0,0,16,16
1443417194,Strong Songs,1,0,0,1,259,261
1443439333,Green Architects' Lounge,0,0,0,0,5,5
1443447819,Pretending to be People,0,0,3,0,47,50
1443491069,CONFLICTED,1,3,0,0,12,16
1443583377,THE INTELLECTUAL DARK WEB PODCAST (HOBBES + LOCKE + ROUSSEAU + US CONSTITUTION in ONE BOOK for 29$),2,1,2,1,1,7
1443605842,90 Day Fiance Trash Talk,23,9,7,4,282,325
1443615779,Power Hour,1,0,0,0,129,130
1443666680,True Crime Bullsh**,43,21,45,55,336,500
1443675475,The Veil Audio Drama,9,3,4,4,32,52
1443678424,ADHD for Smart Ass Women with Tracy Otsuka,0,0,0,0,50,50
1443681520,The Art School Podcast,0,0,0,1,31,32
1443696451,The Crypto Chick with Rachel Wolfson,0,0,0,0,1,1
1443705637,Believe: Paranormal & UFO Podcast,1,0,0,0,15,16
1443852663,Obgyno Wino Podcast,0,0,0,1,22,23
1443856963,10 Things That Scare Me,8,1,1,3,72,85
1443920565,Into the Ether,0,0,0,0,9,9
1443942941,Could It Be Oak Island Podcast,4,1,0,1,37,43
1443966713,Wild Health Podcast,0,0,1,1,48,50
1443970723,Therapy as a Christian,0,0,0,0,24,24
1444219798,Learn Spanish Con Salsa | Weekly conversations and Spanish lessons with Latin music,0,1,1,0,13,15
1444227264,Opinionated History of Mathematics,0,0,0,0,1,1
1444227880,Lab Coat Agents Podcast,0,0,0,0,24,24
1444232980,Nightgeist,0,0,0,0,37,37
1444311612,B For Better Health,0,0,0,0,35,35
1444357023,BBC Earth Podcast,0,0,0,1,17,18
1444361384,The Healing Trauma Podcast,1,0,1,0,41,43
1444374295,The Morning Brew Christian Podcast - On iHeartRadio,1,0,0,0,1,2
1444456380,EmpowerHER,0,0,0,0,50,50
1444459468,Ask Mr. Wonderful,1,0,0,0,28,29
1444464816,The Lovecraft Investigations,3,0,1,5,41,50
1444478597,The Art of Photography :: Off Camera,0,1,0,0,7,8
1444520320,The Market Huddle,2,0,0,0,35,37
1444528803,Champion Puppy Training Podcast,2,0,1,1,40,44
1444559244,Not Skinny But Not Fat,44,7,7,7,376,441
1444561115,Seltzer Squad - Staying Sober In The City,0,1,0,0,49,50
1444667419,Craft Cook Read Repeat,1,0,0,0,5,6
1444694886,Awkward Silences,0,0,0,0,7,7
1444717302,Northwest Nature Matters Podcast,0,0,0,0,9,9
1444720680,The James Smith Podcast,7,2,1,6,484,500
1444727778,MTB Fitness - Mountain Biking Podcast,0,0,1,0,4,5
1444729607,Sentimental Garbage,0,0,0,1,62,63
1444739178,Relationship & Marriage Advice Podcast,0,0,0,0,20,20
1444758667,The Caped Wonder Superman Podcast,0,0,0,0,11,11
1444774640,Hypnosis for Sleeping Deeply,2,0,0,0,1,3
1444793132,An Amber a Day: The Functional Nutrition Podcast,0,0,0,0,3,3
1444795787,FIREBALL with Ashleigh Mayfield,2,0,0,0,48,50
1444801218,The INFJ Whisperer,0,0,0,0,8,8
1444816986,long range shooting and custom rifle building podcast,0,3,1,0,10,14
1444873564,Post Reports,12,3,3,8,24,50
1444905349,Giuseppe Ottaviani Podcast,0,0,0,0,3,3
1445040374,Desire Made Real: A Discovery of Witches Podcast,0,0,0,0,1,1
1445054297,The Big One: Your Survival Guide,19,16,14,6,80,135
1445057173,UI/UX Design Tips,1,0,0,0,0,1
1445071982,The Leah Remini: Scientology and the Aftermath Podcast,5,0,0,0,6,11
1445072206,A Torah State Of Mind,0,0,0,0,1,1
1445085357,Queen of S-Mountain,0,0,0,0,28,28
1445098493,College Tennis Talk,0,0,0,0,2,2
1445150030,Podcast Secrets of the Pharaohs - a Peep Show podcast,0,0,1,1,21,23
1445184387,Precision Medicine Podcast,0,0,0,2,2,4
1445185242,SNR Drive with Matt & Dale (Pittsburgh Steelers),1,4,0,1,15,21
1445214150,"Be you, Unapologetically.",0,0,0,1,64,65
1445218892,Stars Atmosphere,0,0,0,0,3,3
1445260221,The Sweaty Startup,1,0,1,0,48,50
1445303162,Austin Idol World Wide!,0,0,0,0,3,3
1445303520,Over the Cap Podcast,2,0,0,0,6,8
1445326243,The Ultimate Deck Podcast,0,0,0,0,3,3
1445330603,Intuitive Awakening,0,0,0,0,16,16
1445344726,Loose Units: The Podcast,16,4,6,4,65,95
1445358795,The Leighton Smith Podcast,2,0,0,1,19,22
1445368869,Sound By Nature,3,0,1,1,24,29
1445370304,Feel Good Running | For the Everyday Runner!,0,0,0,0,12,12
1445374267,Affirmations by A.,0,0,0,1,9,10
1445443315,The Emerging Cricket Podcast,0,0,0,0,1,1
1445462588,Face the Truth,0,2,1,0,10,13
1445474665,The Science of Getting Rich Podcast with Gerald Peters,0,0,0,0,21,21
1445509054,The Love Hour,0,0,0,3,47,50
1445509665,WHOOP Podcast,4,4,1,4,29,42
1445558606,Inspirational Women,0,0,0,0,1,1
1445571050,Weight Loss For Nurse Practitioners,0,0,0,0,18,18
1445580533,Train Your Own Horse with Stacy Westfall,0,0,0,2,30,32
1445581071,Southern Disgrace,6,1,1,3,36,47
1445582279,Resources Radio,0,0,0,0,2,2
1445589265,A Conversation With...,0,2,1,1,51,55
1445592926,Adventures in Jewish Studies Podcast,0,0,0,0,5,5
1445601454,MPR News with Angela Davis,1,0,0,0,2,3
1445643241,Voices of Misery Podcast,3,0,0,0,304,307
1445665622,The Habit Coach with Ashdin Doctor,0,0,0,2,9,11
1445678215,Fantasy NASCAR Podcast,0,0,0,0,16,16
1445708505,The Narrow Caves,9,6,3,2,23,43
1445721627,Standard Docking Procedure,0,0,2,0,5,7
1445726793,"Life, Death and the Space Between",1,2,0,1,72,76
1445740084,Nationals Talk,0,4,0,3,30,37
1445762076,The Astrology Hub Podcast,5,2,11,20,186,224
1445778316,Hot Marriage. Cool Parents.,1,2,1,0,46,50
1445782277,Disc Golf Discussion,1,0,0,0,3,4
1445784613,The Zookeeper's Voice,0,0,0,0,2,2
1445785268,Zombie Diaries,2,0,0,2,1,5
1445900544,Daily Rosary Meditations,1,0,0,5,29,35
1445901378,Pitchfork Economics with Nick Hanauer,2,2,0,0,46,50
1445912360,"VoxCast: The Official Warhammer 40,000 Podcast",0,0,5,2,3,10
1445916435,The Blossoming Moms Show,0,0,0,1,42,43
1445925348,Medical Mnemonist (from MedSchoolCoach),0,0,0,0,11,11
1445934522,Hoopin with Hoops:  The College Basketball Betting Show,3,6,4,0,50,63
1445952749,Mahabharat Hindi Podcast,0,0,0,0,4,4
1445979525,Woolie Will Figure It Out,1,0,0,1,34,36
1446051252,"Beach Too Sandy, Water Too Wet",1,0,1,1,47,50
1446081221,A Way Out - AA Speaker Meeting,0,0,1,0,8,9
1446088262,Phil in the Blanks,77,24,34,43,322,500
1446089516,The Fighting Entrepreneur,2,1,0,7,140,150
1446097718,Era Uma Vez Um Podcast,0,0,0,0,5,5
1446116424,Sarah's Bookshelves Live,3,1,4,3,116,127
1446181140,The French History Podcast,7,1,2,2,28,40
1446215559,The Clinical Problem Solvers,0,1,2,0,30,33
1446229952,The Hot Zone with Chuck Holton,0,0,0,0,6,6
1446231503,Round the Cauldron,1,0,0,1,5,7
1446252794,Posted Up with Chris Haynes,1,0,1,0,22,24
1446284678,The Clinical Consult,0,0,0,0,5,5
1446311219,The Feminist Frame,0,0,0,0,1,1
1446336657,Buzzcast,0,0,0,0,35,35
1446349567,NOUS,0,0,0,0,2,2
1446356779,Cultra Trail Running,0,0,0,0,44,44
1446440828,House Guest by Country & Town House | Interior Designer Interviews,0,0,0,0,2,2
1446453497,Student Loan Planner,0,1,0,0,20,21
1446455762,Donald J Trump Podcast,30,0,0,0,20,50
1446476355,South Texas Gardening with Bob Webster,0,0,0,0,4,4
1446488136,"Spill The OT: Real Talk Occupational Therapy, Physical Therapy, and Speech Language Pathology",0,0,1,1,44,46
1446493845,Bossy Bruja Podcast,0,0,0,0,18,18
1446518157,Parsha in Progress,0,0,0,0,15,15
1446527049,Ages of Conquest: a Kings and Generals Podcast,0,0,2,2,27,31
1446527874,Here's The Thing,0,0,0,0,50,50
1446537270,Candlestick Chronicles: A 49ers Pod,2,2,4,1,30,39
1446599902,Podcast About List,2,0,0,0,48,50
1446661695,Genetics Unzipped,0,0,0,1,4,5
1446691866,Dynasty Rook Fantasy Football Podcast,0,0,0,0,17,17
1446754787,Backcountry Rookies - Big Game Hunting Podcast,2,0,0,1,39,42
1446799523,Prepping 2.0,17,13,12,3,32,77
1446814974,Oz 9,0,1,2,1,44,48
1446819937,The Mitzvah Podcast - With Rabbi Yaakov Wolbe,0,0,0,0,3,3
1446874607,I Have ADHD Podcast,1,1,1,2,45,50
1446912346,Drag Her! A RuPaul's Drag Race Podcast,48,34,23,22,373,500
1446933421,The Sub-Beacon Podcast,9,5,3,11,328,356
1446934537,Happy Homebirth,0,1,0,0,49,50
1446939961,Hallmark Channels’ Bubbly Sesh,10,3,4,5,143,165
1446940216,WellsCast,89,40,35,24,246,434
1446966686,Well Well Villanelle: A Killing Eve Podcast,0,1,1,2,38,42
1446989387,Relaxation Hypnosis for Stress & Anxiety,2,1,0,0,1,4
1447011448,We're Not Weighting's podcast,0,0,0,0,21,21
1447014030,Making Math Moments That Matter,0,0,1,0,49,50
1447018742,In It: Raising Kids Who Learn and Think Differently,0,0,0,2,25,27
1447045864,Sleep sounds by nature,0,2,0,0,4,6
1447052185,Allow Us to Rethriftroduce Ourselves,0,1,1,0,36,38
1447069026,Wellfed Creative Podcast,0,0,0,0,9,9
1447075892,Understanding Your Enneagram,1,0,0,1,13,15
1447087694,ToKCast,0,0,0,0,2,2
1447136847,Fnaf vs. Fortnite,9,1,2,6,15,33
1447163138,Life in the Fasting Lane,1,0,2,2,11,16
1447165701,Body Positive Health and Fitness,0,0,0,0,19,19
1447167269,Team TaylorMade Podcast,0,0,0,0,20,20
1447169587,The Alpha Girl Confidence Podcast,0,0,0,0,14,14
1447174281,Six Miles To Supper,3,0,0,0,15,18
1447183953,Global Caveat,0,0,0,0,5,5
1447198778,Trashy Divorces,4,2,2,4,38,50
1447250475,Nutrition Rounds Podcast,5,2,0,1,42,50
1447257206,First Year Married,1,0,0,0,28,29
1447262663,The Concept2 Workout Podcast,0,0,0,1,22,23
1447286743,Something Was Wrong,72,67,64,48,247,498
1447301738,Scary Stories,0,0,0,2,32,34
1447306396,Creation Science Podcast - Ultimate Homeschool Radio Network,0,0,0,0,2,2
1447308241,The Rachel Cruze Show,3,3,1,2,41,50
1447313479,JAAOS Unplugged,0,0,0,0,7,7
1447316085,Creative Queso Podcast,0,0,0,0,13,13
1447332205,So Dead,3,5,4,1,113,126
1447344289,Second City Hockey: for Chicago Blackhawks fans,4,2,1,0,1,8
1447373234,Well Far: The Running Podcast,0,0,0,0,7,7
1447382981,Kap Slap Mixes,0,0,0,0,8,8
1447409057,Birgit O'Connor and The World of Watercolor Painting,0,0,0,0,2,2
1447416021,Brother Ben X Podcast,0,0,0,0,12,12
1447428030,InGoal Radio Podcast,0,0,0,1,14,15
1447437054,High and Wide Radio | Philadelphia Flyers Podcast,0,0,0,0,6,6
1447449586,All About Pregnancy & Birth,0,0,0,0,50,50
1447500777,The Weekly Scraps Podcast,1,0,2,1,25,29
1447500966,Storytime Anytime,0,0,0,0,4,4
1447513097,Blackout,1,3,1,4,41,50
1447516735,SIBO Made Simple,0,0,0,0,50,50
1447545040,The Connected Life,0,0,0,0,50,50
1447566241,The Stylish Bride,0,0,0,0,2,2
1447571085,Creativity School,0,0,1,0,39,40
1447630242,The Hurricane Tapes,0,0,0,0,21,21
1447672084,King and the Sting,7,1,1,5,35,49
1447675033,The Nicole Walters Podcast,0,0,0,1,149,150
1447684472,The Bulwark Podcast,41,15,19,33,387,495
1447703567,The Six Figure Esthetician Show,0,0,0,2,3,5
1447708983,Flight Risk: A Star Wars Actual Play Crime Dramedy,0,0,0,1,3,4
1447714806,COURAGEOUS PARENTING,5,3,2,6,324,340
1447742271,The Construction Management Podcast,0,0,0,2,36,38
1447749598,Podcast Pray as you go,1,1,4,5,38,49
1447750893,Sussex Squad Podcast,8,2,1,4,49,64
1447751239,"Wollinspirationen - DER Podcast zum Stricken, Spinnen, Häkeln und anderen Faserkünsten",0,0,0,0,1,1
1447753865,Hiking Thru,1,2,2,3,21,29
1447762473,The Dive Down,0,0,0,0,50,50
1447766702,Spirit School,0,0,0,0,23,23
1447769441,Dearly Departed Podcast,2,0,1,2,112,117
1447775029,Millionaire Muslim,0,0,0,0,1,1
1447778184,House of Jordans - Sports Card Podcast,0,0,0,1,49,50
1447786261,The Gayly Prophet | A Harry Potter Podcast,0,0,0,0,123,123
1447793202,Cultivating H.E.R. Space: Uplifting Conversations for the Black Woman,1,1,0,2,46,50
1447810331,The Parenting Junkie Show,1,0,1,1,47,50
1447814331,Millionaire Mindsets,2,1,3,8,76,90
1447817647,Muscles and Management,0,1,0,0,38,39
1447820372,Mindful Muslimah Speaks,0,0,0,1,49,50
1447821443,Educational Duct Tape,0,0,0,0,49,49
1447830871,Wives of Jannah: Islamic Relationship Advice,0,0,0,0,9,9
1447850978,Ramblin' Radio,0,0,0,0,144,144
1447881756,Black Equity Podcast,0,0,1,0,9,10
1447892344,Over My Dead Body,88,55,69,54,234,500
1447898172,Think Positive: Daily Affirmations,2,0,1,1,23,27
1447927933,Stephen Scullion's Road to Tokyo 2020,0,0,0,0,11,11
1447941112,Dan Jones Hypnosis Sleep Stories,2,0,0,1,9,12
1447949754,Audible Anarchism,0,0,0,0,3,3
1447982978,Enneagram & Coffee,2,4,3,1,40,50
1448034875,Nutrition Made Easy,0,0,0,0,4,4
1448046436,200 Miles Before Breakfast,1,0,1,0,2,4
1448090249,The Sal Vetri Show - Fantasy Sports & Sports Betting,2,0,0,1,497,500
1448118851,Contra*,0,0,0,0,2,2
1448122972,Sex Stories,6,1,1,2,40,50
1448124210,The Mystic Rebel Podcast,0,0,0,0,42,42
1448124526,The Jeff Does Vegas Podcast,0,0,0,1,8,9
1448130626,Life After PTSD: A Podcast About Healing From Trauma,1,0,0,0,6,7
1448137416,Curioscity,0,0,0,0,12,12
1448142533,The Medieval Podcast,2,1,0,2,16,21
1448144055,Let’s Talk Dubs,0,0,0,0,50,50
1448145451,Morally Grey: A Podcast on the Lore of Warcraft,2,0,0,1,47,50
1448146452,Bad Examples w/ Tracy DiMarco & Jessica Romano,32,7,11,12,382,444
1448151398,Going West: True Crime,18,15,13,25,429,500
1448178672,Riki Rachtman's Cathouse Hollywood Podcast,1,1,3,3,42,50
1448181902,The Left of Greg Podcast,0,0,0,0,7,7
1448183641,Affiliate Marketing & Side Hustles on the Doug.Show,0,0,0,0,18,18
1448196964,Thrive Podcast #forflorists,0,0,0,0,27,27
1448199035,Manifest Daily,0,0,0,1,22,23
1448201565,Easy Stories in English,1,0,0,0,2,3
1448204529,Kalaf,1,0,2,0,16,19
1448204723,Go To There: A 30 Rock Podcast,0,1,2,0,3,6
1448210981,The Viall Files,116,36,51,52,245,500
1448211060,Muscle Intelligence,3,0,2,3,42,50
1448214127,The Ninja Selling Podcast,0,0,0,0,47,47
1448222666,AcaDames,0,0,0,0,5,5
1448226241,Dynasty Command Center Podcast,5,0,4,3,64,76
1448229352,Come Follow Me for Us podcast,3,2,2,4,489,500
1448261954,Necronomipod,21,9,10,8,413,461
1448263010,Evan and Katelyn Podcast,1,0,0,0,49,50
1448263089,The Baton: A John Williams Musical Journey,0,1,0,2,21,24
1448272440,Baltimore Sun,0,0,0,0,3,3
1448278419,Witches of the City,0,0,0,0,2,2
1448280088,Pizza City with Steve Dolinsky,0,0,0,0,6,6
1448286071,Black Girls Heal,1,3,5,2,39,50
1448306363,Orgasmic Enlightenment,19,4,2,1,24,50
1448321339,Ajahn Sona,0,0,0,0,1,1
1448330690,SonicScoop Podcast,0,0,0,0,31,31
1448342346,Self Care IRL,1,0,0,1,48,50
1448382456,Autoflower Podcast,0,0,0,0,13,13
1448424341,Find The Magic,0,0,1,2,47,50
1448431800,ARCS,1,0,1,0,48,50
1448433037,Masala Jones,0,1,1,1,47,50
1448446947,Cushman & Wakefield's Greater LA Podcast,0,0,0,0,2,2
1448453998,Cybernautica,1,1,1,3,3,9
1448454953,Tru Heel Heat,0,0,0,0,2,2
1448490065,Mavs Step Back Podcast,2,1,1,2,52,58
1448497302,The Critter Shed,0,0,0,0,3,3
1448504813,Late Night Riders,0,0,0,0,3,3
1448513177,IlmFeed Podcast,0,0,0,0,5,5
1448514363,Saint Stories for Kids,0,1,1,1,47,50
1448525682,Positive Regression: A Motorsports Analytics Podcast,1,0,0,0,32,33
1448530203,Talking Precision Medicine,0,0,0,0,1,1
1448532887,The Dog Walk,3,1,2,0,196,202
1448576480,Scottish Watches,1,0,1,0,32,34
1448579740,The Exorcisters Podcast,0,0,0,0,13,13
1448583269,The Ryan Knorr Podcast,0,0,0,1,11,12
1448599498,Zerodha Educate,0,0,1,0,3,4
1448604292,Shout It Out Loudcast,0,0,2,0,36,38
1448607298,Captains Collective Fishing Podcast,0,0,0,0,32,32
1448636343,Ain't No Seats,6,0,1,0,57,64
1448640991,DRaysBay: for Tampa Bay Rays fans,0,0,0,0,4,4
1448641786,The Hidden People,5,5,5,9,26,50
1448659634,Fine Blue Line Podcast | Law Enforcement,0,0,0,0,7,7
1448699673,School of Inspiration,0,0,0,0,16,16
1448707654,Real Estate & Financial Independence Podcast,0,0,1,0,49,50
1448729712,Up2,0,0,0,0,13,13
1448760100,Spot On!,0,0,0,0,16,16
1448763471,The Freemasons Podcast,2,0,1,0,55,58
1448782891,Seattle Real Estate Podcast,0,0,1,0,7,8
1448785876,CelticsBlog: for Boston Celtics fans,0,0,2,1,15,18
1448788631,Evolve With Emily,3,0,0,0,47,50
1448794346,Speaking of Racism,2,0,0,0,25,27
1448833161,BJJ Mental Models,0,0,0,2,9,11
1448872151,The Phillip Scott Audio Experience,1,0,0,0,18,19
1448885852,You Betcha Radio,0,1,1,1,47,50
1448888894,Bare Marriage,1,2,4,2,39,48
1448892174,Snoozecast,1,0,2,7,40,50
1448895856,Afrobeats Update (Monthly Mixes),0,0,0,0,1,1
1448897073,Secrets of Technology,0,0,0,1,6,7
1448931658,Rock N Roll Archaeology,0,1,0,0,22,23
1448943921,The Nick Zentner Geology Podcast,1,0,0,2,82,85
1448960284,Nite Shift Video,0,0,0,0,8,8
1448960566,Pleasant Ridge Today,0,0,0,0,1,1
1448973714,MCAT Basics (from MedSchoolCoach),1,0,0,2,41,44
1449001372,Ratchet & Respectable,6,2,5,6,401,420
1449039598,Dear Anxiety,0,0,1,2,24,27
1449041559,Horror Queers,2,0,0,2,81,85
1449045370,The Byron York Show,4,0,1,1,44,50
1449045549,Mobituaries with Mo Rocca,0,0,1,2,47,50
1449048091,"Mental Health Download: Exploring Mental Illness, Suicide, Homelessness and Incarceration",0,0,0,0,6,6
1449091280,Organizing Work,0,0,0,0,2,2
1449137711,The Fully Charged PLUS Podcast,3,3,0,0,28,34
1449191242,Voyage to the Stars,0,1,0,1,48,50
1449192455,The Editing Podcast,0,0,0,0,10,10
1449197830,Energy Healing,0,0,0,0,7,7
1449202228,Emotions Mentor podcast,0,3,0,0,47,50
1449220604,Extraterrestrial,57,18,19,10,84,188
1449228526,Wrestling Is Gross,0,0,0,0,6,6
1449229551,Food Matters Podcast,0,0,0,1,49,50
1449254170,The Jeremy Brett Sherlock Holmes Podcast,0,1,0,0,37,38
1449270369,DarrenDaily On-Demand,0,0,0,1,199,200
1449270823,Disneyland For Designers,0,0,0,0,42,42
1449286941,Western Hunter,0,0,0,0,18,18
1449316560,Hotboxin With Mike Tyson,53,13,18,19,392,495
1449336543,Weight Solutions for Physicians,0,0,0,0,16,16
1449341581,The Self Love Fix,0,1,5,7,304,317
1449342896,Mom Worthy,0,0,0,0,50,50
1449365067,Talkin’ Giants (Giants Podcast),6,1,1,0,235,243
1449372657,Fallout Lorecast,0,0,0,1,49,50
1449386759,It’s A TRIBE Thing — Behind The Scenes of Successful Membership Sites,0,1,0,1,48,50
1449390794,Rye Smile Films,0,0,0,0,29,29
1449411804,The Lorin Krenn Podcast,0,0,0,0,6,6
1449415719,Great & Terrible,0,2,0,0,17,19
1449420173,Gabinete de curiosidades,0,0,0,0,6,6
1449421786,Eyes For Ears,0,0,0,0,24,24
1449434247,"Marginal Gains Cycling Podcast, Presented by Silca",1,0,3,0,16,20
1449441502,"Unwell, a Midwestern Gothic Mystery",5,5,4,5,31,50
1449441668,Film School,0,0,0,0,9,9
1449450100,Tungsten Originals Podcast,0,0,0,0,16,16
1449491313,They Had to Go Out,1,1,1,0,14,17
1449500734,The Dropout,8,12,0,10,78,108
1449511676,Richest Hill,0,1,0,0,21,22
1449513577,Car Buying Podcast,0,0,0,0,11,11
1449523846,The Disney Dining Show,1,0,1,3,34,39
1449527049,The Game of Rassilon: A Doctor Who Roleplaying Game Podcast,0,0,0,0,3,3
1449531458,P-Car Talk Podcast,2,0,1,4,43,50
1449553339,As a Woman,3,0,1,1,45,50
1449574387,Hormones in Harmony,0,0,0,1,16,17
1449608102,BBVA Blink,0,0,0,0,1,1
1449610148,Hamilton,5,1,1,0,1,8
1449619878,Backstage - TV & Film,0,0,0,0,2,2
1449622243,Mimosas with Moms,0,0,1,1,46,48
1449628464,Brotherly Pod,0,0,1,0,6,7
1449631195,The Intelligence,3,0,0,0,33,36
1449631740,The OSINT Curious Project,0,0,0,0,2,2
1449642462,Space4U,0,0,0,0,1,1
1449650086,Cat Talk Radio,0,0,0,0,6,6
1449662611,HITS K-9:  Police Dog Training for Cops by Cops,0,0,0,0,2,2
1449669906,One Life One Chance with Toby Morse,0,0,0,2,48,50
1449678510,Stiff Socks,1,0,1,0,48,50
1449744956,Vogue Knitting Knitterviews,0,1,1,1,13,16
1449745207,Rogue Theory: A New Rockstars Podcast,0,0,0,0,65,65
1449766796,The Ron Burgundy Podcast,5,1,0,0,44,50
1449767032,LSAT Pros,0,1,0,0,13,14
1449779475,Talking Elite Fitness,2,2,2,3,41,50
1449785792,Pod Yourself A Gun - A Sopranos Podcast,5,1,0,2,142,150
1449788284,A Ninth World Journal,0,0,0,0,14,14
1449848509,I Don't Speak German,14,2,4,2,28,50
1449883392,Millionaire Car Salesman Podcast,0,0,1,0,21,22
1449884495,Fall of Civilizations Podcast,3,1,5,4,132,145
1449924733,The Motherly Podcast,2,2,1,1,44,50
1449940821,Bash Bros Podcast,1,0,2,1,19,23
1449947569,CARAVAN,2,1,2,3,42,50
1449983613,Run Lift Mom,0,0,0,0,48,48
1449997236,Case Closed,37,36,62,28,65,228
1450005207,David Tennant Does a Podcast With…,2,1,2,3,82,90
1450011728,Daily Grace,3,0,1,6,490,500
1450012190,Karly and Craig,0,0,0,0,2,2
1450018819,Before Breakfast,7,8,4,2,29,50
1450021177,Essential Oil Solutions with doTERRA,13,2,2,1,32,50
1450055753,Wheels Off with Rhett Miller,0,0,0,1,49,50
1450057169,Slightly Offensive with Elijah Schaffer,5,1,1,0,493,500
1450060253,The Hive Jive - Beekeeping Podcast,1,0,0,2,15,18
1450080537,Odd Tonic,0,0,1,0,36,37
1450090404,Teach Create Motivate Podcast: Motivational Tips & Tricks for Teachers,0,0,1,0,49,50
1450107526,Chasin' The Racin',0,0,0,0,2,2
1450115847,Soaring the sky a glider pilot's Podcast,0,0,1,0,7,8
1450178017,The Double Shift,0,1,3,0,46,50
1450179344,WITH A STRAIGHT FACE,2,0,0,0,38,40
1450209837,Choralosophy,1,0,0,1,11,13
1450211392,Earn Your Leisure,4,0,0,4,170,178
1450215031,The Equalizer Podcast,1,3,3,3,28,38
1450216100,10 Things To Tell You,2,0,1,2,103,108
1450218171,"The Not So Sexy, Sexy Podcast with Liv Milano",1,0,0,0,22,23
1450221733,Dlucs_ Podcast,0,0,0,0,15,15
1450232346,What Day Is It?,1,1,0,0,37,39
1450233613,PintheQ Podcast,0,0,0,0,3,3
1450234685,Turn Two Fantasy Baseball Podcast,1,0,0,1,29,31
1450241676,Dungeons and Daddies,1,0,1,0,48,50
1450267467,Best to the Nest with Margery & Elizabeth,0,0,0,0,50,50
1450275909,The Matt and Joe Woodworking Fun Hour,0,1,2,4,14,21
1450277129,Root of Evil: The True Story of the Hodel Family and the Black Dahlia,34,27,23,27,389,500
1450285761,HLTV Confirmed,0,0,0,0,3,3
1450288507,Mind Over Macros,1,0,0,0,27,28
1450288617,Women of the Military,0,0,0,0,14,14
1450289127,The Enthusiasm Project,0,0,0,0,6,6
1450296428,The Merman Podcast,0,0,0,0,3,3
1450296940,The Official Scottish Rugby Podcast,1,0,0,0,0,1
1450302494,Spooky,3,0,0,0,21,24
1450308309,LSAT Unplugged + Law School Admissions Podcast,1,0,0,0,10,11
1450310325,All Things Work From SHRM,0,0,0,0,7,7
1450317528,The Soccer Coaching Podcast,0,0,0,0,4,4
1450340586,Martha Runs the World Podcast,0,0,0,0,10,10
1450341781,Stir the Plot,0,0,0,0,13,13
1450358620,Chris Voss Podcast,2,0,0,0,0,2
1450374691,Construction Genius,0,0,0,0,18,18
1450375359,Material Matters with Grant Gibson,0,0,0,0,3,3
1450385871,The Plotting Shed,0,0,0,0,1,1
1450415116,AUSA's Army Matters Podcast,0,0,1,0,4,5
1450422122,Transitions Daily Alcoholics Anonymous Recovery Readings Podcast,0,0,1,0,3,4
1450428314,Sincerely Fortune,2,0,0,2,46,50
1450531552,Deeper Dating Podcast,1,1,0,0,65,67
1450539640,Raising Mums,0,0,0,1,11,12
1450553422,She's So Reel,0,0,0,1,7,8
1450560564,BRStv Podcasts,0,0,0,0,5,5
1450560659,The Brandel Chamblee Podcast with Jaime Diaz,3,1,5,2,17,28
1450585510,That Park Life Podcast,0,1,0,0,18,19
1450648005,Transport Topics,1,0,0,0,1,2
1450658490,"Very, Very, Quite Contrary Podcast",2,0,0,0,48,50
1450663459,The ModernJeeper Show,1,2,1,0,6,10
1450663573,Birth Story Podcast,0,0,1,0,42,43
1450693772,Mama Said with Jamie-Lynn Sigler & Jenna Parris,8,6,4,5,27,50
1450722267,Black Flagged Podcast,2,0,0,0,10,12
1450730862,Rock and Roll Heaven,1,1,0,2,6,10
1450749115,In a Time of Ancient Gods: The Xena Podcast,0,0,0,0,6,6
1450750269,Sagittarius Eye Podcast: Elite Dangerous' leading news network,0,0,0,0,2,2
1450757252,The Climate Champions,0,0,0,0,3,3
1450764373,How i Died,0,1,1,2,46,50
1450766517,The Rational Republican,0,0,0,0,7,7
1450779291,The Hard Times Podcast,2,2,1,1,22,28
1450807948,TTMCast Sports Collectibles Podcast,0,0,0,0,2,2
1450808650,I Thought I Knew How: A Podcast about Knitting and Life,0,0,0,1,41,42
1450808822,Monday Night Pod: Wrestling's War,0,0,0,0,13,13
1450820162,Molly of Denali,2,1,0,6,41,50
1450841126,New England Travel Journal Podcast,0,0,0,0,1,1
1450846768,Smart Muslima,0,0,0,0,3,3
1450858380,Cracks Podcast con Oso Trava,0,0,0,0,31,31
1450860560,Compete Like a Champion,0,0,0,0,3,3
1450860786,"Gay Therapy LA with Ken Howard, LCSW, CST",0,0,0,0,4,4
1450881801,BRN Podcast: Buddhist Recovery Network,0,0,0,0,2,2
1450886915,It's My Pleasure,0,0,0,0,50,50
1450887023,"Tending Seeds: Adventures in Farming, Gardening, and Herbalism",0,0,0,0,16,16
1450892501,SoulWords- Full Library,0,0,0,0,5,5
1450906305,Let's Hear It,0,0,0,0,3,3
1450941804,Trials & Trebuchets,2,0,0,0,20,22
1450950961,Dare to Awaken,0,0,0,0,33,33
1450987470,The Italian Football Podcast,1,1,0,0,13,15
1450991630,Stewart-Haas Radio,0,1,0,0,7,8
1450993686,The PowerScore LSAT PodCast,3,3,2,1,32,41
1450994021,On Purpose with Jay Shetty,147,91,175,91,1897,2401
1450998654,Espoilers Podcast,2,1,0,1,4,8
1451004288,What Is Life?,0,0,0,0,2,2
1451006833,Dames who Dish,4,1,0,0,73,78
1451019115,ARRL So Now What?,0,1,2,0,7,10
1451026175,Sporting Dog Talk,1,2,0,1,45,49
1451026260,Scrapbook Your Way,0,0,0,0,18,18
1451056585,Fatwa,0,0,1,0,2,3
1451088836,Sports Psychology Podcast,0,0,0,0,2,2
1451095215,Tailgate Guys BBQ Podcast,0,0,0,0,1,1
1451098241,The Dirty John Podcast,1,0,1,0,0,2
1451107900,Bardown Breakdown,0,0,0,0,7,7
1451108442,Big Swing Podcast,0,0,2,0,234,236
1451109634,Throughline,14,10,18,12,136,190
1451112935,Blockbuster,6,9,5,7,266,293
1451115723,SEX COMMUNICATION,0,0,0,0,9,9
1451134824,A.K. 47 - Selections from the Works of Alexandra Kollontai,0,0,0,0,12,12
1451146084,The Ladies Guide to Dude Cinema,0,0,0,0,15,15
1451196235,Cooking with an Italian accent,0,0,0,0,16,16
1451204865,Dorky Geeky Nerdy Trivia Podcast,0,0,0,0,2,2
1451229633,The Flexible Dieting Lifestyle Podcast,1,0,0,0,49,50
1451239165,SEN Live,9,3,2,4,482,500
1451263656,Aviation LO Down,1,0,0,2,11,14
1451285109,The League of Ultimate Questing,0,0,0,0,16,16
1451314421,"Seven Out Gambling, Poker and Casino Podcast",0,0,0,0,50,50
1451336816,1Up Podcast with Gary Williams,0,0,0,0,8,8
1451345410,The Like Attracts Like Podcast,0,0,0,0,4,4
1451386250,Artist/Mother Podcast,0,0,0,0,69,69
1451392483,The Plant Based Podcast,0,1,0,0,2,3
1451422419,Wholly Jewish,0,0,0,0,2,2
1451423010,The Better Human Podcast,2,0,1,1,6,10
1451423325,Indy Ball Report,0,0,0,0,2,2
1451424894,Angels and Awakening,1,0,1,1,460,463
1451425747,Accelerate 2 Great,0,1,0,2,197,200
1451439498,Stars Like Us: Astrology with Aliza Kelly,1,0,2,1,49,53
1451458543,Moms Out Loud,0,0,0,0,6,6
1451459009,Pastor Robert Morris Ministries on Oneplace.com,2,1,8,8,13,32
1451459339,Switch4Good,0,0,0,1,49,50
1451462443,Practice You with Elena Brower,2,2,1,1,76,82
1451463892,The White House Brief,6,0,1,6,209,222
1451469361,The Quicky,11,2,7,10,66,96
1451470931,Who the Hell is Hamish?,9,4,7,10,57,87
1451489585,Sh**ged Married Annoyed,16,4,17,2,461,500
1451529802,Red School Bus - Clean Comedy,0,0,0,1,49,50
1451530001,"Art Juice: A podcast for artists, creatives and art lovers",0,0,1,0,65,66
1451537876,Do It For the Process from Emily Jeffords,0,1,0,1,50,52
1451549039,You Can Learn Chinese,0,0,0,0,28,28
1451557365,Inward with Rabbi Joey Rosenfeld,0,0,0,0,10,10
1451558910,Music Business Podcast,0,0,0,0,15,15
1451558919,Podcast63,0,0,0,0,2,2
1451560910,Two Strike Noise - A Baseball History Podcast,0,0,0,0,14,14
1451565442,The Bellas Podcast,19,6,12,11,452,500
1451566603,Dr. Drew After Dark,9,8,1,5,27,50
1451609095,The Air Force Starts Here,0,0,0,0,3,3
1451646512,Channel F,0,0,0,0,14,14
1451648664,Crime Beat,3,4,2,7,148,164
1451649159,Flying the Line,0,0,0,0,3,3
1451652739,The Michael Scott Podcast Company - An Office Podcast,11,7,10,16,135,179
1451655571,Alpha Male Strategies,1,0,1,0,20,22
1451666866,Best-Self Management,0,0,0,0,36,36
1451671935,Windfall,0,0,0,0,50,50
1451676874,Real Life Real Crime,21,16,8,11,444,500
1451680647,NOISEXTRA - The noise podcast.,0,0,0,0,13,13
1451698435,Fireside Chat with Dennis Prager,7,0,1,0,42,50
1451719641,Reds Alert Podcast,0,0,0,0,7,7
1451740622,Two Titans And A Hunter: A Destiny 2 Podcast,0,0,0,1,12,13
1451746865,Formula Girls,0,0,0,0,5,5
1451761026,The All New Dennis Miller Option,5,1,1,2,41,50
1451763486,Highside / Lowside: Motorcycle Podcast,1,1,1,1,46,50
1451771847,Crimes of Passion,52,37,44,21,208,362
1451778351,FiveOne Volleyball,0,0,0,0,3,3
1451783176,Dakota Spotlight Podcast,3,1,4,2,55,65
1451784057,Pretty Spiritual Podcast,0,0,0,0,33,33
1451843580,Mating Matters,7,2,1,0,77,87
1451859557,How to Start a Business,1,0,0,0,2,3
1451859986,Pax Britannica,0,0,0,2,26,28
1451860877,DevOps and Docker Talk,0,0,0,0,1,1
1451864362,The Rise & Conquer Podcast,24,14,26,14,120,198
1451872835,Thanks For Visiting,0,1,0,0,49,50
1451874289,America First with Sebastian Gorka Podcast,15,3,3,1,28,50
1451888095,The Insurance Dudes,1,0,0,0,49,50
1451972744,The Full Bloom Podcast - for body-positive parenting,0,0,0,1,24,25
1451974673,The Disclosure Podcast,0,0,0,0,120,120
1451997691,Canine Conversations,0,0,0,0,19,19
1451999167,True Crime Daily The Podcast,26,6,8,6,33,79
1452000247,11Point7: The College Baseball Podcast,2,0,0,0,35,37
1452005106,The Zibra Blog’s BEFORE AND AFTER Furniture Refinishing Podcast,0,1,0,0,14,15
1452005742,Sweating The Small Stuff,0,0,0,0,29,29
1452015285,Saucy Rockets,1,0,0,0,2,3
1452021836,SLAKR Moto Radio | Motorcycle Podcast,0,0,0,0,2,2
1452037362,Stuck Not Broken,1,5,2,3,21,32
1452049352,Among the Stars and Bones,2,1,3,5,39,50
1452049777,Becoming Great.com,0,0,0,0,5,5
1452065072,Newt's World,18,5,8,16,453,500
1452077561,The Band: A History,0,1,1,1,15,18
1452081084,Know Your History,0,0,0,0,13,13
1452083196,Buddha’s Teachings,0,0,0,0,2,2
1452117002,Narcissist Apocalypse,3,0,2,3,42,50
1452118040,The Cel Cast,0,0,0,0,1,1
1452118772,Quilt & Tell,0,1,0,1,22,24
1452121762,Hide and Seek,14,22,24,14,113,187
1452126320,unFAITHFUL: redeeming infidelity,0,0,0,1,6,7
1452297085,"The MapScaping Podcast - GIS, Geospatial, Remote Sensing, earth observation and digital geography",0,0,0,0,9,9
1452308513,Red Menace,2,1,0,1,46,50
1452354485,OMG Artistry Podcast: Social Savvy Stylist Olivia Smalley,0,0,0,1,55,56
1452360819,How I Built My Business &...  l🔨,0,0,0,0,7,7
1452376188,Becker’s Healthcare Podcast,0,0,1,0,3,4
1452382842,Explain Like I'm 5: Bite sized answers to stuff you should know about - in a mini podcast,1,1,0,0,25,27
1452395408,Crazy Money with Paul Ollinger,3,0,2,0,106,111
1452401035,Eso Fue Sarcasmo con Fabian Castillo,1,0,0,0,39,40
1452428025,The Movie Podcast,0,0,0,0,1,1
1452433255,I'm Not Your Shrink,0,0,0,0,4,4
1452461494,"Elder Scrolls Lorecast: Lore, ESO, & More",0,0,1,1,48,50
1452609613,Another Name For Every Thing with Richard Rohr,3,0,3,1,179,186
1452619693,Algo Diferente Ministry,0,0,0,0,1,1
1452635850,A Bird Hunter’s Thoughts- Turn ‘Em Loose,0,1,1,0,4,6
1452698284,Knuckleheads with Quentin Richardson & Darius Miles,4,0,2,9,207,222
1452724990,The Austin Rugby Podcast,0,0,0,0,1,1
1452727290,Carbon Removal Newsroom,0,0,0,0,16,16
1452739395,Dope Labs,0,0,1,1,33,35
1452892284,Private Practice Elevation with Daniel Fava,0,0,0,1,17,18
1452905037,Kibbe on Liberty,1,0,0,1,22,24
1452907531,Locked On Badgers - Daily Podcast On Wisconsin Badgers Football & Basketball,3,0,0,0,18,21
1452916654,The Social Work Tutor Podcast,6,2,1,0,10,19
1452927313,BirdNote Presents: Grouse,3,2,1,3,29,38
1452943557,Waltrip Unfiltered,1,3,2,5,48,59
1452978606,Plane Crash Podcast,7,3,3,8,101,122
1452984353,Modern Architect Radio Show with Tom Dioro,0,0,0,0,2,2
1453082197,Gutter Boys,0,0,0,1,6,7
1453082252,Million Dollar Life Lessons,16,1,0,3,174,194
1453086261,Dirty Strength Radio™,0,0,0,0,11,11
1453126311,Foodie Pharmacology Podcast,0,0,0,0,10,10
1453186471,Golf with Jay Delsing,0,0,0,0,2,2
1453208299,Let's Talk Homeschool,0,0,0,0,5,5
1453214274,Virtual Curbside,0,0,0,0,6,6
1453217870,Yahoo Fantasy Baseball Podcast,3,0,4,2,3,12
1453218334,Song Vs. Song,4,1,2,1,48,56
1453224776,What We Wore,0,0,0,1,6,7
1453233713,Rebel Report,1,0,0,0,12,13
1453280018,Capitalmind Podcast,1,0,0,0,6,7
1453287583,Harlem Queen,0,0,0,0,13,13
1453296967,Verbal Diorama,0,0,0,0,33,33
1453298992,Pod Of The Pops (The Girlband Popcast),0,0,0,0,4,4
1453306672,The Farrier's Bellows,0,0,0,0,2,2
1453335854,The A Show on RNC RADIO,0,0,0,0,5,5
1453338249,National Parks Traveler Podcast,3,0,0,0,1,4
1453352591,The Craft Room Podcast,0,0,0,0,1,1
1453359912,Froggy Stories,0,0,0,0,5,5
1453389736,The BossBabe Podcast,0,0,0,0,21,21
1453426302,New York Red Bulls Radio Network,0,0,0,0,7,7
1453429239,Recovering From Reality,4,0,1,0,45,50
1453430567,Witchy Woman Podcast,1,1,0,0,21,23
1453436915,SCP Archives,6,2,3,7,32,50
1453439709,Mike In The Morning,0,0,1,1,5,7
1453441157,Psychic Insights for the Modern World with James Van Praagh,1,0,1,0,36,38
1453446059,The Trouble with Sex,0,0,0,0,10,10
1453446538,Count the Dings (Official),4,2,0,3,41,50
1453446673,Mystic Witch,0,1,0,2,6,9
1453449308,Big Kid Problems,0,0,0,0,50,50
1453455876,Serious Sellers Podcast: Learn How To Sell On Amazon,0,0,0,4,96,100
1453463090,Disorderly Dogs!,0,0,0,1,27,28
1453465234,Pawsome University,0,0,0,0,16,16
1453472927,Off The Couch,1,0,1,0,8,10
1453473062,Become Your Own Therapist,0,0,0,0,1,1
1453482509,"On Friar, A San Diego Sports Wrap Podcast",1,1,2,0,5,9
1453507847,The Last Bohemians,0,0,0,0,7,7
1453532214,For Your Reference,1,0,0,1,178,180
1453547980,The Ella Ringrose Podcast,0,0,0,0,40,40
1453555416,SmoshCast,0,0,0,2,48,50
1453584698,Baseball 365,1,0,1,0,17,19
1453591627,The Future Of Fashion Business,1,0,0,0,2,3
1453598700,The 12:37,0,2,1,1,20,24
1453678957,For What It's Earth,0,0,0,0,1,1
1453728955,81 All Out - A Cricket Podcast,0,0,0,0,3,3
1453731151,Beekeeping at Five Apple Farm Podcast,1,0,0,0,40,41
1453732823,Pri-Med Podcasts,1,2,1,1,3,8
1453760605,Oblivity,0,1,0,0,10,11
1453765092,Harrison's PodClass: Internal Medicine Cases and Board Prep,0,0,0,0,12,12
1453766984,Adult Conversation Parenting Podcast,0,0,0,0,29,29
1453788965,To Live and Die in LA,44,34,27,20,375,500
1453867787,6 Degrees with Mike McKenna,0,0,0,0,28,28
1453869284,Trees A Crowd,0,0,0,1,19,20
1453873374,Deepak Chopra’s Infinite Potential,6,1,4,2,202,215
1453878632,Love and Abuse,1,1,0,2,34,38
1453889000,Poison!,0,0,0,0,10,10
1453893304,Hello Monday with Jessi Hempel,5,1,1,4,117,128
1453908621,Super Rugby Podcast,0,0,0,0,9,9
1453915673,Don't IEP Alone.,2,0,0,1,16,19
1453918264,Killer Instinct,86,71,60,30,147,394
1453940239,Wilderness Podcast,0,0,0,0,7,7
1453978907,SHOW CENTER The Airshow Podcast,0,0,0,0,5,5
1454009140,Life Kit: Parenting,1,1,0,2,26,30
1454026756,Dental A Team with Kiera Dent,0,0,0,0,29,29
1454029822,The Mister(ess) of Pop Culture 🖤,1,1,0,0,1,3
1454036760,K9s Talking Scents,0,0,1,0,8,9
1454040813,Shweet! A Ladies Guide To Bro Culture,0,0,0,0,15,15
1454045560,Elevate with Robert Glazer,0,0,0,0,50,50
1454045768,Becoming Something with Jonathan Pokluda,0,1,1,4,494,500
1454047070,The Official RuPaul's Drag Race Podcast,6,10,7,4,12,39
1454066128,The Jim Day Podcast,0,0,0,2,303,305
1454068609,Mitolife Radio,3,1,0,1,33,38
1454068835,Meditation Life Skills Podcast - How To Meditate,0,0,0,0,2,2
1454092516,Double Impact,0,0,0,0,30,30
1454097755,Naval,0,0,1,0,2,3
1454108232,Fully Free with Taylor Lee,0,0,0,0,29,29
1454112457,The Acquirers Podcast,0,1,1,3,31,36
1454118327,The Ministry of Motion Pictures Podcast,0,0,0,0,1,1
1454139632,American Girls,2,4,1,1,42,50
1454152310,Schnozzcast,0,0,0,0,1,1
1454163215,Black Women Talk Work,0,0,0,0,15,15
1454181987,Wealth Management Today,0,0,0,0,1,1
1454190031,Easy EdTech Podcast with Monica Burns,0,0,0,5,45,50
1454193127,Australian Finance Podcast,1,0,0,3,30,34
1454196846,Into Final Space,0,0,0,0,3,3
1454285643,Uncle Josh's True Scary Stories,0,0,1,4,33,38
1454308695,Stonechats from Wildwood Curriculum,0,0,0,0,1,1
1454309849,Hey! Remember the 80's?,0,0,0,0,3,3
1454334956,Learned Lag,0,0,2,2,2,6
1454366961,True Tales of Luxury,0,0,0,0,2,2
1454367912,Books And Travel,0,0,0,0,14,14
1454372285,The Minimalist Vegan Podcast,0,0,0,0,3,3
1454393520,Couch Riffs,2,0,0,0,23,25
1454408831,Full Disclosure with James O'Brien,13,6,13,15,52,99
1454410522,Not So Wimpy Teacher Podcast,0,0,0,2,48,50
1454412220,Golden Hour - Hosted by Dave Maze,0,0,1,0,22,23
1454420892,Boss Maidel Podcast,0,0,0,0,17,17
1454424563,All My Relations Podcast,1,0,3,0,239,243
1454428294,Rocked Up,0,0,0,0,2,2
1454430628,CruiseTipsTV Unplugged - Cruise Tips and More,1,0,0,1,180,182
1454433391,Nite Callers Bigfoot Radio,1,0,0,1,1,3
1454468777,Fly Fishing Insider Podcast,0,1,2,0,2,5
1454521935,OCD RECOVERY,0,1,0,1,16,18
1454537362,College to Canton,0,0,0,0,18,18
1454538161,Three Chords and the Truth: The Apologetics Podcast,0,0,0,0,38,38
1454538893,The Backhanders,0,0,0,0,4,4
1454548968,Girls on Porn,3,4,2,6,35,50
1454582540,The CharacterStrong Podcast,0,0,0,1,49,50
1454587745,The Candace Owens Show,36,2,0,4,142,184
1454593124,Russian For Cats,0,0,0,0,9,9
1454612763,100% United - A Manchester United Podcast,0,0,0,0,11,11
1454684460,Fibromyalgia Podcast,0,0,0,0,17,17
1454686994,Beyond the Surface,0,0,0,0,4,4
1454693532,Plowtalk,0,0,0,1,1,2
1454701000,Stryd Power Podcast,0,0,0,0,3,3
1454710878,High Speed Dining (+ Marijuana Ringtones) with Stoner Food Critic Joel Haas,0,0,1,0,1,2
1454714520,The Cricket Podcast,0,0,0,0,1,1
1454722186,The Gold Card Podcast,0,0,0,0,5,5
1454759350,Protecting the Frame,0,0,0,0,9,9
1454809704,Chris Simms Unbuttoned,8,4,7,9,202,230
1454816308,ML Soul of Detroit,4,0,5,2,71,82
1454850590,Crazy Town,0,0,0,2,24,26
1454851257,Rants with Danny Shih,0,0,0,0,2,2
1454855065,"DIY Money | Personal Finance, Budgeting, Debt, Savings, Investing",1,2,1,2,44,50
1454856471,Of Witches and Women,0,0,0,0,7,7
1454866940,Ohio Folklore,0,0,0,0,14,14
1454868999,Investing with IBD,1,1,2,0,29,33
1454872557,Sow The Land,0,1,0,1,26,28
1454907200,Superquest Saga,0,1,0,1,48,50
1454957401,The Cannon: for Columbus Blue Jackets fans,0,1,0,0,3,4
1454957630,The Money Sessions,0,0,0,0,15,15
1454968544,Unswtnd + Unfltrd,0,0,0,1,187,188
1454972718,The Christian Health Club Podcast,0,0,0,1,49,50
1454980022,Feminist Wellness,0,0,0,0,50,50
1454989811,The Structural Engineering Podcast,0,0,0,0,4,4
1454995612,So You Want To Be A Healthcare Executive?,0,0,1,0,7,8
1455020179,Blue Collar Elk Hunting,0,0,0,0,140,140
1455024792,Mormon Sex Info,0,3,0,0,8,11
1455030878,6 Figure Influencer,0,0,1,2,197,200
1455031218,Warden's Watch,0,0,0,0,36,36
1455036440,For What It's Worth,0,0,0,0,3,3
1455067534,The Mini-Break,0,0,0,1,15,16
1455111316,Out To Lunch with Jay Rayner,4,2,2,4,36,48
1455120200,Sports Bullies The Game,0,0,0,0,13,13
1455127076,The Deca Tapes,0,0,0,0,30,30
1455133736,Contagious Conversations,0,0,0,0,8,8
1455134689,Union Strong - New York State AFL-CIO,0,0,0,1,3,4
1455155797,FBoL : A comedy podcast about toxic people in literature,5,0,2,4,43,54
1455157759,Presenting Hitchcock,0,0,0,0,6,6
1455169228,Articles of Interest,1,1,0,5,193,200
1455174630,The Jim Fortin Podcast,0,0,0,0,50,50
1455185473,Still Lives,1,2,1,6,37,47
1455215682,Unmanned Uncovered,0,0,0,0,1,1
1455227934,Weather Insider,1,0,1,0,4,6
1455239738,OT After Dark,0,0,0,0,4,4
1455251280,Laughter Permitted with Julie Foudy,1,1,0,5,243,250
1455257747,How to Buy a Home,1,1,1,2,41,46
1455273497,Communal Table,2,0,0,0,12,14
1455304425,What To Watch,1,0,0,0,9,10
1455361893,Heal Thy Self with Dr. G,1,2,1,3,43,50
1455379351,Against the Rules with Michael Lewis,28,21,20,18,372,459
1455386910,TILclimate,0,0,0,0,9,9
1455395163,Scary Story Podcast,4,6,5,9,152,176
1455402495,The Pink Aisle: A Barbie Movie Podcast,1,0,0,0,3,4
1455406581,Backcountry Hunting Podcast,4,1,1,2,92,100
1455418690,The Wild with Chris Morgan,1,0,5,2,198,206
1455421425,The Slutrepreneur Podcast,1,0,0,0,49,50
1455446173,Get Around Me,0,0,0,0,1,1
1455527504,Dear Art Producer,0,0,0,0,15,15
1455544816,Think Like a Hacker with Wordfence,0,0,0,1,5,6
1455589166,Locked On Tigers - Daily Podcast On The Detroit Tigers,4,1,1,4,58,68
1455639994,Readastorus - Classic Children's Stories,0,0,0,0,3,3
1455648150,Civics 101: New Hampshire,0,0,0,0,1,1
1455651992,Michelle's Sanctuary: Bedtime Stories & Sleep Meditations,0,0,0,0,3,3
1455655840,SWOON: Love Lessons with Julie and Gina,0,0,0,1,42,43
1455668750,Jensen and Holes: The Murder Squad,65,14,17,17,387,500
1455677259,Get Loved Up with Koya Webb,1,0,0,0,24,25
1455711597,Fiber Nation,0,0,0,0,50,50
1455712112,Let's stay together: a Fruits Basket podcast,0,0,0,0,9,9
1455713645,According Two,1,0,1,5,82,89
1455717403,30 Animals That Made Us Smarter,0,1,1,2,50,54
1455758394,James Bond & Friends,1,1,1,0,10,13
1455761627,The Aaron Doughty Podcast,1,1,3,9,486,500
1455785618,Hawaii's Best Vacation Travel and Business Guide to Hawaii,1,0,0,0,42,43
1455788895,Thrive University,0,0,0,0,49,49
1455791108,The Road to Self Love,0,0,1,1,48,50
1455791691,Sage Parnassus,0,0,0,0,12,12
1455791934,The Cosmic Savannah,0,0,0,0,2,2
1455792414,The Mom Voice,2,0,1,0,47,50
1455795473,Estate Planning Strategies,0,0,1,0,1,2
1455795928,Shamangelic Healing Podcast with Anahata Ananda,0,0,0,1,45,46
1455797729,The Secret Life of Dietitians,0,0,0,0,2,2
1455812655,Roxy Talks Manifestation Podcast,1,0,0,0,12,13
1455813121,X-2 Drop: A Yu-Gi-Oh! Discussion PODCAST,1,0,0,1,4,6
1455825458,Squawk Box Europe Express,1,0,0,0,2,3
1455836400,Sales Copywriting and Content Marketing Hacks Podcast with Jim Edwards,0,0,0,0,5,5
1455850106,New Southern Garden,0,0,0,0,1,1
1455870257,Survival,7,3,3,3,34,50
1455873468,Amazon FBA Seller Round Table,0,1,0,0,17,18
1455894620,Mathematical Objects,0,0,0,0,1,1
1455903870,Holistic Health Radio,2,0,0,0,11,13
1455909213,As For Me And My House,36,11,16,13,424,500
1455909225,Locked On Giants – Daily Podcast On The San Francisco Giants,4,2,3,6,26,41
1455914151,Ask The Masters Podcast,0,0,0,0,1,1
1455917082,The Fasting Podcast; WOW (Wellness & Optimal Weight),1,1,0,1,8,11
1455926874,The Staff & Graph Podcast,1,0,1,0,9,11
1455929808,Boomer Living Senior Living Broadcast,0,0,0,0,11,11
1455955334,The Organic Gardening Podcast,0,0,0,0,2,2
1455965877,David Guetta,0,0,0,0,2,2
1455984211,Get The Pancake: A Podcast For Volleyball Coaches,0,0,0,1,11,12
1455998535,The Cannabis Investing Podcast,8,4,2,3,16,33
1456014220,Grow My Salon Business Podcast,0,0,0,0,11,11
1456014234,It's a Slate of Mind,0,0,0,1,9,10
1456018846,Boarding Party's Pokemon DnD,1,0,1,0,6,8
1456035236,Kings Pulse: A Sacramento Kings Podcast,1,0,1,0,31,33
1456045551,Talking Feds,1,2,3,3,41,50
1456057533,Behind The Bum,2,2,1,1,18,24
1456127373,Write Your Legend,1,0,0,0,30,31
1456137016,FromTheBackTees,0,0,0,0,57,57
1456137677,Beginning Teacher Talk,0,0,0,0,50,50
1456152559,Black Wealth Renaissance,1,0,0,3,70,74
1456178436,TENDRIL: The Banshee Chronicles,0,0,0,0,30,30
1456179019,NeedleDepth: Tattoo Podcast,0,0,0,0,2,2
1456196922,Pursuit of Bliss,0,0,0,0,50,50
1456197803,"#LikeAWoman: Mindset, Habits and Lifestyle for Women Entrepreneurs",1,0,0,1,41,43
1456199456,One Rental At A Time,0,0,0,0,4,4
1456252774,Seven Slot Society,0,0,0,0,30,30
1456268043,"The Good, The Bad, and The Sequel",0,0,0,0,7,7
1456280468,DevEd,0,0,0,0,1,1
1456285385,Project Recovery,0,0,0,1,40,41
1456292665,Unsolicited Advice with Ashley and Taryne,1,0,1,3,45,50
1456298001,That's Hockey Talk,3,0,1,1,51,56
1456302507,Hello Road,0,0,0,0,1,1
1456327498,Real-Life Korean Conversations For Beginners,0,0,0,3,1,4
1456369974,SpongeBob SquareCast,1,0,1,0,15,17
1456376809,RV Small Talk Podcast,0,0,0,1,13,14
1456395854,Wild For Life,0,0,0,0,3,3
1456404450,The Kingsley Grant Show: Where Emotional Intelligence (EI/EQ) and Leadership Skills Intersect,0,0,0,0,11,11
1456407031,The [P]Rehab Audio Experience,0,0,0,1,9,10
1456441262,The Jay Situation,0,4,0,0,7,11
1456451910,The Build Math Minds Podcast,0,0,1,0,29,30
1456452684,Wax Museum: A Basketball Card Podcast,1,0,0,0,26,27
1456466433,Hey Bitches,0,0,0,1,14,15
1456467014,The Compound Show with Downtown Josh Brown,4,3,1,1,131,140
1456474041,The Last Laugh,3,3,3,3,38,50
1456495091,¡Coches Y Tacos!,0,0,0,0,3,3
1456536586,The WAG Podcast,1,0,0,2,47,50
1456538451,Not Overthinking,0,0,0,1,18,19
1456539406,Called To Homeschool,0,0,1,0,40,41
1456541346,Discovering Classical Music,0,0,0,0,2,2
1456544408,The Gold Shaw Farm Podcast,0,0,0,1,36,37
1456552351,The Imbalanced History of Rock and Roll,1,0,0,0,7,8
1456561554,Awakening with Rabbi Ami Silver,0,0,0,0,4,4
1456602492,The Food Truck Scholar,0,0,0,1,12,13
1456631897,Otaku Summit,0,0,1,0,2,3
1456642771,Lauren Conrad: Asking for a Friend,31,35,23,11,100,200
1456643199,Locked On Indians - Daily Podcast On The Cleveland Indians,2,0,1,1,31,35
1456653976,The School of Greatness Hall of Fame,0,0,0,1,49,50
1456657346,Birdies Not BS. A Modern Approach To Golf,1,0,0,0,17,18
1456761991,Daily Dose,5,1,2,1,5,14
1456772823,Something Rhymes with Purple,0,2,11,16,174,203
1456774128,Instagram Secrets,0,0,0,0,42,42
1456783235,The Empath Podcast,1,0,0,0,44,45
1456789983,Shake Up Learning Show,1,0,1,0,48,50
1456794132,Halp's Dynasty Baseball Podcast from ImaginaryBrickWall.com,0,0,0,0,5,5
1456798246,Locked On Red Sox - Daily Podcast On The Boston Red Sox,6,0,1,1,15,23
1456800368,Graceful Atheist Podcast,0,0,0,0,12,12
1456807247,Locked On Rangers - Daily Podcast On The Texas Rangers,8,2,0,0,14,24
1456824325,The NFX Podcast,0,0,1,0,8,9
1456850698,Graham Allen’s Dear America Podcast,49,4,8,11,428,500
1456966267,The American English Podcast,0,0,0,0,7,7
1457049580,This Is Your Brain With Dr. Phil Stieg,0,0,0,0,18,18
1457064404,Locked On Astros - Daily Podcast On The Houston Astros,6,4,0,2,31,43
1457088404,The Insomnia Project,0,0,0,1,1,2
1457092789,Hole In None,0,0,0,0,11,11
1457093604,Finance Regulation Technology,0,0,0,1,3,4
1457099403,Under The Sticks Rugby,0,0,0,0,2,2
1457106360,"Dave Hill: History Fluffer (with Dave Hill, Jim Biederman, Chris Gersbeck & Jodi Lennon)",0,2,0,0,25,27
1457108418,Book More Clients Photography Podcast - Build a Five Figure+ Photography Business,1,0,0,0,53,54
1457115009,The Biofriendly Podcast,0,0,0,0,10,10
1457136401,The Braver Angels Podcast,1,3,0,1,7,12
1457141569,Crime Salad Podcast,24,18,23,20,126,211
1457146003,Locked On Dodgers – Daily Podcast On The Los Angeles Dodgers,7,3,6,2,109,127
1457146683,Locked On Mets - Daily Podcast On The New York Mets,2,1,1,1,17,22
1457150621,Moving Abroad,0,1,1,2,1,5
1457211214,Become an IDOL,0,0,0,0,8,8
1457246814,Fairway Tales: Stories of Women in Golf,0,0,0,0,2,2
1457255205,My Mom's Basement,6,0,2,1,284,293
1457262153,Expand,0,0,0,0,89,89
1457262157,Academy Queens,1,1,0,2,12,16
1457266207,Worst Firsts with Brittany Furlan,4,2,1,0,43,50
1457266239,DISCovery with Eric Senich,0,0,0,0,11,11
1457266799,Mommying While Muslim,0,0,0,0,21,21
1457274965,Fifth & Mission,6,2,4,5,16,33
1457297959,Encounter Party!,0,0,0,0,50,50
1457365096,Health Is Hell,1,0,1,0,48,50
1457380388,75 Hard Podcast,1,0,0,0,2,3
1457380767,OT Potential Podcast | Occupational Therapy CEUs,0,0,0,0,8,8
1457381834,Mommies Tell All,11,4,3,3,29,50
1457396337,Built To Grow Fitness Business,0,0,0,0,32,32
1457397110,Game Brain: A Board Game Podcast About Our Gaming Group,4,1,0,2,17,24
1457398334,A Quick Timeout,0,0,0,2,72,74
1457398886,Circle Sanctuary Network Podcasts,0,0,1,1,0,2
1457399201,the only one in the room podcast,0,1,0,0,33,34
1457402220,I Can’t Sleep Podcast,1,0,3,4,28,36
1457402664,Rebel Weight Loss & Lifestyle,0,0,0,0,50,50
1457408010,CINEMA JUDGE,0,0,0,0,2,2
1457466837,Anti-Aging Hacks,0,0,0,0,50,50
1457483597,Teaching With Jillian Starr Podcast,1,0,1,0,48,50
1457506919,Plant-Based Diet,0,0,0,0,1,1
1457514703,Espionage,46,2,0,0,2,50
1457515962,Motherhood Sessions,3,1,3,1,42,50
1457516002,Infertile AF,0,0,1,0,49,50
1457552694,We Have Ways of Making You Talk,2,3,5,9,76,95
1457602260,The West Wing Thing,19,3,3,8,66,99
1457608641,Purple Panties,2,2,4,4,174,186
1457611450,The Brown Girls Guide to Politics,10,3,1,0,64,78
1457615356,Hello Movies,0,0,0,0,1,1
1457620388,Locked On Phillies - Daily Podcast On The Philadelphia Phillies,3,0,2,0,7,12
1457667995,KIC POD,20,8,4,4,54,90
1457678006,Get Soft With Dr Snuggles,0,0,0,0,11,11
1457703545,The Psilocybin Chronicles,0,0,0,0,6,6
1457738054,George's Box - Yankees MLB Podcast,8,2,2,3,75,90
1457738208,The SCamp Life Podcast,0,0,0,0,5,5
1457739485,Cooper Stuff Podcast,0,2,2,1,190,195
1457763320,Podcast But Outside,0,0,0,1,49,50
1457786880,Swinging Outside the Lines,0,1,0,1,21,23
1457791415,The Strong Mommas Podcast,0,0,0,0,50,50
1457802246,OOMF,0,0,0,1,11,12
1457809565,The Panty Selling Podcast,0,0,1,0,12,13
1457825804,Elite Baseball Development Podcast,0,2,0,0,39,41
1457844882,COPPERHEART: A RiggStories Audio Drama,3,1,1,0,23,28
1457878143,The Bourbon Road,0,0,0,0,74,74
1457887654,Fun Astrology with Thomas Miller,4,0,1,0,96,101
1457899667,Independent Americans with Paul Rieckhoff,10,2,4,3,31,50
1457908252,Beauty Tips and Bullsh*t,0,0,0,1,35,36
1457917756,Champion's Mojo,0,0,0,0,21,21
1457934459,Powerline Podcast,0,0,2,1,22,25
1457973968,Life After Life Podcast - Our Soul's Experience in Life and Death,2,1,1,1,58,63
1457989328,Speech Uncensored: A Speech Pathology Podcast,0,0,1,2,25,28
1457996131,The John Ankerberg Show Podcast,0,0,0,0,1,1
1458008691,The Drake and Jimmy Jew Show,0,0,0,1,14,15
1458014132,On Deck : DFS MLB 2021 Podcast by LineStar App,0,0,0,0,12,12
1458022518,Ask Aviator Livestream & Podcast,0,0,0,0,2,2
1458025439,Movie Melt! Grindhouse and Exploitation Podcast,0,0,0,0,12,12
1458025883,Locked On Rockies - Daily Podcast On The Colorado Rockies,1,0,0,1,5,7
1458026831,A Single Serving Podcast,1,1,0,2,118,122
1458027133,Bebop Banter: The Premiere Anime Podcast,0,0,0,0,2,2
1458048346,UnBossed,1,2,1,1,13,18
1458053033,Not Another Movie Pod,4,3,3,6,215,231
1458056564,The Calligraphy Podcast,0,0,0,0,29,29
1458062597,The Daily Gardener,2,0,0,0,4,6
1458073378,The Gangster Chronicles,12,4,8,6,275,305
1458107908,The Hall of Fame with Booker T & Brad Gilmore,2,0,0,0,18,20
1458136901,The Nostalgic Front Podcast,0,0,0,0,22,22
1458149874,Ad Age Marketer's Brief,0,0,0,0,2,2
1458175901,Under The Shroud,0,0,0,1,42,43
1458221310,Graffstars,0,0,0,0,12,12
1458243509,No Planet B,0,0,1,0,4,5
1458285352,LightCast,0,0,0,1,4,5
1458292250,BallBlast Fantasy Football,3,1,0,1,115,120
1458292763,How Do You Train That?,0,0,0,0,1,1
1458320520,HandCut Radio,0,0,0,0,17,17
1458356753,Enrique Santos Replay,1,0,0,0,2,3
1458363841,Your 2 Dads w/ Sean & Julian,2,2,2,4,40,50
1458363871,Stand-Up w/ Tom Thakkar,4,2,5,4,35,50
1458368225,Whale Tales Podcast,0,2,0,0,5,7
1458373074,Ad Age Ad Block,0,0,0,0,4,4
1458376688,Dream Big Podcast with Bob Goff and Friends,2,0,0,1,86,89
1458408066,Dance Studio 411,0,0,0,0,2,2
1458412369,Dunk Tank,0,0,0,0,50,50
1458413661,Middle Of Somewhere,2,2,1,0,45,50
1458420685,How to Spanish Podcast,0,0,1,0,7,8
1458424590,Pier 54 - A General Hospital Fan Podcast,0,0,0,0,5,5
1458444954,The New Legend Podcast,0,0,0,0,6,6
1458448897,Teaching Middle School ELA,1,1,0,2,46,50
1458495087,Pastry Arts Podcast,0,0,0,0,3,3
1458501036,Anamnesis: Medical Storytellers | from MedPage Today,0,0,0,0,3,3
1458505005,NHL Draft Class,1,0,0,1,15,17
1458519430,Forest 404,0,1,0,1,7,9
1458529384,Bleav in Tiger Woods with Cam Rogers,0,0,1,0,1,2
1458545350,Food 360 with Marc Murphy,1,1,0,3,43,48
1458558519,Backyard Bounty,0,0,0,0,14,14
1458563601,Crime Pays But Botany Doesn't,2,0,0,1,16,19
1458565545,Decomposed with Jade Simmons,0,3,0,7,248,258
1458568923,Anything Goes with Emma Chamberlain,12,6,8,12,954,992
1458571224,Love Anyway,0,0,0,0,46,46
1458578448,Dropping Gems with Devi Brown,0,0,0,0,50,50
1458621216,The Label,0,0,0,0,17,17
1458633885,Mishna Study,0,0,0,0,1,1
1458643160,Chief Complaint Podcast,0,0,0,1,4,5
1458647174,Pamela Des Barres' Pajama Party!,0,0,0,0,13,13
1458654443,Oprah and Eckhart Tolle: A NEW EARTH,0,0,0,0,3,3
1458667471,MUDA Talks,0,0,0,0,1,1
1458671311,Catholic Economics,0,0,0,0,3,3
1458672189,Thirty Minutes with The Perrys,2,1,0,5,452,460
1458675168,The Cosmic Skeptic Podcast,0,0,0,0,84,84
1458675998,Snail Trail 4x4,0,0,0,0,50,50
1458736427,The Crumb - Bake from Scratch,0,2,1,1,16,20
1458750622,Power Corrupts,8,10,5,4,102,129
1458774193,PLANTSTRONG,5,0,0,1,44,50
1458799157,Fantasy Impact Today,0,0,0,0,1,1
1458884463,The GM Shuffle with Michael Lombardi and Adnan Virk,34,19,21,23,201,298
1458887650,Daily Breath with Deepak Chopra,10,2,2,3,33,50
1458895042,Ciao Bella,0,0,0,0,12,12
1458904143,Two Jabronis With A Wrestling Podcast,2,1,0,1,17,21
1458912985,Come Follow Me - Weekly,0,0,0,0,30,30
1458916814,Down To Earth PCOS Nutrition Podcast,0,0,0,0,10,10
1458930048,Sports Wars,32,10,19,19,170,250
1458932675,Unapologetically Abundant,0,0,0,0,29,29
1458945676,Thinking Crypto News & Interviews,0,0,0,0,6,6
1458984363,The Atomic Library,0,0,0,0,4,4
1458989046,Pods and Monsters: A Monster Movie Podcast,0,0,0,0,7,7
1458992375,The Blonde Files Podcast,0,0,1,2,47,50
1458994918,Let's Get It,0,0,0,0,20,20
1459017088,The Real Life Caddie Podcast,0,0,0,0,49,49
1459017391,Digging Deep with Robert Plant,1,0,2,1,46,50
1459057481,For the Love of Dog,0,0,0,0,15,15
1459124232,The Stakes,0,2,2,1,27,32
1459128692,The Messy Truth - Conversations on Photography,0,0,0,0,9,9
1459162001,Rock N Roll Librarian,1,2,0,2,3,8
1459167088,Cosmic Body with Danielle Paige,4,0,0,0,46,50
1459206873,Sales Made Simple,0,0,0,0,12,12
1459273902,Halfway to Heroes - A D&D 5e Actual Play Podcast,0,0,0,1,38,39
1459322652,Digital HR Leaders with David Green,0,0,0,0,7,7
1459324924,The Build Guild Podcast : A Professionally Unprofessional Podcast for Makers,0,0,0,0,29,29
1459356319,Hate That Podcast,0,0,0,0,17,17
1459386463,Bad Bitches Losing Weight,0,1,1,0,48,50
1459399711,Casey Aviation Podcast,0,0,0,0,2,2
1459401769,Speak Chinese Naturally -Learn Chinese (Mandarin),0,0,0,0,4,4
1459410736,For Your Reconsideration,0,0,0,0,5,5
1459414434,Anime and Chill,0,1,0,0,5,6
1459416461,Outrage + Optimism,1,0,2,1,35,39
1459417907,The Chris Stigall Show,2,0,0,0,48,50
1459421450,Little Girl Lost: The Case of Erica Parsons | Mystery and Murder: Analysis by Dr. Phil,78,48,66,65,243,500
1459470616,Dear White Women,0,0,0,0,16,16
1459520830,Balbaro Que Podcast,0,0,0,0,1,1
1459527171,Le Batard & Friends Network,1,1,0,2,493,497
1459579977,New Jump City,0,0,0,0,6,6
1459600791,The Humble Hoof,0,0,0,0,10,10
1459613877,Exactamundo with Eddie Della Siepe,0,0,0,0,18,18
1459642847,The Level Up English Podcast,0,0,0,0,14,14
1459648280,Hey Jessica,0,0,0,0,50,50
1459657136,13 Minutes to the Moon,7,6,9,21,410,453
1459675744,Broken Ground,1,0,0,0,20,21
1459685850,Too Tired To Be Crazy with Violet Benson,5,0,0,1,44,50
1459688896,Firearm Trainer's Podcast For American Firearm Instructors,0,0,0,0,11,11
1459689875,The Melanated Social Work Podcast,1,0,0,1,24,26
1459712981,The Chernobyl Podcast,24,3,8,14,370,419
1459768556,Go For Production with Brandon Riley: A Filmmaking Podcast,0,0,0,0,7,7
1459768628,Movie Night,0,0,0,1,1,2
1459770134,So...What Do You Do Again?,0,0,0,0,12,12
1459808234,Cream City Pacers,1,0,0,0,2,3
1459827588,Going Racing with Adam Carolla,0,0,1,0,0,1
1459884105,Bitcoin Magazine Podcast,0,0,0,0,7,7
1459899275,The Shrink Next Door,38,40,31,34,357,500
1459899327,Life is Short with Justin Long,3,2,5,7,33,50
1459899343,Inside Star Wars,23,15,12,10,83,143
1459906445,Private Aviation Insider,0,0,0,0,1,1
1459931231,The Soul Awakening Podcast,0,0,0,1,36,37
1459939394,"Eat, Pray, Britney",5,0,6,4,30,45
1459946034,Ayurveda Life School Podcast,0,0,0,1,49,50
1459947195,The Aloha Press - Golf Podcast,0,0,0,0,16,16
1459950159,Couples Coaching with Natalie Clay,0,0,1,1,48,50
1459956041,El Cuido Podcast,0,0,0,0,16,16
1459959514,RNZ: The Detail,3,1,4,1,46,55
1459993408,Value Investing with Legends,2,1,4,1,6,14
1460021700,Fowl Mouths Podcast,1,0,0,0,12,13
1460023991,Physiology by Physeo (An InsideTheBoards Podcast),0,0,0,0,5,5
1460025534,Up All Night: An Are You Afraid of the Dark Podcast,0,1,0,1,26,28
1460029661,From the Field,0,0,0,0,6,6
1460030295,Simply Put,0,0,0,0,74,74
1460030305,Your Undivided Attention,2,0,2,3,76,83
1460036034,The Rexin Around Show: A Star Wars Podcast,1,1,0,0,322,324
1460036325,Bavarian Football Works: For Bayern Munich fans,1,0,0,0,7,8
1460045342,EnviroMENTAL,0,0,0,0,2,2
1460047965,What Goes Up,0,0,1,2,30,33
1460051721,BiggerPockets Business Podcast,4,3,6,5,118,136
1460055048,DBT Weekly,0,0,0,0,17,17
1460055316,Deep Background with Noah Feldman,5,4,2,4,35,50
1460062355,The Event Safety Podcast,0,0,0,0,1,1
1460092075,American Nightmare Podcast Presents...,0,0,0,0,9,9
1460137502,The Dear Body Podcast,0,0,0,1,49,50
1460147025,Unashamed with Phil & Jase Robertson,2,2,4,2,174,184
1460154838,Wisdom From The Top,2,3,0,2,26,33
1460156192,Mexican Fluency Podcast,0,0,0,0,9,9
1460157002,Million Dollaz Worth Of Game,2,1,2,0,45,50
1460168984,Inside Marvel: A WandaVision Aftershow,2,1,1,3,34,41
1460169297,Girl CEO Podcast,1,0,1,2,46,50
1460173668,MLVC: The Madonna Podcast,3,1,0,1,15,20
1460182320,Outdoor News Radio,1,0,0,0,1,2
1460201385,It's All Bad,0,1,0,2,47,50
1460202619,Chirpin' DMV,0,0,0,0,11,11
1460206153,Elderberry Tales,0,0,0,0,7,7
1460255222,Hurry Up and Wait,0,0,0,0,15,15
1460265414,The Iron Dice,0,0,0,0,42,42
1460265667,Ringside Rant,0,0,0,0,12,12
1460272793,Life Worth Chasing,0,0,0,0,66,66
1460276302,Code source,0,0,0,0,1,1
1460297058,Boston Harbor Horror Presents,0,1,5,0,12,18
1460310663,What's the Score Podcast,0,0,0,0,1,1
1460319105,Primetime,3,0,0,1,21,25
1460329478,Dead Ass with Khadeen and Devale Ellis,5,4,6,5,480,500
1460334766,The One Inside: An Internal Family Systems (IFS) podcast,0,0,0,0,12,12
1460340229,185 Miles South,0,0,0,0,58,58
1460355472,21.FIVE - Professional Pilots Podcast,0,0,0,0,50,50
1460397186,Learn to Code in One Month,0,0,1,1,18,20
1460398144,RC STUFF,0,0,0,0,2,2
1460403775,IBM Blockchain Pulse,0,0,0,0,4,4
1460438143,Wheeling Wine And Whiskey,0,0,0,0,50,50
1460445344,L'italiano vero,0,0,0,0,7,7
1460494764,Bar Exam Game Plan℠,0,0,0,0,6,6
1460527936,Boom Boxxx,1,1,2,2,7,13
1460535096,The DiscoverU Life Podcast,0,0,0,0,1,1
1460567441,We Say Things - an esports and Dota podcast with SUNSfan & syndereN,0,1,0,2,83,86
1460580131,We Gotta Believe,3,0,0,0,140,143
1460580357,The Literary Life Podcast,3,0,0,2,65,70
1460581266,The 21st Rewrite,0,0,0,0,3,3
1460582675,Manifest It A.L.L. Podcast,0,0,0,0,31,31
1460590581,Americana Podcast,0,0,0,0,30,30
1460595349,Earth Break,7,6,3,6,28,50
1460600818,The Charlie Kirk Show,14,0,0,4,168,186
1460601634,The David Bach Show,0,0,1,0,64,65
1460603182,Serve The People Podcast,0,0,0,0,3,3
1460608243,The Cheese Room Podcast (THFC),0,0,0,0,4,4
1460626741,The Infant Toddler Toolbox,0,0,0,0,5,5
1460632845,Livin' the Suite Life Podcast,0,0,0,0,7,7
1460634070,Committed to Us,0,0,3,1,43,47
1460685072,La Story,0,0,0,0,2,2
1460690037,This Family Tree Podcast,5,0,0,0,30,35
1460710219,The Senior Golfer Advisor,0,0,0,0,2,2
1460713022,The Collector Car Podcast,0,0,0,0,4,4
1460716677,Science Rules! with Bill Nye,51,16,19,28,334,448
1460719638,approachable.,4,5,6,5,180,200
1460730948,The Underculture with James Adomian,0,0,0,0,50,50
1460732338,The Visceral Voice Podcast,0,0,0,0,9,9
1460733175,The Patdown with Ms. Pat,3,0,1,0,46,50
1460734936,Panic with Friends - Howard Lindzon,0,0,0,0,3,3
1460743150,That Witch Life,1,0,0,0,22,23
1460746245,Explicitly Pro-Life,18,1,0,0,31,50
1460757606,MLS: The Call Up,2,0,0,1,50,53
1460805013,Bigfoot and Beyond with Cliff and Bobo,4,4,5,4,102,119
1460805372,Maximized Minimalist Podcast,0,1,0,0,49,50
1460821937,Real Bodybuilding Podcast,1,0,0,1,48,50
1460825733,None of the Above,0,0,0,0,5,5
1460830128,Anaya Ivy,1,2,1,1,157,162
1461008135,You're Welcome with Hilary Rushford,3,0,0,0,147,150
1461141261,My Digital Farmer | Marketing Strategies for Farmers,1,0,0,0,11,12
1461164275,Win Daily Sports Show: WinDailySports.com,0,0,0,0,25,25
1461244394,The ADHD Smarter Parenting's Podcast,1,0,0,0,5,6
1461247838,The Road to Emmaus with Scott Hahn,2,0,0,0,28,30
1461312941,The Oath with Chuck Rosenberg,7,3,3,6,481,500
1461441094,Nights At The Round Table Pod,3,1,0,1,87,92
1461441374,Health Anxiety Show,0,0,2,0,48,50
1461470244,Pilot Protection Services Podcast- Aviation Podcast,0,0,0,1,0,1
1461493560,Life Kit,6,3,6,5,30,50
1461493575,Life Kit: Money,0,0,1,1,2,4
1461494159,Life Kit: Health,2,1,0,1,6,10
1461499182,"Incarceration, Inc. with Van Jones",2,0,1,0,11,14
1461506762,Morning Tide with Ted Ramey,0,0,1,1,7,9
1461511691,WTOP’s American Nightmare Series,8,18,18,16,120,180
1461515071,The Zane Lowe Interview Series,3,0,0,2,32,37
1461515995,Redesigning Life with Sabrina Soto,1,0,3,2,68,74
1461518124,"The FitMind Podcast: Mental Health, Neuroscience & Mindfulness Meditation",1,0,2,0,45,48
1461593509,The Force Fed Sci-Fi Movie Podcast,0,0,0,0,2,2
1461631542,Mediocre Golf Podcast,0,0,0,0,8,8
1461649567,The Anime Lately Podcast,0,0,0,0,4,4
1461664501,"Freely Filtered, a NephJC Podcast",0,0,0,0,17,17
1461677443,How Neal Feel,14,5,1,1,29,50
1461681314,Estimation 180,0,0,1,0,19,20
1461703526,"Cabot Cove Confidential: A ""Murder, She Wrote"" Podcast",0,0,1,0,23,24
1461704914,The Homegrown Helpers,1,0,1,2,31,35
1461705002,Sports Info Solutions Baseball Podcast,0,0,0,1,4,5
1461707895,The Astroholic Explains,0,0,0,0,1,1
1461709440,Magic Monday,2,0,0,1,113,116
1461716128,Ten Very Big Books - A Malazan Readthrough Podcast,2,0,0,2,31,35
1461719659,Bigfoot Terror in the Woods Sightings and Encounters,2,0,1,0,47,50
1461724650,The Empowered Nurse Podcast,0,2,0,0,45,47
1461725746,Paranormal Portal,3,0,5,4,33,45
1461727960,The Living Force: A Star Wars Podcast by Youtini,0,0,0,1,19,20
1461729348,The Training For Trekking Podcast,0,0,0,2,16,18
1461730531,Talkin' Halos,2,0,1,1,52,56
1461748146,The Girls Bathroom,22,3,16,13,236,290
1461757277,Les Brown Archive's Podcast,2,0,0,0,2,4
1461762316,The Graham Cochrane Show,0,0,0,0,164,164
1461769024,Colors of the Dark,1,1,4,2,38,46
1461771083,"Fundamental Health with Paul Saladino, MD",1,1,0,0,48,50
1461771992,Lew Later,2,0,3,3,183,191
1461774020,The Skillful Podcast,0,0,0,0,26,26
1461777308,SURGE Strength - Dryland & Strength Training for Swimming,0,0,0,0,5,5
1461786022,GMBN Presents The Mountain Bike Podcast,0,0,0,0,8,8
1461841525,The TryPod,2,4,2,1,41,50
1461857952,Big Life Kids Podcast,1,0,2,2,45,50
1461884747,VAST Horizon,4,5,14,4,23,50
1461999702,7am,5,7,5,7,73,97
1462001603,Realtree Outpost,1,0,0,1,13,15
1462001757,Wholesale To Millions,0,0,1,0,5,6
1462016612,UI Narrative: UI/UX Design and Product Strategy,0,0,1,2,27,30
1462051732,Cal's Week in Review,11,3,5,7,474,500
1462055621,Harper Rose Trilogy,0,1,0,1,2,4
1462075800,The Dungeon Run Podcast,0,0,0,0,50,50
1462096941,Life Will Be the Death of Me with Chelsea Handler,12,0,2,0,36,50
1462120160,How To Love Lit Podcast,0,0,0,0,20,20
1462120258,Tales From The Rabbit Hole,0,0,0,0,6,6
1462186184,Wheelin',0,0,1,0,5,6
1462188092,The Rabbi Stark Podcast,0,0,0,0,4,4
1462188362,My Funeral Home Stories,2,2,5,6,339,354
1462189254,Fierce,0,0,1,0,19,20
1462190737,The Rest of the Story™ Podcast,5,2,2,7,139,155
1462192400,Creating Confidence with Heather Monahan,0,0,0,0,50,50
1462195742,The Al Franken Podcast,5,0,2,0,43,50
1462201421,Bankshot,0,0,0,0,3,3
1462205941,WRAL News Daily,0,0,0,1,4,5
1462207570,Teachers in America,1,0,0,0,4,5
1462213019,Friend of a Friend,1,0,1,0,13,15
1462214941,For Canon Sake,0,0,0,0,23,23
1462214964,The Long View,5,1,1,2,30,39
1462216572,Truth Be Told,5,1,1,1,96,104
1462221862,Lesbians In Love - the LGBTQ show for women in relationship with women,0,0,0,1,18,19
1462231846,Intuitive Eating for the Culture,0,0,0,0,12,12
1462234964,Digging Deep: a boscia skincare podcast,0,0,0,0,2,2
1462241492,Meraki Unboxed,0,0,0,0,2,2
1462279220,The Hudson Valley Disc Golf Podcast,0,0,0,0,4,4
1462286425,Teaching Autism and Special Education,0,0,0,0,5,5
1462287744,Crickets to Cha-Chings,0,0,0,0,100,100
1462288566,UnCommon Law,0,0,0,1,23,24
1462324602,Nice Try!,29,15,5,11,140,200
1462331025,Modern Renegades,1,0,0,0,15,16
1462336009,The SLP Now Podcast,0,0,1,1,31,33
1462339102,Kristen Welch,0,0,0,0,3,3
1462360829,Sewing For The Weekend,2,0,0,1,16,19
1462368967,In the Open,1,0,0,0,0,1
1462418412,The Genetics Podcast,0,0,0,0,3,3
1462431615,Houndsman XP - Sportsmen's Nation,1,1,3,3,105,113
1462449171,The Corporate Director Podcast,1,0,1,0,12,14
1462484363,Out Alive from BACKPACKER,2,0,3,6,73,84
1462495693,The Pod and the Pendulum,0,2,0,1,24,27
1462498611,Couldn't Help But Wonder: A Sex and the City Podcast with Jamie Lee and Rose Surnow,9,4,2,4,143,162
1462533687,Being Earnest,0,1,0,0,23,24
1462537296,Jacked Athlete Podcast,0,0,0,0,1,1
1462539226,Self Evident: Asian America's Stories,0,0,0,0,30,30
1462543521,Plastic Surgery Uncensored,1,0,0,2,27,30
1462579812,Manifest with Tori DeSimone,11,12,6,2,19,50
1462605329,Civilized,2,1,2,1,25,31
1462617253,Leanne Ward Nutrition,0,0,1,0,49,50
1462620349,The Apparel Entrepreneurship Podcast,0,0,0,0,6,6
1462629288,The Poker Grid,0,0,0,1,30,31
1462634386,Crawfordsville Connection,0,0,0,0,2,2
1462642371,Ageless,0,0,0,3,145,148
1462649946,The David McWilliams Podcast,0,0,0,0,7,7
1462650519,White Lies,5,2,8,11,474,500
1462656660,Seeking Witchcraft,3,1,4,1,37,46
1462683950,One in Ten,0,0,0,0,4,4
1462691469,LA LISTA: A Latinx Writers Podcast,0,0,0,0,6,6
1462702850,The Closet Conservative Podcast,5,0,0,0,12,17
1462706458,With Whit,12,7,11,5,15,50
1462757216,Colorful Conversations: DIY & Home Design,0,0,1,2,41,44
1462757524,Mushroom Revival Podcast,0,0,0,2,11,13
1462772852,The Collecting Cars Podcast with Chris Harris,2,1,2,6,22,33
1462776122,My Climate Journey,0,0,0,1,15,16
1462785477,Casio's Cut,1,0,0,0,21,22
1462787414,THE PAYOFF,4,2,1,0,30,37
1462808218,Bleed Cubbie Blue: for Chicago Cubs fans,0,0,0,0,5,5
1462871328,Sweet T: The Unofficial Southern Charm Podcast Podcast,4,2,2,1,277,286
1462884931,Fresh From The Pod - Gardening Stories,0,0,0,0,3,3
1462962051,Helping Couples Heal Podcast,0,0,0,2,25,27
1462978030,K-Pod,0,0,0,0,4,4
1463047179,Long Ash Podcast,0,0,1,0,3,4
1463081342,13 Alibis,3,2,4,7,97,113
1463085161,Anyone Can Run,0,0,0,0,9,9
1463089708,The EMS Lighthouse Project,0,0,0,1,5,6
1463109375,Paired,0,0,0,0,43,43
1463112037,Skincare Secrets,0,0,2,2,50,54
1463118998,The Intellectual Dollar Tree,5,0,0,0,1,6
1463120911,Drawing Inspiration,0,0,0,0,6,6
1463124516,AC/DC: Beyond The Thunder,0,0,0,0,2,2
1463174591,OfflineTV Podcast,5,1,1,2,61,70
1463196836,Three Gossip Girls - A Gossip Girl Podcast,0,0,0,0,19,19
1463204309,The Thermal Podcast,0,0,0,0,5,5
1463214827,The SimplyBe. Podcast,0,0,0,0,50,50
1463219123,Melissa and Lori Love Literacy,0,0,0,0,4,4
1463219412,Rise & Shine with Adrienne Gold Davis,0,0,0,0,11,11
1463222879,Have It All,0,0,2,1,47,50
1463225367,The Putting Couch Podcast presented by SeeMore Putter Company,0,0,0,0,7,7
1463229926,Ghostrunners,0,0,0,0,50,50
1463239577,SKYlights,0,0,0,0,14,14
1463273791,Delving Into Islam,0,0,0,0,1,1
1463278988,Erotica Bedtime Stories,0,0,0,0,2,2
1463305044,Daily Star Trek News,0,1,0,1,19,21
1463322273,Encore une histoire,0,0,0,1,9,10
1463327106,Relationship Transformers,3,0,0,0,39,42
1463337469,The River Radius Podcast,0,0,0,0,8,8
1463343238,The Victor Marx Podcast,0,0,0,0,10,10
1463344121,Deck of Friendship!,1,0,0,0,38,39
1463351676,The Arch and Anth Podcast,0,0,0,0,1,1
1463356560,Brown Girl Self-Care,0,0,1,0,31,32
1463398695,Today is the Day,0,0,0,0,21,21
1463398832,Speaking of Bitcoin (formerly Let's Talk Bitcoin!),0,0,0,0,1,1
1463400941,Adulting,0,0,0,3,47,50
1463414537,The Carlat Psychiatry Podcast,0,0,3,0,18,21
1463427673,Bobby and Jens,1,0,0,0,10,11
1463441793,Wall Street Oasis,1,0,1,6,192,200
1463447461,Craft A Life You Love,1,0,0,1,48,50
1463468736,Badass Digital Nomads,1,0,0,0,37,38
1463527666,Horror Soup,5,0,1,4,71,81
1463601870,Parenting Without Power Struggles,0,0,1,0,26,27
1463604638,Faithless Brewing: MTG for the Rogue Deckbuilder,1,0,0,0,28,29
1463608439,Queer The Table,0,0,0,0,11,11
1463624066,Wildfire,4,7,6,3,14,34
1463640779,Backstage Journal Podcast with Rhett Shull,0,2,6,0,19,27
1463648278,The McIlwraith Statements,0,0,0,1,27,28
1463743075,The Quickie - Interviews for Graphic Designers,0,0,0,1,82,83
1463784885,The Engineers Collective,0,0,0,0,2,2
1463821672,She’s Here for It,1,0,1,0,48,50
1463828705,Bird Sh*t Podcast,0,0,0,1,12,13
1463858676,Locked On Big 10 – Daily College Football & Basketball Podcast,0,3,1,1,12,17
1463858682,Locked On SEC – Daily College Football & Basketball Podcast,3,2,0,0,13,18
1463860501,We Like Theme Parks Podcast,0,0,0,1,19,20
1463861548,Busted Open,11,4,7,9,75,106
1463862139,SLOWMO,0,0,0,0,2,2
1463896106,Just the Zoo of Us,0,0,1,0,37,38
1463979546,Morbidology,12,17,11,4,164,208
1463991214,Girl On Top: ShallonXO,13,1,0,2,83,99
1464038604,Sound Investing,0,1,0,0,11,12
1464056693,Quick Question with Soren and Daniel,0,0,2,2,46,50
1464086460,Jewish History Soundbites,1,0,0,0,32,33
1464101742,Culturally Relevant with David Chen,5,0,1,3,105,114
1464163280,Tailgate Country,1,0,0,0,2,3
1464170865,Sneaker Closet Podcast,4,0,0,0,46,50
1464212261,Quiz Quiz Bang Bang Trivia,0,1,1,2,46,50
1464225551,"Let's Go, Atsuko!",0,0,0,1,27,28
1464240720,Bussin' With The Boys,6,0,2,5,484,497
1464254263,Psychology After Dark,0,0,1,0,12,13
1464297830,Charm Talk: A Consideration of Southern Charm,2,2,2,6,32,44
1464306524,Adventure Bound,0,0,0,0,54,54
1464461126,The Wolf's Den,4,4,2,2,92,104
1464470280,Husband In Law,2,3,1,1,95,102
1464473810,Digging Deep with Cody Janssen,0,0,0,0,6,6
1464477951,All Things Testosterone,2,0,0,1,31,34
1464479946,Street Parking Podcast,0,0,0,2,36,38
1464481655,The PCOS Nutritionist Podcast,0,0,1,0,20,21
1464488062,"Parental As Anything, with Maggie Dent",1,0,4,3,44,52
1464494326,WHAT THE HELL DO I EAT?,1,0,0,1,6,8
1464504909,Great British Quilter Podcast,0,0,0,0,5,5
1464506383,The Kabbalah of You,0,0,0,0,1,1
1464506493,The Pashmina Podcast,0,0,0,0,1,1
1464516469,The Great One on 1,2,1,1,2,38,44
1464524725,Encyclopedia Womannica,6,2,0,1,41,50
1464558838,Menace 2 Sports with Zach Smith,23,9,4,11,144,191
1464565197,Conversations in Close Protection,0,0,0,0,4,4
1464566199,The Mindful Corner Podcast,0,0,0,0,34,34
1464567770,Very Bad Therapy,3,1,3,0,28,35
1464577811,The Official Average Boy Podcast,0,1,0,1,48,50
1464586861,The Two Princes,1,1,0,5,43,50
1464595175,Talking Records,0,0,0,0,7,7
1464606843,Brawl Time- A Brawl Stars Podcast,3,0,0,1,46,50
1464621845,Robert Cabral's Canine Conversations - Dog Training Podcast,1,0,1,0,31,33
1464697654,First Move with Julia Chatterley,1,0,0,0,2,3
1464722246,Podcasting Q&A,0,1,0,0,16,17
1464725572,The Chasing Daylight Podcast,0,0,0,0,20,20
1464733123,The Nitty Gritty Show,0,0,0,2,75,77
1464745258,Locked On Brewers- Daily Podcast On The Milwaukee Brewers,5,1,0,0,7,13
1464755075,The MomForce Podcast Hosted by Chatbooks,0,0,0,2,48,50
1464765509,So You Want to Be a Marine Biologist,0,0,0,0,12,12
1464766741,Best Friends with Nicole Byer and Sasheer Zamata,1,0,1,1,47,50
1464767919,The WoMed,6,5,3,3,96,113
1464774523,Dumb Dad Podcast,0,0,0,0,21,21
1464852714,Cryptic,3,1,0,0,21,25
1464919521,Dateline NBC,126,78,84,48,354,690
1464919907,The Disney Vacation Club Show,1,2,2,2,14,21
1464920506,Building Your Business with doTERRA-Empowered Success,0,0,0,0,6,6
1464938655,ILLUMINATORS,0,0,0,0,12,12
1464953082,Connected Families Podcast,0,0,0,0,38,38
1464953319,DJ & PK in the Morning,2,0,0,0,3,5
1464954218,This Land,24,13,19,23,389,468
1464962252,The Everyday Style School,0,0,0,0,30,30
1464990187,The Zone Sports Network - Utah Jazz,1,0,0,1,3,5
1465024739,Was That Good For You? - Raya Carmona,2,0,0,1,23,26
1465089999,Cereal Killers,0,0,0,0,50,50
1465112521,DogSpeak: Redefining Dog Training,0,0,0,0,3,3
1465151153,Current ECG Podcast,0,0,0,0,1,1
1465161233,Pivot to the Future with Will.i.am and Omar Abbosh,2,0,0,1,4,7
1465163940,BTS AF,0,1,1,1,12,15
1465176074,Tennis Anyone with Michael Kosta,1,0,0,2,50,53
1465180254,Real Estate Strategies with Ken McElroy,0,1,0,1,46,48
1465180342,Draftsmen,0,1,3,0,46,50
1465181848,Book to New Worlds (A D&D Audiobook): Narrated by Jack Voraces,1,0,0,0,7,8
1465230244,Good Omens Podcast from TV Podcast Industries,0,0,1,0,2,3
1465232233,The Never Rad Miscellany,0,0,0,0,5,5
1465262360,Get Messy Podcast,0,0,0,0,6,6
1465273008,Dumb Blonde,2,0,0,0,48,50
1465286477,Ringer Dish,25,9,7,7,141,189
1465290044,Elis James and John Robins,1,0,0,3,46,50
1465291335,Behavior Bitches,2,0,0,0,230,232
1465299678,Honeybee Kids - Bedtime Stories,8,0,3,3,36,50
1465313328,Depression to Expression Podcast,0,0,1,0,23,24
1465334342,Man In The Window: The Golden State Killer,41,40,44,43,332,500
1465377461,Purpose Driven Mom Show,0,0,0,0,50,50
1465470771,No Stylist Left Behind,0,0,0,0,30,30
1465476559,The Crate 808 Podcast,0,0,0,0,7,7
1465487889,The Devdutt Pattanaik Show | Mirchi,3,1,1,0,6,11
1465592411,Poorly Read Podcast - Season One: Harry Potter,1,1,1,0,13,16
1465622635,Dream of Italy,1,0,2,1,70,74
1465669980,Locked On Rays- Daily Podcast On The Tampa Bay Rays,2,1,0,0,17,20
1465673770,Fantasy Football Advice Podcast,1,0,0,0,45,46
1465681054,Fab Fertility,1,0,0,0,45,46
1465689539,SnapBack Sports Pod,1,1,0,2,493,497
1465700348,The CouRage and Nadeshot Show,3,0,0,2,45,50
1465767420,Land of the Giants,15,12,9,11,71,118
1465778040,The Guerilla Cricket Podcast,0,0,0,0,1,1
1465785780,Document,2,2,2,6,18,30
1465791989,What Now? A JTS Podcast,0,0,0,0,6,6
1465880396,The Suspendables,0,0,0,0,4,4
1465893378,Runners Without Limits,0,1,1,0,48,50
1465904347,What We Learned Today,0,0,0,1,0,1
1465937091,Changes with Annie Macmanus,1,1,1,1,56,60
1465961157,Two Drunk Moms,0,0,0,0,15,15
1465962719,Unleash Your Strengths w/ Eddie Villa,0,0,0,0,95,95
1465963922,Korean American Perspectives,0,0,0,0,1,1
1465981059,Selfmade with Nadeshot,0,0,1,4,74,79
1465981375,The GolfRules Questions Podcast,0,0,0,0,2,2
1465981993,Let Us Eat Cake,0,0,0,0,13,13
1465994842,SlabStox Sports Card Trading,0,1,0,1,7,9
1466031863,The Stag's Stable,2,1,0,0,3,6
1466064652,DJ PH,1,0,0,0,22,23
1466080869,How Men Think with Brooks Laich & Gavin DeGraw,35,24,33,27,113,232
1466082738,American Osteopathic College of Physical Medicine and Rehabilitation,0,0,0,0,1,1
1466126525,Murder Room,0,0,0,0,1,1
1466138723,Magik Vibes,0,0,0,0,79,79
1466142599,Adventures Of The StarKeepers,0,0,1,0,30,31
1466166364,Real Pod,0,0,0,0,50,50
1466172823,Stadium and Gale: A Florida Gators Podcast,2,2,1,4,143,152
1466183042,Gluten Free You & Me,0,1,1,2,46,50
1466184341,Starting In Te Reo Maori Podcast,3,0,1,0,4,8
1466187704,Clean Sport Collective,4,0,2,2,31,39
1466232309,FreightWaves Insiders,0,0,0,0,1,1
1466256168,That's Not My Age,0,0,0,1,6,7
1466261548,"Sex, Love, and Addiction: Healing Conversations for Gay, Bisexual, and Transgender Men",0,0,0,0,2,2
1466264114,Swinger University - An Educational Podcast About Swinging,0,0,0,0,5,5
1466267575,The Spark Show,0,0,0,0,33,33
1466271396,Spectacular Failures,15,10,6,8,161,200
1466271998,Black Women Travel Podcast,0,0,0,0,12,12
1466283984,The Balanced Life,1,0,0,1,48,50
1466308274,Live To Eat with Candace Nelson,0,0,1,0,49,50
1466315625,DIVINELY HUMAN,0,0,0,0,16,16
1466321575,True Crime Chronicles,6,2,8,9,92,117
1466323126,"What Goes On, BTS? - An ARMY Made BTS Podcast",0,0,0,0,5,5
1466330985,Culpable,27,25,22,17,409,500
1466344305,AWS Morning Brief,0,1,0,0,6,7
1466445204,Consider Before Consuming,0,1,3,2,44,50
1466446583,Around the Circle: An Enneagram Podcast,0,0,0,0,34,34
1466448710,Come to Where I'm From,0,0,1,2,19,22
1466486707,The Heavy-Duty Parts Report,0,0,0,0,3,3
1466549386,What Magic Is This?,1,1,1,1,34,38
1466576565,The Fiona Show,0,0,0,0,2,2
1466630842,House Culture,0,0,0,0,3,3
1466660180,PORTRAITS,0,0,0,0,6,6
1466667116,Made For This with Jennie Allen,0,2,0,2,180,184
1466669216,Let's Talk ETFs,1,0,0,1,9,11
1466686717,Thoughts on the Market,0,2,2,3,33,40
1466697207,Overheard at National Geographic,17,3,13,42,381,456
1466699089,African Folktales Podcast,0,0,0,0,8,8
1466715135,Chris and Dave’s Reality Cast: Bachelor & Temptation Island,1,0,1,1,28,31
1466725800,Co-Parenting Past Chaos,0,0,0,1,17,18
1466758143,The Conduct Science Podcast,0,0,0,0,1,1
1466772819,Wild Animals,0,0,0,1,5,6
1466812661,Juice Worlds Death Conspiracy Theories,3,0,2,1,14,20
1466824259,Duolingo French Podcast,0,0,0,3,6,9
1466851347,Theories of the Third Kind,43,17,20,19,401,500
1466867032,Black History in Two Minutes (or so),0,0,0,0,11,11
1466867273,Fintech Beat,0,0,0,0,11,11
1466901702,BrandoCast with Brendan Smith,0,0,0,0,17,17
1466902528,Weebology Podcast,0,0,0,0,10,10
1466909218,The Soccer Soup Podcast,0,0,2,2,84,88
1466940832,Monocle 24: The Monocle Minute,0,0,0,0,2,2
1467003572,The PC Gamer Show,3,1,2,0,3,9
1467032570,The Soulful Hunter Podcast,1,0,0,1,14,16
1467067991,Beyond the Pink Cloud,0,0,0,0,9,9
1467099082,Own Woman,0,0,0,0,7,7
1467108547,The SwimSwam Podcast,0,0,0,0,3,3
1467170363,Secret Sonics,0,0,0,0,13,13
1467191107,Bob Stroud's One 45 of the Week,0,0,2,1,0,3
1467232418,"Medical Myths, Legends & Fairytales",7,1,0,0,9,17
1467256065,1865,7,0,1,5,37,50
1467269399,Todd Durkin IMPACT Show,0,1,0,0,49,50
1467279706,The SCP Foundation Database,0,0,0,0,10,10
1467281044,Firsthand: Geniuses,0,0,0,0,9,9
1467292185,Extremities,2,2,2,6,139,151
1467297559,Hacks on Tap with David Axelrod and Mike Murphy,5,1,2,1,41,50
1467317304,Broken Silicon,0,0,0,0,27,27
1467329441,Ranger Danger: Archives,0,0,0,0,2,2
1467374705,Casual Watch Talk,0,0,0,0,4,4
1467404358,ColdFusion,0,0,0,0,18,18
1467408488,The Zen of Everything,0,0,0,0,3,3
1467427607,The Full-Time FBA Show - Amazon Reseller Strategies & Stories,2,0,1,0,54,57
1467432231,Nurse Educator Tips for Teaching,0,0,0,0,1,1
1467437212,Illini Inquirer Podcast,0,1,0,0,31,32
1467439262,ADV Podcasts,0,0,3,2,15,20
1467454679,Star Wars Theory,3,2,2,12,239,258
1467480727,Up is Down Podcast,2,0,0,0,19,21
1467481703,The Origins Podcast with Lawrence Krauss,3,5,1,2,7,18
1467515562,Your First Million,0,0,0,1,80,81
1467517796,Bob Thurman Podcast: Buddhas Have More Fun!,1,0,0,1,8,10
1467535513,Community Influencer® Show,1,0,1,0,16,18
1467639214,Emma’s Diary from the Road,0,0,0,0,40,40
1467639342,People's Party with Talib Kweli,140,0,1,10,218,369
1467646674,Buddahood Podcasting,0,0,0,0,1,1
1467657266,The All Things Overlanding Podcast,0,0,0,1,4,5
1467679266,Cut Through Nutrition,0,0,1,2,42,45
1467711251,The Illustration Department Podcast,0,0,1,2,57,60
1467732980,Face 2 Face,0,0,0,0,1,1
1467756143,Kingdom Hairstylist's show,0,0,0,0,9,9
1467771598,Waldorfy,0,0,0,0,15,15
1467820967,At The Bridge Pod: A Chelsea FC Podcast,0,0,0,1,5,6
1467823230,Real Personal Finance,0,0,0,0,30,30
1467828055,High Vibin’ It,0,1,0,0,27,28
1467834910,Juna Women Podcast,0,0,0,0,15,15
1467837883,The Kids Get Rich Podcast,1,0,0,0,4,5
1467840240,laborvision,0,0,0,0,2,2
1467977625,The Enduring Gifts of MARVIN GAYE Podcast,0,0,0,1,1,2
1467982091,Awesome Movie Year,0,0,0,0,3,3
1467994405,The Four Jack Podcast - A Global Golf Podcast,1,0,0,0,1,2
1468013270,2 Bears 1 Cave with Tom Segura & Bert Kreischer,18,8,10,18,134,188
1468028667,The DMT Xperience Podcast,1,1,0,0,16,18
1468032555,Knights of the Rolled Table | a Dungeons & Dragons podcast,0,0,1,0,21,22
1468033698,She's On The Money,92,22,34,20,28,196
1468057141,Oculus Quest Cast,0,3,0,1,7,11
1468061855,The Boy Mom Podcast with Monica Swanson and Friends,1,0,0,0,49,50
1468070342,Blended Life - A Blended Family Podcast,4,0,1,2,10,17
1468107412,Chica Travel with Lelo,0,1,0,2,54,57
1468127632,The Widowed Mom Podcast,0,0,0,1,49,50
1468149206,Bark Talk with Bonnie,0,0,0,0,2,2
1468225873,Wookieeleaks: A Mandalorian Aftershow | A New Rockstars Podcast,1,1,0,0,18,20
1468233826,"Plantbased, Not Perfect",0,0,0,0,50,50
1468319416,Starting Point with Casey Jennings,0,0,0,0,7,7
1468332063,Noble Blood,31,15,11,24,416,497
1468355828,Fat Murder Podcast,1,0,1,0,12,14
1468368093,Inside Out Health with Coach Tara Garrison,0,0,0,0,11,11
1468373285,Upland Nation,4,1,0,2,30,37
1468377792,Let The Darkness Take Control,1,0,1,0,9,11
1468381716,Grow Your Own Food,0,0,1,0,9,10
1468394782,Fanboys,0,0,0,0,5,5
1468396157,Burnin' Daylight,0,0,0,0,2,2
1468409757,Tests and the Rest: College Admissions Industry Podcast,0,0,0,0,7,7
1468409996,No Dunks,6,1,3,5,485,500
1468508189,iRacing Downshift,1,0,0,0,5,6
1468510314,Present Company,0,0,0,0,9,9
1468518223,Watts Up,1,0,0,0,3,4
1468527982,All Rabbi Yaakov Wolbe Podcasts,0,0,0,0,2,2
1468533126,The Three Questions with Andy Richter,1,7,1,2,39,50
1468537756,The Biblical Mind,0,0,0,1,20,21
1468542488,Inside the Birds: A Philadelphia Eagles Podcast,6,6,6,6,199,223
1468546812,The Withering Effect - Minecraft Podcast,2,0,2,3,17,24
1468559046,Sara Carter Show,5,2,2,4,223,236
1468564406,Cracking the Code of Spy Movies!,0,0,0,0,5,5
1468574292,Fruitbowl,0,0,0,0,15,15
1468589450,The True Tunes Podcast,0,0,0,1,8,9
1468607534,Good Kids,9,5,0,1,34,49
1468678544,The Alarmist,5,2,4,1,38,50
1468715294,Intentional Leader with Cal Walters,0,0,0,1,24,25
1468715531,The Babylon Bee,14,6,4,13,275,312
1468722580,E se ... podcast,0,0,0,0,7,7
1468725665,Sense of Soul Podcast,1,0,0,1,22,24
1468726055,Wrestling Perspective Podcast,0,0,0,0,8,8
1468805026,Bad Heroes,0,0,0,1,12,13
1468806244,Por el Placer de Vivir con el Dr. Cesar Lozano,1,0,0,0,16,17
1468827005,Road to the Trials,0,0,0,0,37,37
1468896686,Last Day,10,9,8,17,315,359
1468915450,The Moral Imagination,0,0,0,0,13,13
1468917807,Housewives Tonight!,0,0,0,0,27,27
1468926430,Manifest Mad Money,0,0,1,0,26,27
1468939064,Insight with Chris Van Vliet,2,1,1,3,492,499
1468949359,The Turn On,0,0,0,0,7,7
1468956772,Carrier,2,4,8,6,30,50
1468959707,Dreamnasium sci-fi audio drama anthology,0,0,0,0,2,2
1468964257,Archive Seasons 1-6 – Writing Excuses,0,0,0,0,1,1
1468992067,New York Daily News,0,0,0,2,1,3
1469002731,What We're Drinking with Dan Dunn,3,1,1,0,15,20
1469068121,Slimming World Podcast,2,2,1,5,137,147
1469090348,Lost Art,0,0,0,0,1,1
1469092311,"Mixing Music | Music Production, Audio Engineering, & Music Business",1,0,0,0,57,58
1469111932,Drone to 1K Podcast by Drone Launch Academy,0,0,0,2,124,126
1469113217,Game of Roses,24,7,11,14,444,500
1469132612,Couch and The Rube,1,0,0,0,7,8
1469151663,Moonrise,2,2,7,5,34,50
1469152539,Ghoul Friends Podcast,0,0,0,0,14,14
1469153189,"Ford Mustang The First Generation, The Early Years Podcast",1,0,0,0,14,15
1469153910,True Crime Conversations,13,7,9,9,54,92
1469168641,Strict Scrutiny,6,5,2,6,31,50
1469229625,Ladybug Podcast,2,0,0,1,22,25
1469231846,The Hylian Gamescast,0,0,0,0,22,22
1469270123,The Climate Pod,0,0,0,1,24,25
1469274680,Dermasphere - The Dermatology Podcast,0,0,0,0,9,9
1469278121,Disgusting Hawk with Jessica Kirson,2,1,2,0,45,50
1469293841,Kitces and Carl - Real Talk for Real Financial Advisors,1,0,0,1,9,11
1469319650,Frequent Miler on the Air,1,0,0,1,25,27
1469338483,Voices for Justice,4,8,7,5,476,500
1469339669,The Bludd Heart - Diablo & Gaming News,0,0,0,0,10,10
1469394914,The Journal.,117,45,18,9,93,282
1469423585,Wrasslin' With Sports Entertainment Presented By Pat McAfee Inc.,0,0,0,1,16,17
1469433026,Junkyard Dawgcast,3,0,0,4,87,94
1469454063,The Scale of Wisdom,0,0,0,0,1,1
1469466722,The Bare Performance Podcast,1,0,0,1,48,50
1469493659,The Red Resistance: A Handmaid's Tale Podcast,0,0,0,2,28,30
1469569875,College Admissions Decoded,0,0,0,0,2,2
1469582727,Where The Scary Things Are,0,0,0,0,2,2
1469615517,The Papaya Podcast,4,4,6,3,33,50
1469626819,Foodtrainers,1,0,0,0,49,50
1469631127,How To!,3,1,3,5,38,50
1469635169,The Nacho Kids Podcast: Blended Family Lifesaver,1,1,1,0,47,50
1469643813,Absolutely Not,10,3,1,3,33,50
1469683141,Neuroscience Meets Social and Emotional Learning,0,0,0,0,3,3
1469703618,True Crime South Africa,0,2,5,2,54,63
1469714268,The Functional Tennis Podcast,0,0,0,0,9,9
1469738274,Cobwebs: A Gothic Cinema Podcast,0,0,0,0,3,3
1469759170,My First Million,5,1,6,4,184,200
1469843033,Worm Audiobook,1,1,3,0,5,10
1469846035,Telehell,0,0,0,0,7,7
1469847630,Yes Way with Daniel Weingarten,0,0,0,0,13,13
1469850723,Fight Bananas,0,0,0,0,14,14
1469885794,Franco's World,0,0,0,0,8,8
1469962833,The Killing of JonBenet: The Final Suspects,133,80,58,21,66,358
1469980054,Think Like A CEO with Gary Keller & Jay Papasan,0,0,2,4,77,83
1469984661,Blog & Mablog,2,0,0,0,95,97
1470003061,Trapital,0,0,0,0,9,9
1470038645,Network Marketing Ninja Podcast With Frazer Brookes,0,0,0,0,100,100
1470081310,StressLess Camping podcast,0,1,0,0,19,20
1470110795,Charlie & Ben Podcast,1,0,0,3,46,50
1470129415,Where Is My Mind?,3,2,0,5,44,54
1470172607,"Pili, Raul & La Musica",0,0,0,0,21,21
1470174589,Fitness for the Fairways,0,0,0,1,24,25
1470175064,Mixing with Mani,3,1,3,4,124,135
1470237531,The Dead To Me Podcast,1,0,0,0,3,4
1470242499,The Roys Report,3,1,0,2,13,19
1470281303,The Van Life Podcast,5,1,1,0,3,10
1470283431,SOMM TV,0,2,0,5,17,24
1470291456,Billboard News Now,0,0,0,0,1,1
1470324538,DayLuna Human Design Podcast,0,0,1,0,36,37
1470336961,Behind The Scenes | Animation,1,1,0,2,54,58
1470339165,APEX Live Anesthesia,0,0,0,3,33,36
1470339726,Liminal Apocalypse,6,2,2,5,8,23
1470342753,Growing Cubs: A Chicago Prospect Podcast,0,0,0,0,6,6
1470375638,The Fantastic History Of Food,0,0,0,0,18,18
1470391649,Living Fully with Mallory Ervin,10,1,4,4,481,500
1470422004,Joyce Meyer's Talk It Out Podcast,0,0,0,7,113,120
1470466331,The Woj Pod,15,3,6,2,20,46
1470483538,The Fantasy Points Podcast,1,1,0,2,31,35
1470490447,Dilemma Podcast,2,0,0,0,4,6
1470544620,Scary Stories & Rain,1,0,0,2,58,61
1470546918,Farm4Profit Podcast,0,0,0,0,7,7
1470562048,Eastern Current Saltwater Fishing Podcast,0,0,0,0,58,58
1470599958,EMS World Podcasts,0,0,0,0,1,1
1470621596,TwoOhSix Podcast,0,0,0,0,1,1
1470622572,The Jim Rutt Show,0,0,0,2,9,11
1470631199,CE5 Podcast,0,0,0,0,2,2
1470655288,The Fiona Show: Hot Off the Press,0,0,0,0,1,1
1470669577,The Pilots' Lounge,0,0,0,0,8,8
1470672274,Inside the Lion's Den: A Business and Leadership Podcast,0,0,0,0,36,36
1470682949,Underunderstood,2,1,1,2,58,64
1470690716,Sierra Unfiltered,4,0,2,1,93,100
1470707078,Not The Worst Marriage,1,0,2,1,86,90
1470708012,Storytime With Teta,0,0,0,0,2,2
1470736893,Suggestible,1,1,3,1,194,200
1470773952,History in Five Songs with Martin Popoff,0,0,0,0,7,7
1470779069,Plat Chat,0,0,1,0,23,24
1470779784,The Keto Kamp Podcast With Ben Azadi,0,0,0,1,49,50
1470796712,The Forbidden Apple,0,0,0,0,18,18
1470805418,Find Your Aha Moment,0,0,0,0,2,2
1470902794,The Scalpel With Dr. Keith Rose,0,0,0,0,15,15
1470903474,Larger Than Life,4,3,2,3,73,85
1470936865,PaddyTalks Golf,0,0,0,0,5,5
1470952338,Towards Data Science,0,0,0,0,3,3
1470994027,Vacation Rental Machine,0,0,0,0,13,13
1471001518,Another Level,0,0,0,0,10,10
1471003314,Deeper Than Money,0,0,0,0,150,150
1471007511,The Sister Diary,0,0,2,3,85,90
1471015571,Black History Year,3,0,0,3,44,50
1471023870,Shut Up I Love It,0,0,0,0,12,12
1471046920,Con Artists,14,6,7,4,121,152
1471076523,UnAborted,1,0,0,0,49,50
1471111035,El Show De Chiquibaby,0,0,0,0,3,3
1471130008,The Travel Diaries,2,0,1,1,87,91
1471148772,The Long Hallway,0,5,4,1,16,26
1471158307,Popular Volcanics,0,0,0,0,3,3
1471166224,The Moment,15,10,24,27,139,215
1471168934,Dog Lovers Unleashed™ - Fetching Your Dog's Best Life,0,0,0,0,9,9
1471183444,MORNING KOMBAT WITH LUKE THOMAS AND BRIAN CAMPBELL,6,1,5,5,141,158
1471188269,The Cold War: What We Saw,0,2,0,1,47,50
1471199567,Flow with Berrion Berry,0,0,0,0,18,18
1471202833,The Endless Honeymoon Podcast,4,1,1,1,43,50
1471240409,Pod Don't Lie,3,2,0,1,236,242
1471270483,Gloss Angeles,4,1,2,2,148,157
1471284399,State of Mind with host Debra Sloss,0,0,0,0,8,8
1471389934,Green Eggs and Dan,0,0,0,0,21,21
1471391402,D3 Glory Days Podcast,0,0,0,0,18,18
1471405771,Kickback Anime Discussion Podcast,0,0,0,0,1,1
1471409634,Lights Out Bedtime Stories for Boys and Girls,0,0,0,0,1,1
1471411980,American Thought Leaders,0,0,1,0,29,30
1471422562,The Secret Lives of Black Women,5,0,4,5,137,151
1471432747,The Clearing,26,29,46,55,318,474
1471439989,BeEzrat HaShem with Rabbi Yaron Reuven,0,0,0,0,1,1
1471459169,NORTH IDAHO NOW,0,0,0,1,3,4
1471479507,Waterpeople Podcast,1,1,1,2,155,160
1471500012,Japanese podcast for beginners (Nihongo con Teppei),1,0,0,0,14,15
1471502633,All The Right Movies: A Movie Podcast,0,0,0,0,8,8
1471554293,Harmony in the Home,0,0,0,0,50,50
1471556007,The Rough Cut,0,0,0,0,3,3
1471556146,Native Lights: Where Indigenous Voices Shine,0,0,0,0,2,2
1471581521,Bret Weinstein | DarkHorse Podcast,29,7,15,7,173,231
1471604689,The Homecoming Podcast with Dr. Thema,0,0,0,0,50,50
1471644670,Context,0,0,1,1,0,2
1471679636,Bizarre Albums,0,0,0,0,50,50
1471715443,FIVE MINUTE NEWS,0,0,0,1,7,8
1471731529,Pregnancy & Birth Made Easy,0,0,0,1,49,50
1471750320,Drinking And Screaming - A Horror Movie Review Podcast,0,0,0,0,21,21
1471786624,Starting Sustainability: Sustainable Living: eco-friendly: environment: green: recycle: zero-waste,0,0,0,1,5,6
1471912866,The Bob Rivers Show,1,2,0,2,40,45
1471921202,Film Fam: Inspired By True Events,0,0,0,0,7,7
1471924888,Fish the Moment Podcast,0,0,0,0,53,53
1471962712,Echange,0,0,0,0,5,5
1472032462,Nice Try,1,0,0,1,10,12
1472038590,Mississippi Golfer Podcast,0,0,0,0,1,1
1472061802,True Sex & Wild Love,8,3,6,4,29,50
1472068137,Tad DeLay,0,0,0,0,2,2
1472069036,Spirit Speakers,0,0,0,0,37,37
1472100290,The Frenemies Podcast,0,0,0,0,18,18
1472106563,Meditative Story,0,0,0,0,2,2
1472107627,Another Kind of Mind: A Different Kind of Beatles Podcast,3,2,0,1,20,26
1472111769,Compromised,0,1,0,0,2,3
1472126503,Life Uncut,1,1,2,3,80,87
1472224582,The Beauty Closet,20,14,12,7,32,85
1472242330,Yeshiva of Newark Podcast,0,0,0,0,1,1
1472280357,Parklandia,4,7,1,2,46,60
1472282344,Chemistry For Your Life,2,0,0,0,30,32
1472295940,Podcasting After Dark,0,0,0,0,37,37
1472305411,TB UNICORN POD,0,0,0,0,4,4
1472341475,Manifestations,1,0,0,1,3,5
1472370879,Psychology In Hindi,1,0,0,0,3,4
1472375310,Filmtrepreneur™ - The Entrepreneurial Filmmaking Podcast with Alex Ferrari,0,0,0,0,16,16
1472376956,"A Second Opinion with Senator Bill Frist, M.D.",0,1,1,0,48,50
1472392291,Passenger List,0,1,2,7,78,88
1472401495,Over the Road,2,3,3,5,129,142
1472428389,Disney Magic of Storytelling,0,1,0,1,9,11
1472456658,The Game EXPOSED: Relationship and Dating Advice,1,0,1,1,16,19
1472460862,THE UPSIDE with Callie and Jeff Dauler,40,13,3,4,440,500
1472530787,LowCarbUSA Podcast,0,0,0,0,4,4
1472538778,Past Lives & the Divine,2,0,0,0,74,76
1472544809,In The Landscape®,0,0,0,0,9,9
1472545207,Cynema,0,0,0,0,7,7
1472587591,Creative Processing with Joseph Gordon-Levitt,1,1,1,3,55,61
1472650099,Jeepin Bubba,0,0,0,0,1,1
1472737419,Curiosidades de la Historia National Geographic,0,0,0,0,3,3
1472776349,Covering the Spread,0,0,0,1,11,12
1472778836,Dropping In,0,0,0,1,15,16
1472815380,Graining In,0,0,0,1,56,57
1472870897,Not What You Thought You Knew,0,2,1,2,6,11
1472885658,BarBend Podcast,1,0,1,1,47,50
1472886394,Advantage Connors,0,0,1,0,29,30
1472888443,Listen To Sleep - Quiet Stories,0,0,0,0,17,17
1472891063,Animal Training Fundamentals with Barbara Heidenreich,0,0,0,0,5,5
1472896599,Brain Jail,0,0,2,1,47,50
1472939543,Talkin' Baseball (MLB Podcast),10,6,4,12,387,419
1472941585,Addicted to Sets Tennis Podcast,0,0,0,0,5,5
1472945003,Two Gay Matts,1,0,0,0,16,17
1472961073,The Stick and Hack Show,0,0,0,0,2,2
1472970678,The Secret Teachings Archives,3,0,0,0,8,11
1472974414,Comedy Rewind,0,0,0,0,1,1
1473025028,"The Practical Prepper: A modern conversation about preparedness, survival and being self reliant",0,1,1,0,2,4
1473055758,Establish The Run,7,1,2,1,110,121
1473064626,Dish On Ditching Diets,0,0,0,1,0,1
1473072044,Raising Good Humans,2,0,1,2,45,50
1473076176,Candid Confidence,0,0,0,1,18,19
1473079013,The Bougie Show,0,0,0,0,1,1
1473081850,Old Dirty Boston,0,0,0,0,10,10
1473092394,CitySpeak,0,0,0,0,2,2
1473125489,Tim May Podcast - Ohio State Football,1,1,2,3,15,22
1473130627,Truck N' Hustle,0,0,0,0,13,13
1473137390,Engadget News,1,0,0,0,0,1
1473143832,Shark Tales,0,0,0,0,2,2
1473149489,Dynasty’s Child,0,0,0,2,19,21
1473150244,Americast,12,4,6,7,65,94
1473194273,Normal to Nomad,0,0,0,1,59,60
1473207217,Room 20,101,43,38,32,195,409
1473280776,El Camino de Santiago Pilgrims' Podcast,0,0,0,0,5,5
1473313219,The 200 Level with Mike Carpenter,4,1,2,3,48,58
1473317866,F.I.R.E.D UP with Krista Mashore,0,0,0,0,50,50
1473322793,The Tea on Tap: A Hair & Beauty Podcast,0,0,0,0,2,2
1473364526,Plant Daddy Podcast,3,0,1,1,45,50
1473378614,Sounds From The Abyss,0,0,0,0,13,13
1473382916,Run the List,0,1,0,1,12,14
1473436479,Clash Of The Titles,0,0,0,0,7,7
1473460202,DERELICT,2,0,0,4,44,50
1473463798,The Nurse Practitioner - The Nurse Practitioner Podcast,0,0,0,2,1,3
1473488887,The Lost Ogle Show,0,1,1,0,1,3
1473504872,The HYPE Report,0,0,0,0,16,16
1473507649,Patient Zero,9,5,4,5,67,90
1473519165,The Boston Terrier Society,0,2,0,0,2,4
1473523403,The Spill,13,12,9,5,56,95
1473537961,Inside Eyes,0,0,0,0,14,14
1473541728,Brigit's Erotic Bedtime Stories,0,0,0,0,4,4
1473543128,The Adam Ferrara Podcast,0,0,0,0,50,50
1473548587,F*ck Weddings Podcast,0,0,0,0,12,12
1473553201,InsureTech Geek Podcast,0,0,0,0,1,1
1473600403,The Plough-Share,0,0,0,1,0,1
1473609364,Forward Press Podcast from Golfweek.com,0,0,1,0,0,1
1473621372,Orchid Chat With Dr. Connors,0,0,0,0,1,1
1473626965,Guided Sleep Meditation & Sleep Hypnosis from Sleep Cove,3,0,4,1,52,60
1473645747,Empath To Power Podcast,0,0,0,1,32,33
1473649053,Bachelor Happy Hour,50,9,11,9,420,499
1473655873,Medical Mysteries,30,20,24,18,79,171
1473671727,Chicks on The Right Podcast w Mock & Daisy,1,0,0,0,49,50
1473703394,The Narcissists' Code,0,0,0,0,1,1
1473708852,That's What I'm Tolkien About,0,0,1,0,29,30
1473711424,Sports Card Investor,4,0,3,2,27,36
1473712245,Wind's Howling: A Witcher Netflix Show Podcast,1,1,3,2,21,28
1473734049,Heros For Sale Podcast | Sports Card News & Info,4,1,1,0,20,26
1473739537,The Battle of Gettysburg Podcast,0,0,0,0,50,50
1473745084,Talkin' Yanks Pre-Game Show,0,0,0,0,14,14
1473747182,The Daily Beans,19,7,20,8,228,282
1473757537,Soccer 101,0,1,1,1,124,127
1473769939,The Mechanics of Storytelling,0,0,0,0,2,2
1473833894,Real Arabic,1,0,1,1,3,6
1473838608,Eric Roberts Fitness,0,0,0,0,43,43
1473848992,In Search of Portland,0,0,0,1,3,4
1473854035,Apple Events,6,1,4,3,33,47
1473865038,Marcus & Sandy's Second Date Update,3,6,0,0,1,10
1473866529,Cassie Stephens,0,0,0,0,48,48
1473872585,Apple News Today,68,19,22,28,161,298
1473877695,CommissionED: The Air Force Officer Podcast,0,0,0,0,12,12
1473907169,Point Shot,1,0,0,0,1,2
1473951152,Unscripted Podcast – Islam21c Media,0,0,0,0,1,1
1473995472,Kente Korner,0,0,0,2,8,10
1474001390,TrueAnon,20,8,8,7,165,208
1474005538,The Art and Science of Running,0,0,1,0,5,6
1474007372,Weed Wonks,0,0,0,0,4,4
1474008289,MNmaxed Podcast,0,0,0,0,7,7
1474018356,"Brain Health and Beyond with Team Sherzai, MD",0,0,0,1,77,78
1474052266,Just the Gist,5,7,4,5,71,92
1474090526,Weeknight Kitchen with Melissa Clark,1,1,1,2,38,43
1474091338,Healthy Widow Healthy Woman,0,0,0,0,2,2
1474095302,Memory Card,0,0,0,0,3,3
1474096593,Fala Gringo! | Intermediate Brazilian Portuguese,0,0,0,0,19,19
1474112482,88 Days: The Jayme Closs Story,38,41,21,10,56,166
1474171732,At The Table with Patrick Lencioni,0,0,2,4,109,115
1474242146,The Sweet Smell of Succession,2,5,3,2,29,41
1474245040,The Happiness Lab with Dr. Laurie Santos,16,12,16,16,324,384
1474254179,RadioActive Dads,0,0,0,0,9,9
1474309028,Daily Comedy News: a podcast about comedians,0,0,0,1,6,7
1474317160,Unofficial Titans Podcast: Tennessee Titans,0,0,0,0,1,1
1474319015,11 Personnel,0,0,0,1,24,25
1474359464,The Tablo Podcast,0,0,0,6,494,500
1474393287,State of Emergence,0,0,1,0,1,2
1474395537,Narcissistic Abuse No More,1,0,1,2,6,10
1474398539,Your Parenting Long Game,0,0,0,1,34,35
1474400307,Through the Smoke: A Miami Hurricanes football podcast,4,2,1,2,124,133
1474419082,Alfacast,0,0,0,0,4,4
1474429475,Waveform: The MKBHD Podcast,2,0,2,5,54,63
1474430846,Piece of Cake Podcast: A Detailed Guide to Wedding Planning,0,0,0,0,7,7
1474431037,16 Minutes News by a16z,0,0,0,0,2,2
1474432079,Tenn and Two,2,1,1,1,32,37
1474437038,Strategic Sensibility,0,0,0,0,6,6
1474439369,First Name Basis Podcast,0,0,0,0,50,50
1474441303,Biddy Bedtime Stories Podcast,0,0,0,0,16,16
1474453846,Once It's Begun,0,0,1,0,7,8
1474455608,Collected Talks of David Solomon,0,0,0,0,5,5
1474460561,The Champions Playbook,0,0,0,0,8,8
1474472848,Amazing Wildlife,0,0,0,0,8,8
1474473624,El Club de las 4AM,0,0,0,0,1,1
1474481316,The Reconnection Club Podcast,0,1,0,0,6,7
1474505122,Hustle Humbly,0,1,0,0,49,50
1474505415,The Storage Papers,0,1,3,2,23,29
1474516796,FUT IN REVIEW,0,0,0,0,7,7
1474551466,TWC Show,0,0,0,0,2,2
1474558908,Grief is a Sneaky Bitch,0,0,0,0,26,26
1474580048,A Tale of Two Rivals: A Fantasy Football Podcast,0,0,0,0,4,4
1474582435,You Cannot Be Serious,13,4,7,9,66,99
1474586820,Cowboy Boys Podcast,0,0,1,1,48,50
1474622040,Keto Life Support,0,0,0,1,49,50
1474633295,The Hannity Monologues,3,0,0,0,2,5
1474665748,Business Blooming Podcast,0,0,0,0,35,35
1474687988,The Realignment,8,2,4,4,365,383
1474697743,Gutsy Health | Nutrition and Medicine,1,1,2,2,44,50
1474698060,GG Over EZ,0,0,0,1,49,50
1474699736,Soil Sense,0,0,0,0,3,3
1474706111,The Melanie Avalon Biohacking Podcast,0,0,1,2,47,50
1474707029,The Garden Girls,0,0,0,0,8,8
1474709653,"Good Together: Ethical, Eco-Friendly, Sustainable Living",1,4,1,3,41,50
1474717167,Clothes Minded Podcast,0,0,0,0,6,6
1474726168,The Boys of 161st Street - Yankees MLB Podcast,0,0,0,2,82,84
1474731758,A Quilter's Life,0,0,0,2,6,8
1474769114,True Crime Astrology with Shawn Engel | True Crime | Astro | Astrology | Zodiac | Horoscope | Creepy...,1,0,0,0,18,19
1474796049,Storyberries Radio,0,0,0,0,1,1
1474805073,On The Green Fence,0,0,0,0,3,3
1474828818,Nightly Bedtime Story Podcast,0,0,1,0,1,2
1474860566,Martes De Misterio,0,0,0,0,4,4
1474868818,The Frank Caliendo Cast,7,0,0,3,38,48
1474869162,Keno-Talk Podcast,0,0,0,0,1,1
1474873320,The Zone,1,1,0,0,1,3
1474881598,The American Story,0,0,0,1,49,50
1474883341,Cutting The Distance with Remi Warren,3,0,1,6,490,500
1474917079,Today in True Crime,57,35,36,17,125,270
1474948728,The Week Junior Show,0,0,0,0,8,8
1474953937,The Stadio Podcast,0,0,0,0,61,61
1474971310,Heartwood,0,0,0,0,2,2
1474975295,Spanish Lessons With Pablo - Learn Spanish.,0,0,0,0,1,1
1474978235,The Level Up Latina Podcast,0,0,0,0,12,12
1475001382,My Solo Road,2,1,1,4,115,123
1475010766,KETO AFTER DARK,1,0,0,0,17,18
1475010812,The Mind Of Dom,0,0,0,0,15,15
1475056491,Meanspiration with Annie Lederman,2,0,0,0,48,50
1475060182,Former Action Guys Podcast,0,0,0,0,33,33
1475090347,The India Hicks Podcast,1,1,0,1,55,58
1475110703,The Spitfire Series,0,0,0,0,1,1
1475113128,The NASM-CPT Podcast With Rick Richey,0,0,2,1,30,33
1475115108,Locked On Mariners - Daily Podcast On the Seattle Mariners,0,0,0,0,4,4
1475116211,Squawk on the Street,10,1,4,3,13,31
1475119044,Tech News Now,1,0,0,2,3,6
1475147716,Sacred & Profane,0,0,0,0,12,12
1475154123,Child of the Redwoods: Montessori Parenting,0,0,0,1,49,50
1475160059,Team LoCoFit Round Table,0,0,0,1,19,20
1475160811,Collider Podcast,4,2,0,0,27,33
1475177002,Covert Castaway Liveaboard Sailing,0,0,0,0,6,6
1475189415,Mental Health Remix,0,0,0,0,27,27
1475201622,Food Biz Wiz,0,0,0,0,50,50
1475204845,Wisdom of Crowds,0,2,0,1,6,9
1475207392,Endocrine Disruptors,0,0,0,0,16,16
1475285499,American Institute for Economic Research,0,1,0,1,0,2
1475298586,Carmen Johnston Gardens,0,0,0,0,4,4
1475302519,Solar Disruption Theory,0,0,0,0,2,2
1475303785,Mike & Max's Offroad Podcast,1,0,0,0,30,31
1475358928,Just Listen to Yourself with Kira Davis,0,0,0,1,49,50
1475378148,The Former Lawyer Podcast,0,0,0,0,3,3
1475412003,"Cyberpunk Lorecast: The Lore, News & Gameplay Podcast for Cyberpunk 2077",1,0,1,2,29,33
1475429487,Five Nights At Freddy's: Let's Pod!,1,0,2,2,17,22
1475440097,CHIC Happens,4,0,1,1,44,50
1475463467,Living The New Science with Lynne McTaggart,1,1,0,3,77,82
1475482850,Omar Hisham Al Arabi,0,0,0,0,2,2
1475498491,BASCHAMANIA,0,0,0,0,47,47
1475531920,She Plays Games Podcast,0,0,0,0,2,2
1475539856,Argus Media,0,0,1,0,0,1
1475551112,Someday is Here,0,0,0,0,22,22
1475552619,The Lipstick Files,3,0,1,0,112,116
1475580109,Kickback with Nedum,0,0,0,0,9,9
1475592953,The Intersection with Jason Page,2,0,0,0,2,4
1475597548,GOONS,0,0,0,0,50,50
1475609450,GQ Talk,0,1,0,1,2,4
1475653406,Ellie and The Wave,0,0,1,0,20,21
1475655383,Wellness that Works,0,0,1,0,8,9
1475680946,Behind The Baller Podcast with Ben Baller,9,0,0,1,190,200
1475687979,Veronica Mars Investigations,7,7,0,2,40,56
1475692072,Marine Mammal Science,1,0,0,0,1,2
1475692098,Environmental Studies and Sciences,0,0,0,0,1,1
1475711250,A Reseller's Life by Daily Refinement,0,0,0,0,50,50
1475773051,rSlash,1,0,0,0,49,50
1475783610,Saxo Market Call,0,0,0,1,6,7
1475785035,Teacher Hustle Podcast,0,0,0,0,45,45
1475793300,Magnus Podcast,0,0,0,0,13,13
1475794447,Pulling Curls Podcast: Pregnancy & Parenting Untangled,0,0,0,0,17,17
1475796905,Conservative Daily Podcast,13,3,3,3,181,203
1475800695,Point of Origin,2,0,2,2,40,46
1475805670,Tales of a Gearhead,0,0,0,0,2,2
1475818212,The Drive with Lon Tay & Derek Piper,0,0,0,0,8,8
1475835329,Old Fashioned On Purpose,2,1,2,0,45,50
1475840401,RuffStuff Podcast,0,0,0,0,3,3
1475844469,The Viridian Wild,0,0,0,0,3,3
1475845109,Life As We Know it,0,0,0,0,1,1
1475845728,Talk Tennis,0,0,1,3,40,44
1475852708,Wild Plant Culture,0,0,0,0,6,6
1475866450,STEMpod,0,0,0,0,3,3
1475903567,Nick Bahe Podcast,2,0,1,1,110,114
1475952183,Premier League on NBC,2,0,1,0,2,5
1475965495,The Quilters Circle Podcast,0,0,0,0,1,1
1475984291,We Ain't Got No History: for Chelsea FC fans,0,0,2,0,1,3
1475990943,The Cigar Pulpit,0,0,0,0,17,17
1475995025,ReReading Wolfe,0,0,1,0,18,19
1476007966,Dreamful Bedtime Stories,1,2,3,3,26,35
1476022900,Dungeons of Drakkenheim,0,0,0,1,17,18
1476061292,1 Insight,0,0,0,0,7,7
1476077177,The Jewish Lives Podcast,0,0,1,0,13,14
1476085691,GameSpot After Dark,0,1,1,0,14,16
1476091059,Matt McCall's Moneyline,0,0,0,0,2,2
1476091307,All About The Jersey: for New Jersey Devils fans,1,0,0,0,2,3
1476102891,Conta Pra Mim?,0,0,0,0,6,6
1476109108,The Lawyer's Escape Pod,0,0,0,0,2,2
1476110521,Useful Idiots with Matt Taibbi and Katie Halper,42,23,25,22,388,500
1476168116,George's Random Astronomical Object,0,0,0,0,1,1
1476173058,A Legitimate Salvage (The Expanse),1,0,1,0,2,4
1476177944,A Voice From Darkness,1,0,1,0,48,50
1476197146,The Hayseed Scholar Podcast,0,0,0,0,1,1
1476214151,Jujutsu Kaisen Podcast ~Positive JuJu~,0,0,0,0,3,3
1476214999,You're Buying A Home With Silas Lindenstein,1,0,1,1,20,23
1476224704,Cosplay Gems,0,0,0,0,1,1
1476270751,The Dollop - England & UK,2,0,2,2,44,50
1476287601,Miles to Memories Podcast,3,1,1,1,41,47
1476302603,The Eat for Endurance Podcast,0,0,0,0,7,7
1476318970,The St. Canard Files: A Darkwing Duck Podcast,0,0,0,0,5,5
1476331236,Peace and Parenting,0,0,0,0,50,50
1476342477,The Devy Delight,1,0,0,0,4,5
1476357131,Interpreting India,0,0,0,0,3,3
1476392010,Bardstown,50,59,42,38,197,386
1476423464,Perreo 101,0,0,0,0,11,11
1476433140,Huddle Up with Gus,0,0,0,0,1,1
1476446599,Being Unlimited,0,0,1,0,7,8
1476456225,JMO Podcast,1,0,1,1,1,4
1476464084,The Lensrentals Podcast,0,0,0,0,9,9
1476480135,Mindhunter,0,0,0,1,3,4
1476482913,That Song From That Movie,0,0,0,0,16,16
1476501557,The Imperfects,0,1,1,2,74,78
1476503497,Disaster Girls: A Podcast About Disaster Movies,2,0,0,0,31,33
1476544801,TLP Podcast For Dentists,0,0,0,0,43,43
1476552025,Too Scary; Didn't Watch,3,0,3,4,69,79
1476567949,The Thistle Scottish Rugby Podcast,0,0,0,0,1,1
1476572021,Make Climate Cool Again,0,0,0,0,14,14
1476590140,PorscheCooled Podcast,0,0,0,0,16,16
1476608348,Stories of The Prophets,0,0,0,0,1,1
1476610783,Jewish Inspiration Podcast · Rabbi Aryeh Wolbe,0,0,0,0,1,1
1476644292,House Party Protocol,1,0,0,0,11,12
1476688287,fit4life | fitgirl weekly chat,0,0,0,0,2,2
1476704862,Wake Up America! Opening Monologues,0,0,0,0,12,12
1476712823,Talking with the dogs!™,0,0,0,0,17,17
1476723514,Dating Straight,2,2,1,3,461,469
1476734813,talkSPORT Daily,1,0,0,0,1,2
1476735078,Why Dad Drinks,0,1,0,0,2,3
1476738421,The Bake Down - Bake Off Reviewed,1,0,0,0,30,31
1476740208,The Soap Box with Austin Malleolo,0,0,0,0,2,2
1476740894,By Order Of The: Peaky Blinders,5,2,2,3,19,31
1476744233,LOST: Down the Hatch - A Spoiler Filled LOST Re-Watch,2,1,0,1,61,65
1476763378,The Power Scaling Podcast,0,0,0,0,1,1
1476828522,Happy Days Rested Nights,0,0,0,0,50,50
1476831468,Plant Medicine Podcast with Dr. Lynn Marie Morski,0,0,0,0,17,17
1476844445,Disney For Scores,0,1,0,0,29,30
1476845124,The BBC Good Food podcast - Rookie & Nice,0,1,0,2,2,5
1476851182,"Spill it, Sister! Reality TV recaps with Ally & Leah",0,0,0,1,27,28
1476863701,GOLF's Fully Equipped,2,1,3,4,11,21
1476878124,Shankcast - A Tennis Banter Podcast,0,2,2,17,106,127
1476882343,Nashville Podcast,0,2,0,1,19,22
1476883661,Fit Girl Magic | Healthy Living For Women Over 40,0,0,0,0,17,17
1476888334,Heaux in the Kneaux,0,0,0,0,24,24
1476928106,1619,16,0,0,3,31,50
1476932329,The SwordCast,0,0,0,0,8,8
1476940551,Petri Dish,0,0,0,0,13,13
1476944546,CBS Radio Mystery Theater | Old Time Radio,0,0,0,0,10,10
1476945087,Swiping Up,13,4,1,2,136,156
1476949983,The Skorpion Show Podcast,1,0,2,0,47,50
1476957977,The Subjective Truth,1,0,1,4,34,40
1476958861,Bitcoin Rapid-Fire,0,0,0,0,22,22
1476972434,Strong Runner Chick Radio,0,0,0,0,6,6
1476985058,The Rich Redmond Show,0,0,0,0,53,53
1477054314,Fantasy Football Factory,25,8,6,9,370,418
1477059799,ALAB Series,2,0,2,0,84,88
1477089538,The Freedom Friends,0,0,0,0,8,8
1477094947,Fun City,0,0,0,0,10,10
1477099279,Business Coaching Secrets,0,0,0,0,38,38
1477103897,Preach,1,0,0,0,89,90
1477107854,Trucking for Millennials,0,0,0,0,17,17
1477117097,The Not So Straight and Level Podcast,0,0,0,0,2,2
1477126939,Know Your Aura with Mystic Michaela,0,0,2,4,494,500
1477129059,About Them Cowboys: a show about the Dallas Cowboys,1,1,1,0,11,14
1477129387,Can't Wait: A show about the New York Jets,3,1,1,3,37,45
1477129521,Hear That Podcast Growlin': A show about the Cincinnati Bengals,0,0,3,0,20,23
1477131675,Five For Fighting Podcast,1,0,0,1,13,15
1477131944,Class 1A: A My Hero Academia Podcast,0,0,3,0,7,10
1477137943,Better Golf Academy: Strategy to Awesome Golf,0,0,0,0,11,11
1477139871,From The Shadows,1,3,2,1,13,20
1477148384,The Talent Tank,1,0,0,1,48,50
1477171022,Journey Through Sci-Fi,0,0,0,0,5,5
1477191770,Laughter for All Podcast with Comedian Nazareth,0,0,0,0,3,3
1477194143,The Journey,0,0,0,0,1,1
1477223069,Dead Sirius,0,0,0,0,6,6
1477229952,The Women's Rugby League Podcast,0,0,0,0,11,11
1477239212,D23 Inside Disney,2,2,6,2,28,40
1477240003,The Morning Mess,1,0,0,3,13,17
1477245221,Geoff Schwartz Is Smarter Than You,3,0,2,3,21,29
1477261410,Maked Up Stories: Imaginative Kids Stories,1,1,0,0,48,50
1477264305,The Tennis Tragic,0,0,0,0,3,3
1477266932,Saved By The Pod,0,1,0,0,26,27
1477279443,Finding Fred,57,14,14,16,361,462
1477287015,Scared To Death,2,1,1,1,45,50
1477323816,Millennial Investing - The Investor’s Podcast Network,0,0,1,2,60,63
1477380265,Job Interview Coaching,0,0,0,0,4,4
1477386458,Monster: The Zodiac Killer,8,11,7,6,16,48
1477400167,The Kevin Sheehan Show,1,1,1,2,21,26
1477400332,BMitch & Finlay,0,1,0,1,7,9
1477409118,Family Road Trip Trivia Podcast,0,0,1,4,30,35
1477411615,All Ages of Geek Podcasts,0,0,0,0,1,1
1477411788,Spielman and Hooley,7,1,1,0,41,50
1477415387,Haunted Hell House of Horror,0,1,0,0,5,6
1477483749,The Chain: Protein Engineering Podcast,0,0,0,0,1,1
1477492573,Cheaper than therapy,0,0,0,0,7,7
1477512975,The Bikini and the Brain,1,0,2,1,38,42
1477513600,Loam Listen,0,0,0,0,13,13
1477514469,A Duchess Like Us,0,0,1,0,29,30
1477515380,Broncos Country Tonight,25,0,0,0,10,35
1477519393,The Fashionpreneur Diaries,0,0,0,0,18,18
1477524651,The World of Intelligence,1,0,0,0,0,1
1477535034,11 Personnel: A show about the Los Angeles Rams,2,0,0,1,29,32
1477536795,The Andy Staples Show & Friends: A show about college football,9,3,7,3,27,49
1477537533,The Athletic Fantasy Football Podcast,1,1,0,0,14,16
1477541494,Rhythms for Life,0,1,2,2,182,187
1477555097,Reality Gays: Trash TV and GayDD with Mattie and Poodle,27,5,1,1,456,490
1477561531,Exposed: The Series,0,0,0,0,1,1
1477565093,Fantasy Hour On Tap,0,0,0,0,4,4
1477568928,Five Dirty Bikers,0,0,0,0,9,9
1477570208,TWS with Angi B,0,0,0,0,3,3
1477578107,Stitch Please,0,1,0,0,49,50
1477582177,Beauty Marketing Simplified podcast,0,0,0,0,38,38
1477621566,The Snatchelor,96,25,21,14,344,500
1477623029,Dish City,1,1,1,0,22,25
1477623268,That's What People Do,0,0,0,0,4,4
1477651063,Latinx Intelligentsia,0,0,0,0,4,4
1477652461,Prospects To Pros with Dane Brugler & Lance Zierlein,1,0,0,0,16,17
1477654911,"Creativity, Spirituality & Making a Buck with David Nichtern",0,0,0,0,8,8
1477655202,Flight Safety Detectives,4,3,1,1,29,38
1477660645,Classical Breakdown,0,0,0,0,6,6
1477661505,Breaking Up With Binge Eating,0,0,0,0,12,12
1477662296,Steelers Blitz (Pittsburgh Steelers),1,0,0,0,20,21
1477662556,The Football GM: a show about the NFL,1,1,0,0,2,4
1477710574,Wicca Level 1: Witchcraft for Beginners,0,0,0,1,0,1
1477723877,godless longganisa,0,0,0,0,1,1
1477726377,Talkin’ Shiz,0,0,0,0,47,47
1477731029,Surviving Narcissism - Narcissist Rehab,1,2,1,1,32,37
1477731497,Cinema Recall,0,0,0,0,4,4
1477747461,Real Hauntings Real Ghost Stories,0,0,0,2,30,32
1477757732,Your Space Journey,0,0,0,0,2,2
1477761062,Master Your Health Podcast,2,1,0,0,47,50
1477763044,The Duck Farmer,0,0,0,0,5,5
1477769105,Hygge Girls Podcast,0,0,0,0,8,8
1477772349,Fright Night Minute,0,0,0,0,2,2
1477773466,Big Mad True Crime,24,13,11,16,436,500
1477776241,The Hunting Photographer,0,0,0,0,16,16
1477829870,Functional Relations,0,0,0,0,4,4
1477839366,The Kat Scan Podcast,0,0,0,0,27,27
1477845672,The Vault: Classic Music Reviews Podcast,0,0,0,0,6,6
1477850851,Unwasted: The Podcast,0,0,0,0,28,28
1477856333,All Over Overland,1,0,0,0,5,6
1477875094,Three Big Points,0,0,0,0,6,6
1477877813,School of Manifestation,0,0,0,0,1,1
1477881654,Fck This Place: The Jobs Podcast,0,0,0,1,7,8
1477888510,I’ve Got a Secret! with Robin McGraw,10,1,4,1,39,55
1477890065,Thriving Dog Pawcast,0,0,0,0,2,2
1477901637,Minding Scripture,0,0,0,0,2,2
1477905385,Sew-organised-style,0,0,1,0,0,1
1477915364,Simplexity with Alyson Stoner,1,0,1,1,103,106
1477920956,Things That Are Blank - Game Show,0,0,1,0,2,3
1477926278,This Teacher Life,0,0,0,0,32,32
1477930581,Watts Your Safeword,0,0,1,1,48,50
1477930942,Front Nine Golf Podcast,0,0,0,0,1,1
1477931849,Harmless Phosphorescence,0,0,0,0,1,1
1477932768,"Knight Falls, CA",2,1,1,1,9,14
1477991794,Trapped Under Plastic,0,0,0,3,25,28
1477994760,Something for Nothing: A RUSH Fancast,0,0,0,0,29,29
1477999442,Aquinas 101 - Course 1: Why Aquinas?,0,0,1,0,5,6
1478010450,Neon Jezebel,0,0,0,0,3,3
1478011641,Mysteries Of The Unexplained | Paranormal Podcast,0,1,0,0,17,18
1478013779,WashingtonWise Investor,2,0,1,0,23,26
1478018712,Let's Talk - Cobra Kai,0,0,3,0,14,17
1478020673,Cincy Slangin’ Bearcat Sports Podcast,0,0,0,0,14,14
1478026062,Winner Take All,0,0,0,0,13,13
1478026758,Were You Raised By Wolves?,1,3,4,1,225,234
1478084613,Kelly and Murray,6,5,0,10,162,183
1478116413,The It's Time for Bed's Podcast,0,0,0,1,2,3
1478138996,Murder in Oregon,22,19,25,31,182,279
1478163837,The Fifth Hour with Ben Maller,4,0,1,0,90,95
1478169003,The Bible for Kids Podcast,0,0,0,1,7,8
1478171420,Spiced Chaos,0,0,1,2,12,15
1478179188,The Fleabag Situation: A Fleabag Fan Podcast,2,1,0,1,38,42
1478211900,Beauty IQ Uncensored,12,8,10,2,156,188
1478272793,Backyard Gardens - Gardening for everyone,0,0,0,1,3,4
1478276232,GRABS Podcast,0,0,0,0,6,6
1478296139,Sources Say Podcast,2,2,1,1,31,37
1478303230,Weeping Cedars,1,0,1,1,24,27
1478308505,Blue face baby,1,1,0,0,0,2
1478310045,"Norman's Rare Guitars, The Podcast",1,0,0,4,208,213
1478330055,Home Space and Reason,0,0,0,0,15,15
1478419606,United Stand Podcast,1,0,0,0,33,34
1478422712,Bred to Perfection,0,0,0,0,2,2
1478425101,Conversations with Kevin,0,0,0,0,2,2
1478427481,The Woo Woo 'Verse,0,0,0,0,5,5
1478431097,The Offside Rule: WSL Edition,0,0,0,0,14,14
1478434046,Jared Dillian Podcasts,0,0,0,0,11,11
1478439548,Crypto Marketing with Ty Daniel Smith | A Coinbound Podcast,0,0,0,0,4,4
1478457465,The Two Onions podcast with Dani Daniels,1,2,1,0,16,20
1478460758,BROKEN: Seeking Justice,0,2,8,2,14,26
1478465499,The WindUp Podcast,0,0,0,0,7,7
1478466659,The Ortho Show,0,0,0,0,2,2
1478469181,MS Living Well: Key Info from Multiple Sclerosis Experts,0,0,0,0,8,8
1478471035,Dry Powder: The Private Equity Podcast,0,0,0,0,9,9
1478482078,Homebrewing DIY,0,0,1,0,2,3
1478486574,Cult of the Clocktower,0,0,0,1,3,4
1478494671,Breakfast with Vinnie!,0,0,0,0,21,21
1478513382,The Vine Podcast,0,0,0,0,8,8
1478548815,The Witch Daily Show,0,0,1,1,40,42
1478551197,Talking Backwards: A Twin Peaks Podcast,0,0,0,1,6,7
1478561777,Two Dollar Late Fee,0,0,0,0,25,25
1478567809,The Leadership Locker,0,0,0,0,50,50
1478574492,The Spark File with Susan Blackwell and Laura Camien,0,0,0,0,32,32
1478579958,Cartoon Logic,1,0,0,0,9,10
1478628463,Manage Mold,0,0,0,0,22,22
1478660220,DEADLOCK: A Pro Wrestling Podcast,3,1,0,5,379,388
1478662512,Energy Sense,0,0,0,0,2,2
1478676974,Points South,0,2,0,0,6,8
1478682639,The Social Kick Podcast,0,0,0,0,1,1
1478686295,BunnyRanch Podcast,0,0,0,0,17,17
1478697583,The Pitmaster's Podcast,0,0,0,0,35,35
1478744465,Curious Kids Podcast,0,0,0,0,2,2
1478745648,Occupy Me,0,0,0,0,1,1
1478746415,Zane and Heath: Unfiltered,24,15,22,20,419,500
1478746510,Diggin' Oak Island,0,0,0,0,53,53
1478759022,PWC Connections: The Podcast,0,0,0,0,1,1
1478767232,Home School'd Podcast,0,0,0,0,7,7
1478786688,Focus on This,9,9,6,8,91,123
1478789552,Gist Healthcare Daily,0,0,0,1,11,12
1478794003,Worst Year Ever,65,25,32,20,160,302
1478795266,The Coordinate: An Attack on Titan Podcast,0,0,0,0,3,3
1478795556,Pack de Potes Rugby Podcast,0,0,0,0,1,1
1478809778,The Adam Schein Podcast,0,0,0,0,8,8
1478826950,The Folly Coffee Podcast,0,0,0,0,4,4
1478827007,The Situation with Michael Brown,1,0,0,0,4,5
1478829524,Monster Madness,1,1,0,1,10,13
1478837409,Ten to the Fifteenth: The Official Podcast of the National Neuroscience Curriculum Initiative (NNCI),0,0,0,0,1,1
1478839226,The Lost Drive-In,1,0,0,0,65,66
1478880454,Brooklyn Zen Center Audio Dharma Podcast,0,0,0,0,2,2
1478899470,Optophobia,0,0,0,0,4,4
1478916120,Yoga from the Source,0,0,0,0,3,3
1478923801,BIN Radio,0,0,1,0,24,25
1478932231,Talkin' Trader Joes,0,0,0,0,12,12
1478938636,She's Just Getting Started™ - Tips for starting a business & making money doing what you love,1,0,0,0,41,42
1478945784,Listen Hunnay with Jeannie Mai,3,1,8,6,163,181
1478952711,Today in PA | A PennLive daily news briefing with Claudia Dimuro,0,0,1,0,19,20
1478960893,Of Course You Realize THIS Means Podcast - A Looney Tunes Discussion,0,0,0,0,3,3
1478975367,Steroids Podcast - Real Bodybuilding Training Diet and Supplementation Science for Muscle Building,3,0,0,0,47,50
1478998729,Evolve 2 Pagan Podcast,1,0,0,1,7,9
1479014499,Brave New World,0,0,0,0,1,1
1479031192,The Dan John Podcast,0,0,0,0,23,23
1479039137,Watchmen Watch,1,0,0,3,8,12
1479052215,Peak Endurance,0,1,0,0,1,2
1479053637,Network Marketing Breakthroughs with Rob Sperry,0,0,0,0,19,19
1479053665,Penguin Magic Podcast,0,0,0,0,6,6
1479057220,Over 40 & Faded,0,1,0,0,14,15
1479062989,PMP Exam Success Secrets with Scott,3,0,0,0,25,28
1479074542,Better with Dr. Stephanie,1,0,0,0,43,44
1479074862,Visible,0,0,0,0,3,3
1479092574,MOONFACE,0,2,0,0,48,50
1479092695,The Hank Haney Podcast,9,0,2,4,57,72
1479095304,The Andy Pollin Hour Podcast,1,0,0,0,1,2
1479107698,Recode Daily,11,8,6,6,117,148
1479112798,Super Carlin Brothers,0,0,0,1,46,47
1479119960,5 Second Rule,0,0,1,1,0,2
1479120204,Long May They Run,0,1,3,2,44,50
1479124505,Demolisten,0,0,0,2,25,27
1479133426,Friends From Work,0,0,0,1,64,65
1479133919,Excuse Me: The Vickie Guerrero Show,0,0,1,0,10,11
1479137502,The Daily Space,0,1,0,0,8,9
1479138243,KINGS OF THE PODCAST ™️,1,0,2,2,16,21
1479148682,See America,0,0,0,0,19,19
1479150610,Onto Waveland: A show about the Chicago Cubs,1,0,2,2,6,11
1479150771,755 Is Real: A show about the Atlanta Braves,1,1,2,2,21,27
1479151754,Keep 'em Nude: The story of the 99ers,0,0,0,0,1,1
1479197664,Not Neurotypical w/ Laura Zdan,0,0,0,0,20,20
1479201110,Flip The Script,0,0,0,0,61,61
1479202955,BallTalkers Podcast,0,0,0,0,1,1
1479208112,Ben Rimalower's Broken Records,0,0,0,0,11,11
1479227419,Camp Monsters,0,0,1,3,46,50
1479234915,The Thing About Pam,6,2,20,10,146,184
1479245851,Correct Opinions with Trey Kennedy,1,1,1,1,46,50
1479266398,Cryptids,0,1,0,4,42,47
1479277874,Ryzzun Energy,0,0,0,0,5,5
1479298432,Making Sense of Pets,0,0,0,0,2,2
1479298456,Pharmacy to Dose: The Critical Care Podcast,0,1,0,2,8,11
1479308325,The Things We Do,2,0,0,0,92,94
1479312117,Eat Your Spanish: A Spanish Learning Podcast for Kids and Families!,2,0,0,1,47,50
1479329996,"It's Fine, I'm Fine",7,0,1,0,42,50
1479330738,City Ballet The Podcast,0,0,1,0,6,7
1479333588,The Book of Life and Living with Reb Mimi Feigelson,0,0,0,0,1,1
1479333981,Storybound,5,4,6,5,30,50
1479338239,The Q & A with Rabbi Breitowitz Podcast,0,0,0,0,2,2
1479346591,Kosmographia,0,0,1,3,50,54
1479349063,What The HR! TCSHRM HR Podcast,0,0,0,0,13,13
1479389232,The Universe Speaks in Numbers,0,0,0,0,2,2
1479402048,Inspire Health Podcast,0,0,0,1,4,5
1479421145,The Continuing Adventures of John Blade: Super Spy,0,0,0,2,0,2
1479444959,The Edge of Sleep,2,1,2,4,41,50
1479445547,NinosCorner™ Podcast,0,0,0,0,1,1
1479455008,Scam Goddess,0,1,3,1,45,50
1479457300,Law X.0,0,0,0,0,1,1
1479468209,Past Gas by Donut Media,0,1,3,3,43,50
1479472319,Dr. Finlayson-Fife's Podcast Archive,1,0,2,0,29,32
1479481950,Listed,0,0,1,0,6,7
1479489504,Sean Oliver's Kayfabe Podcast,1,0,2,1,15,19
1479506992,Monsters Vs Men,0,0,0,0,17,17
1479522737,Formula 1 Grid Talk Podcast,0,0,2,0,1,3
1479554969,NHL @TheRink,1,1,0,1,13,16
1479559103,Gap Time,0,0,1,2,6,9
1479561926,And Now The Hard Part,1,1,1,0,7,10
1479561986,The Best Little Horror House in Philly,0,0,0,0,23,23
1479564642,Those Who Were There: Voices from the Holocaust,0,0,0,0,9,9
1479603056,Puppy Training Principles,0,0,0,0,2,2
1479606317,Babel: Translating the Middle East,0,0,0,0,5,5
1479608194,The Razor's Edge,1,0,1,0,8,10
1479619225,Another Marvel Podcast,1,0,0,0,3,4
1479619320,The Jasmine Star Show,0,0,0,4,196,200
1479620257,Dingers - The only fantasy baseball podcast for smart people,1,0,0,0,8,9
1479624416,The Pharm So Hard Podcast: An Emergency Medicine and Hospital Pharmacy Podcast,0,0,0,0,2,2
1479639548,Harbor,0,0,0,0,14,14
1479643724,The Influential Personal Brand Podcast,0,0,0,3,127,130
1479657741,Jetlagged ✈️,0,0,0,0,1,1
1479682063,A Psychic's Story,0,0,0,1,12,13
1479698334,"""The Dirt"" Trailrunning Podcast",0,0,0,2,22,24
1479706872,The AMA Podcast,0,0,0,1,8,9
1479709811,The Creeping Hour,2,4,3,6,35,50
1479721943,War & Peace,0,0,0,0,2,2
1479723447,The Culling,0,1,0,0,4,5
1479725737,The Gemini Scorpio Podcast,0,0,0,0,3,3
1479738261,Good Talk with Anthony Jeselnik,1,0,0,1,16,18
1479793208,meteorologyIRL,0,0,0,0,1,1
1479813908,Grand Master Level Podcast,0,0,0,0,2,2
1479852150,Unleashed,0,0,0,0,2,2
1479856792,Mohammed Hijab,0,0,0,0,3,3
1479869759,The Thorne Podcast,0,0,0,0,1,1
1479871899,My Life of Crime with Erin Moriarty,6,3,5,8,34,56
1479882159,Brad & Will Made a Tech Pod.,3,2,1,2,68,76
1479884325,Recovery Dharma Audiobook,0,0,0,0,1,1
1479891283,Jay and Dave's Sports Bar,0,0,0,0,4,4
1479921758,Creative Therapy Umbrella,0,0,0,1,16,17
1479924013,All Through a Lens: A Podcast About Film Photography,0,1,1,0,9,11
1479924698,A Moment In Crime,1,2,1,0,2,6
1479939374,None But The Brave,0,0,0,0,16,16
1479953993,Hey It's Enrico Pallazzo Fantasy Baseball,0,0,0,1,19,20
1479973402,You're Dead To Me,0,3,3,9,177,192
1480036653,“The Horror Cast” Intelligent Horror Movie Discussion,0,1,0,0,12,13
1480037528,The Aquarium Guys,2,1,1,1,14,19
1480037919,2 for 1 Drafts,1,0,1,1,497,500
1480041703,Central Synagogue Podcast,1,0,0,0,0,1
1480043803,Rick & Bubba University Podcast,2,0,2,0,68,72
1480050832,Notes from the Backpack: A PTA Podcast,1,0,0,0,26,27
1480055524,The Mysterious Mr. Epstein,64,39,49,47,208,407
1480059697,Business Casual,31,19,23,12,115,200
1480067454,A Date With The Bake,3,1,2,1,143,150
1480068586,Encouraged with Celebrate Kids,0,0,0,0,16,16
1480069613,Youre The Man Now Dog,0,0,0,0,44,44
1480069950,Goddess Confessions,0,0,0,2,47,49
1480122326,The Construction Life,0,0,0,0,11,11
1480128157,Growing Microgreens Podcast,0,0,0,0,1,1
1480143610,The Cut,2,0,0,1,25,28
1480157950,Pali audio,0,0,0,0,2,2
1480159954,The Mr. Bill Podcast,0,2,0,1,46,49
1480164569,LIFE WITH AN ESTHETICIAN,0,1,0,0,0,1
1480167042,Songbirding,0,0,0,0,7,7
1480167663,The Kaiju Apostle Podcast,0,0,0,0,12,12
1480175191,Bible Stories for Heathen Children,0,0,0,0,4,4
1480175657,Used Car Dealer Podcast,0,0,0,0,1,1
1480176264,Sample Excavator,0,0,0,0,15,15
1480178861,What's in the Basket,0,0,0,0,4,4
1480180291,Kosher Queers,0,0,0,0,7,7
1480201597,Classic Ghost Stories,0,0,0,0,27,27
1480215364,The World Rugby Podcast,0,0,0,0,1,1
1480218010,God for Grownups,0,0,0,0,3,3
1480223567,The IcePod,0,0,0,0,2,2
1480257700,The Ray & Dregs Hockey Podcast,1,2,0,1,16,20
1480259187,The Great Women Artists,0,0,0,2,27,29
1480260388,Handyman Pros Radio Show,0,0,0,0,4,4
1480263708,Your Own Backyard,3,8,9,12,468,500
1480270157,Hunting Warhead,1,1,6,9,273,290
1480277989,VMP Anthology,0,0,0,0,1,1
1480282074,Inevitable Change✨,0,0,0,0,1,1
1480295967,Today in Digital Marketing,0,0,0,0,21,21
1480300467,"Fight Hustle, End Hurry",0,3,4,7,74,88
1480304882,Facing Fate,1,0,0,0,4,5
1480305003,Bigger Than Us,0,0,0,0,5,5
1480305567,Sin Llorar,0,0,1,0,17,18
1480311435,Office Ladies,35,63,105,56,1008,1267
1480313729,Taking Sides with The Dashleys,0,0,1,3,406,410
1480316467,Lone Star Outdoor Show,0,0,0,0,7,7
1480319986,90 Day Fiance Mmkay,1,0,2,3,10,16
1480320465,Aquinas 101 - Course 2: Introduction to Thomistic Philosophy,0,0,0,0,4,4
1480321270,The Ever Evolving Truth,9,4,13,5,18,49
1480369430,Inside College Soccer,0,0,0,0,4,4
1480370692,Mija Podcast (French),0,0,0,0,2,2
1480370916,Mija Podcast (Spanish),0,0,0,0,5,5
1480370918,Mija Podcast (English),0,0,0,0,9,9
1480376047,Badass Women at Any Age,0,0,1,0,1,2
1480382078,Cursed Podcast,0,0,0,0,34,34
1480387124,Comedians with Ghost Stories,0,0,0,1,20,21
1480398327,The Leader | Evening Standard daily,0,0,0,1,0,1
1480583664,Elon Musk Pod,1,0,0,0,1,2
1480586314,The Adventures of Ben Squared,0,0,0,0,4,4
1480586463,On The Brink with Castle Island,0,0,0,0,36,36
1480589194,Women Rocking Real Estate Podcast,0,0,0,0,16,16
1480590700,Football & Grits: A daily podcast about SEC football,2,0,0,1,8,11
1480593827,Shelf Love: Romance Novels Unpacked with Love,0,0,0,0,16,16
1480593828,Financially Free Journey,0,0,0,0,30,30
1480593911,Rude Tales of Magic,0,0,0,2,48,50
1480595648,She Reads Truth Podcast,2,1,2,5,201,211
1480598793,Andrea Savage: A Grown-Up Woman #buttholes,0,0,0,0,50,50
1480599127,Bowmar Show,4,0,0,0,46,50
1480603149,Learn to Paint Podcast,0,0,0,0,6,6
1480605295,POLITICO Energy,2,0,0,3,5,10
1480605577,Locked On Bruins - Daily Podcast On The Boston Bruins,3,1,1,1,19,25
1480605872,The Vicious Circle Podcast,0,0,0,0,5,5
1480612145,Cry Power Podcast with Hozier and Global Citizen,0,0,0,0,25,25
1480615007,Three of Seven Podcast,0,0,0,0,50,50
1480626727,The Life Boss Podcast,1,1,0,1,21,24
1480638693,Breaching Extinction,0,0,0,0,2,2
1480639251,The Naughty Dog Podcast,0,0,0,0,2,2
1480657973,Pro-Fit Golf Conditioning Podcast,0,0,1,0,4,5
1480674640,Lisa A Romano Breakdown to Breakthroughs,0,0,0,0,20,20
1480675242,RIDE AND TALK - THE BMW MOTORRAD PODCAST,0,0,0,0,2,2
1480709469,Strength Training For Cyclists - Dialed Health,0,0,0,0,48,48
1480713299,Urgency of Change - The Krishnamurti Podcast,0,0,0,0,9,9
1480726134,Deep Dive with the Institute for Justice,0,0,0,0,2,2
1480766062,ARN,10,6,7,6,161,190
1480767891,Protect Your Noggin,0,0,0,0,12,12
1480776334,Joyful Marketing,1,0,0,0,41,42
1480784209,SKinFolk,0,0,0,0,6,6
1480792783,Chasing Giants with Don Higgins,3,0,0,1,50,54
1480794624,Iron-On Wrestling with Gregory Iron,0,0,0,1,21,22
1480795036,Raw Truth: Stories of Female Infidelity,0,0,0,0,11,11
1480809045,What Would Jamie Do?,0,1,0,2,233,236
1480843422,Soul Soil: Where Agriculture and Spirit Intersect with Brooke Kornegay,0,0,0,0,9,9
1480847786,Locked On Blackhawks - Daily Podcast On The Chicago Blackhawks,1,3,2,3,24,33
1480853742,Inside the Admissions Office: Advice from Former Admissions Officers,0,0,0,0,15,15
1480854824,Finding Your Purpose,0,1,0,1,19,21
1480860366,Sundays With Cate,0,0,2,1,7,10
1480889809,Happy as a Mother,0,0,0,0,50,50
1480890290,Squawk Pod,4,3,1,2,28,38
1480904163,The Anxious Achiever,1,0,1,0,25,27
1480913421,Reppin,0,0,0,0,11,11
1480920164,The Strange Harbors Podcast,0,0,0,0,18,18
1480930358,"HELLO HOLLY – the podcast about interior, trends and friends",0,0,0,0,9,9
1480951419,BodhiHeart Podcast with Khenpo Sherab Sangpo,0,0,0,0,1,1
1480955561,Stamp With Us,0,0,0,0,2,2
1480965056,Theory & Philosophy,0,1,0,0,10,11
1480970735,The Good-Good Golf Podcast,0,0,0,0,2,2
1480978629,Six Figure Authors,0,0,1,1,45,47
1480991718,Clearstory,0,0,4,2,44,50
1480993478,Lecture Breakers,1,0,0,0,2,3
1480995584,Listen To This While You Shit,0,0,0,0,5,5
1480997091,The Tower,1,0,0,2,10,13
1481003819,The Uncensored Podcast with Tumbo & Black Moses,0,0,1,0,10,11
1481010774,Legends Only - A Pop Culture Podcast,2,0,1,1,81,85
1481017105,Curator on the Go Podcast,0,0,0,0,3,3
1481019308,Blerdy Talk,0,0,0,0,3,3
1481027491,Following The Leftovers,1,0,0,0,4,5
1481057827,Friends Watching Friends Podcast,5,0,1,1,17,24
1481087511,Locked On Canadiens - Daily Podcast on the Montreal Canadiens,0,0,0,0,3,3
1481093871,Demystifying Gay Porn,0,1,0,0,3,4
1481107230,Historias de cama,0,0,0,0,5,5
1481120045,Mommy Labor Nurse,0,3,1,0,35,39
1481122529,The Breaks – KUTX,0,0,0,0,5,5
1481124544,Telemundo Deportes,0,0,0,0,5,5
1481125618,From Scratch with Michael Ruhlman,0,1,0,1,14,16
1481127855,The Hacker Next Door,0,0,0,0,3,3
1481135244,Hacking Your ADHD,0,1,0,1,28,30
1481138656,John Oliver Podcast,11,1,2,0,2,16
1481145773,Posse de Bola,0,0,0,0,4,4
1481145911,Mythical Monsters,4,3,6,3,34,50
1481160337,Creepy Pasta Myths,4,0,0,0,28,32
1481197705,Volunteer Plain Talk,0,0,0,0,1,1
1481218159,Sue Perkins: An hour or so with...,7,2,2,2,87,100
1481231734,LEAVE YOUR MARK,0,0,0,0,83,83
1481239682,15 Hour Sound Machines (no loops or fades),1,1,3,0,11,16
1481247292,Graced Health,0,0,0,0,13,13
1481252940,Locked On Sharks - Daily Podcast On The San Jose Sharks,2,0,0,1,10,13
1481253733,Locked On Ducks - Daily Podcast On The Anaheim Ducks,0,1,0,0,4,5
1481254034,Go Rangers Radio,0,1,0,0,13,14
1481254566,American Elections: Wicked Game,16,4,1,3,26,50
1481254854,Locked On Golden Knights - Daily Podcast On the Vegas Golden Knights,1,1,0,0,6,8
1481261969,Thrillist Explorers,3,0,1,0,45,49
1481265576,Who Is?,35,9,8,4,45,101
1481266455,Proverbial,0,0,0,2,15,17
1481283173,The Jerry Lawler Show,0,0,0,0,25,25
1481291824,The Weekly Knightly Podcast - by Vegas Golden Knights Fans,2,0,0,1,2,5
1481292809,Steministas,0,0,0,0,2,2
1481348744,Serious Angler - Bass Fishing Podcast,0,0,0,0,6,6
1481362257,Better: The Brand Designer Podcast,0,0,0,0,17,17
1481365894,Sissy That Pod,0,0,0,0,2,2
1481366978,Comedians on South High,0,0,0,0,4,4
1481369481,Locked On Kings - Daily Podcast On The Los Angeles Kings,1,0,1,0,1,3
1481383415,Climate Changers,0,0,0,0,3,3
1481391102,clean. simple. free,1,0,2,1,25,29
1481398762,Dolly Parton's America,10,4,10,2,118,144
1481400586,Among the Jungle Podcast,0,0,0,0,14,14
1481428395,Laz and Powers: A show about the Chicago Blackhawks,0,0,0,0,4,4
1481428641,Wings for Breakfast: A show about the Detroit Red Wings,0,0,2,0,8,10
1481428656,No Sleep Til Belmont: A show about the New York Islanders,1,0,0,0,6,7
1481428713,Straight From The Source with Michael Russo: A show about the Minnesota Wild,0,0,2,1,4,7
1481464847,Austin Headline News Express,0,1,2,2,3,8
1481465172,The Property Academy Podcast,0,0,1,1,39,41
1481477992,The Graham Stephan Show,1,1,0,0,10,12
1481502917,The Profitable Website: Digital Marketing Secrets For Small Business Success,0,0,0,0,27,27
1481506203,Scarred For Life,0,0,0,2,50,52
1481510647,Anime Trap House,0,0,0,0,2,2
1481521396,Conversations with Charlie,0,0,0,0,2,2
1481543060,Cam & Strick Podcast,2,1,2,3,32,40
1481543700,Chemist Confessions,1,1,2,2,6,12
1481575548,AoS Coach,0,0,0,0,1,1
1481597697,Locked On Penguins - Daily Podcast On The Pittsburgh Penguins,0,0,0,0,4,4
1481597851,The Baseball Prospectus Podcast Network,0,0,2,0,2,4
1481613895,HawgBeat Pods,0,0,1,0,3,4
1481619684,Sexduction Academy (SEX TABLE TALK),0,0,0,0,7,7
1481624475,The Lion’s Roar Podcast,1,0,0,0,8,9
1481635873,Not Lukewarm Podcast with Deanna Bartalini,0,0,0,0,4,4
1481650374,Talking Stuff: Ohio State Recruiting Podcast,0,0,1,0,18,19
1481660223,Wu-Tang: The Saga Continues,0,0,0,0,4,4
1481688463,Smart Tech Today (Audio),0,0,1,0,6,7
1481716218,Talking Home Renovations with the House Maven,0,0,0,0,6,6
1481720117,Brave Knitting,0,0,0,0,1,1
1481726535,Alpha Trader,1,1,1,3,3,9
1481728195,TRIVIA TIME,2,1,1,1,39,44
1481732173,Paul Graham's Essays by Listle,1,0,0,0,0,1
1481736651,The Leo & Danny Show,4,1,0,0,37,42
1481768180,The Fangirl Business,0,0,0,0,4,4
1481776281,Grits and Grinds: Memphis Grizzlies,1,1,1,0,5,8
1481789790,This is The Goods,0,0,0,0,2,2
1481801238,The Top 100 Games Podcast,0,1,0,1,28,30
1481805272,The Living Easy Podcast,0,1,0,5,445,451
1481852023,Behind the Horns,0,0,0,0,3,3
1481852465,Air Force Handbook 1,0,0,1,1,0,2
1481869152,I'd Buy That For A Dollar,0,0,0,0,7,7
1481878006,DIESEL SHOP TALK PODCAST,0,0,0,0,1,1
1481890792,Catch The Fever Fishing Podcast,0,0,0,0,1,1
1481899710,Red Carpet Rendezvous,0,0,1,0,24,25
1481906266,Football Today,0,0,0,0,9,9
1481907254,Locked On Sabres - Daily Podcast On The Buffalo Sabres,1,0,2,0,3,6
1481907672,Primary Care Pod,0,0,0,0,4,4
1481911502,I Did Not Sign Up For This,0,0,0,0,3,3
1481920763,Tales from the Moosiverse,0,0,0,0,11,11
1481923946,Talking Scripture,1,1,4,0,79,85
1481932456,Rice To Meet You,1,0,2,1,46,50
1481971681,The Secret Life of Prisons podcast,0,0,0,0,1,1
1481982630,Fault Lines,1,0,0,0,3,4
1481983747,Mockery Manor,0,1,0,2,16,19
1481996448,The Engineering Leadership Podcast,0,0,0,0,3,3
1481997309,Castaway,1,1,1,0,58,61
1481999470,Planthropology,0,0,0,0,23,23
1482013417,Locked On Fantasy Hockey,0,0,0,0,13,13
1482018906,Running the 615,0,0,0,0,12,12
1482061243,Full Story,9,2,10,8,65,94
1482065046,The Shape of Care,0,0,0,0,3,3
1482067226,The Next Big Idea,9,6,11,7,51,84
1482070333,Crypto News Alerts | Daily Bitcoin (BTC) & Cryptocurrency News,2,3,2,4,96,107
1482075980,The Well Grand Rapids,0,0,0,0,1,1
1482132871,Why It Matters,9,0,1,3,44,57
1482140536,"Me, My Demon, and I",0,0,0,0,13,13
1482149602,Ovinology,0,0,0,0,1,1
1482152133,Little Steven's Underground Garage - Coolest Conversations,0,0,0,0,1,1
1482165135,Questionable Material with Jack & Brian,0,0,0,2,39,41
1482165330,Teen Talk!,1,0,1,1,8,11
1482166178,Honey Sex Talk,0,0,0,0,2,2
1482179882,Beg to Differ with Mona Charen,4,1,5,4,36,50
1482193534,Tour Stories,0,0,0,0,2,2
1482201439,Bobby Approved - The FlavCity Shopping Experience,0,0,1,0,26,27
1482205598,Transformations Through Running,0,0,0,0,12,12
1482211846,The History of American Slavery,7,7,4,2,9,29
1482212953,Culture Gabfest,4,0,1,3,6,14
1482214296,Ted & Tempany Talk Sex,0,0,0,0,4,4
1482217790,Scouting The Refs Podcast,0,0,0,0,1,1
1482218180,Extra Napkins Podcast,0,0,0,0,37,37
1482253375,The Music Podcast for Kids!,0,0,0,0,4,4
1482281446,Crypto Ballers : NBA Top Shot Podcast,3,0,0,0,140,143
1482286194,Spilling the G&T: Rupauls Drag Race,0,0,0,1,5,6
1482302167,The Second Oil Age,1,4,8,5,24,42
1482302708,On The Gold   Prospecting 2 Mining with Kevin Hoagland,0,0,0,0,3,3
1482304722,Back In The Closet - Two Crazy Cat Ladies,0,0,0,0,2,2
1482306113,The Streaming Wars,0,1,0,1,0,2
1482310665,I Spy,6,6,2,8,136,158
1482313742,Brian Lehrer: A Daily Politics Podcast,6,1,2,2,17,28
1482323669,Hands-On Photography (Video),0,0,0,0,18,18
1482324726,Talk Dead To Me,2,1,1,1,13,18
1482332890,GeeGo Live,0,0,0,2,5,7
1482338339,The Attaway Appeal,2,0,2,2,16,22
1482360881,Tackle Talk - Bass Fishing Podcast,1,0,0,0,21,22
1482399861,Tomorrowland Friendship Mix,0,0,0,1,1,2
1482406262,Margaritas & Donuts,0,0,0,1,13,14
1482411529,Divine Destiny with Latoya,0,0,0,0,4,4
1482419385,QuizzleMania: A Wrestling Comedy Quiz Show!,0,0,0,0,1,1
1482424209,Locked On Flyers - Daily Podcast On The Philadelphia Flyers,2,0,0,0,3,5
1482426505,The Record Store Day Podcast with Paul Myers,0,1,1,0,14,16
1482428549,Culture First,0,0,0,0,8,8
1482430204,Inside a Sinister Mind,0,1,0,1,30,32
1482430556,Voices In Validation,0,0,0,0,1,1
1482431848,We Don't Deserve Dogs,0,0,1,1,48,50
1482433220,The Vets Unleashed,0,0,0,0,17,17
1482437196,With Caulk and Candles,0,0,0,0,2,2
1482441301,The SoccerWire Podcast,1,0,0,0,1,2
1482447809,Beyond The Beat,0,0,0,0,1,1
1482448472,On the Ground with Samaritan's Purse,0,0,0,0,26,26
1482449855,DailyTekk AfterParty,0,0,0,0,9,9
1482455669,Defiance,0,0,0,1,29,30
1482481719,Squawk Ident - An Aviation Podcast,0,0,0,0,5,5
1482502667,Gutting the Sacred Cow,1,0,0,4,138,143
1482510236,The Todd Starnes Show,5,1,2,0,30,38
1482516550,Gen Z Girl,1,0,0,0,49,50
1482561357,Minecraft explained: the mobsters,9,2,4,2,8,25
1482566489,FULCRUM News - USA and Global Top News Updates,6,0,0,0,25,31
1482572182,The Utah UAP Podcast,0,0,0,0,1,1
1482575855,Short Wave,10,4,14,6,164,198
1482580830,Third Eye Awakening,0,0,0,0,15,15
1482584144,Making The Impact - A Dance Competition Podcast,0,0,1,0,49,50
1482584247,CBG Radio,0,0,1,0,0,1
1482596277,Jimmy Eat Pod,1,0,1,0,8,10
1482600740,The Batwoman Podcast,1,0,1,0,3,5
1482634886,"UNEWS, Top stories for U.S. Latinos in English",0,0,0,0,1,1
1482645186,Kim Komando Daily Tech Update,0,0,0,0,1,1
1482647944,6 Feet Above with Megan Armstrong,0,0,0,0,9,9
1482648241,Locked On Capitals - Daily Podcast On The Washington Capitals,4,2,0,0,13,19
1482658194,The Basketball&Barbells Podcast,0,0,0,1,2,3
1482665129,The VSiN Market Insights Podcast with Josh Appelbaum,3,0,0,0,22,25
1482667592,The Human Risk Podcast,0,0,0,0,3,3
1482669176,DUST,0,1,2,5,42,50
1482680261,ESPN Daily,43,12,13,24,364,456
1482681517,Our Line Starts,1,1,0,1,6,9
1482691345,Shamayim: Jewish Animal Advocacy,0,0,0,0,1,1
1482713471,Straighten Your Crown,0,0,0,1,8,9
1482723951,The Stationery Cafe,0,0,3,0,15,18
1482728867,Academy Football Network Podcast,0,0,0,0,1,1
1482735472,A to Z Running,0,0,0,0,20,20
1482771543,Fait main,0,0,0,0,1,1
1482801842,Waddle & Silvy,2,1,1,0,10,14
1482802816,Kap & J. Hood,10,3,0,1,8,22
1482803055,Carmen and Jurko,0,1,0,0,2,3
1482803660,Bleck & Abdalla,0,0,0,0,7,7
1482805082,John Jastremski,0,1,0,1,0,2
1482805648,Motivational Speakers,0,0,0,0,1,1
1482820355,So Bad It's Good with Ryan Bailey,17,1,5,6,276,305
1482845057,A Las Carreras,0,0,0,0,1,1
1482851200,Bad Batch,37,38,61,45,232,413
1482859791,REACH - A Podcast for Executive Assistants,1,0,0,2,18,21
1482864006,Run The Riot Podcast,0,0,0,0,17,17
1482887969,Former Adventist,2,1,0,0,21,24
1482906139,Bryan Air,0,0,0,0,2,2
1482910877,Chasing Poker Greatness,0,0,0,0,29,29
1482915134,EstheticianOnTheEdge,0,0,0,0,63,63
1482927095,The Animatics Podcast,0,0,0,0,1,1
1482968569,Humanity's Team Podcast with Steve Farrell,0,0,0,0,4,4
1482980221,11:11,0,0,0,0,3,3
1482984603,COMPLEXITY,0,0,1,0,15,16
1482999433,Scrub Caps & Sippy Cups,0,0,0,0,27,27
1483003004,STORIES FOR KIDS,0,0,0,0,2,2
1483009735,Tag Team Pokemon TCG Podcast,0,0,0,0,6,6
1483011704,Nothing Personal with David Samson,15,5,1,5,402,428
1483012660,Are UFO Real?,2,2,1,0,13,18
1483073168,Following Harriet,0,0,0,1,44,45
1483081371,Unstuck | Mindset • Energy • Business • Life,1,0,0,0,40,41
1483081827,Guy Kawasaki's Remarkable People,3,2,3,0,133,141
1483086030,The Godly Dating 101 Podcast,2,1,1,6,490,500
1483090685,Consider This,0,0,0,0,3,3
1483134030,Beat Check with The Oregonian,0,0,0,0,6,6
1483134323,Just Get Fit with Nikki,0,0,0,2,48,50
1483159889,The Perspectives Podcast,0,0,0,0,10,10
1483162548,PCOS Fighters - Weight Loss Method,0,0,0,0,1,1
1483173609,BTS Happy Hour,0,0,0,0,1,1
1483175040,Animation Happy Hour,0,0,0,0,20,20
1483181738,Play No Games Podcast,0,0,0,0,6,6
1483230313,Dublin Murders,6,0,0,0,2,8
1483233279,Greeking Out from National Geographic Kids,1,0,0,6,43,50
1483233538,WWE After The Bell with Corey Graves,24,8,8,10,293,343
1483237956,Locked On NHL - Daily Podcast On The National Hockey League,1,0,0,1,4,6
1483238021,PMU School: A Podcast For Artists by Artists,0,0,0,0,15,15
1483238581,The SXS Guys Offroad Podcast,0,0,0,0,3,3
1483241955,Zero Hours,6,5,1,1,37,50
1483252435,Full Body Chills,2,1,2,2,43,50
1483256510,The Melt Podcast,0,0,0,0,6,6
1483261668,ShrinkChicks,0,0,0,3,30,33
1483264365,Business of Tech,0,0,1,0,1,2
1483267868,Hollinger & Duncan NBA Show - NBA Basketball Podcast,12,4,5,5,91,117
1483270312,Game Notes: A Show About The Utah Jazz,0,0,0,0,11,11
1483275662,Good Morning From Hell,2,3,0,1,44,50
1483289230,Radio Rental,5,7,10,23,455,500
1483290411,It was a Thing on TV:  An Anthology on Forgotten Television,0,0,0,0,3,3
1483292770,Bewitched Crafts with Tracy Miller,0,0,0,0,2,2
1483299584,That's in the Bible,0,0,0,0,5,5
1483304964,» Divine Intervention Podcasts,1,0,0,0,15,16
1483329487,Setting the Tone: An ER Retrospective,0,0,0,1,4,5
1483339602,Storytime with Tula Jane and her Mother In The Wild,0,0,0,0,3,3
1483345080,Science Rehashed,0,0,0,0,25,25
1483365681,Onsite!,2,0,0,0,1,3
1483378901,A Cricketing View,0,0,0,0,1,1
1483380582,The Brandon Adams Podcast,1,0,0,0,10,11
1483398992,SONDHI TALK,0,0,0,0,2,2
1483399748,Shooters Gotta Shoot,0,1,1,3,226,231
1483485062,Learning Bayesian Statistics,0,0,0,0,1,1
1483488736,Anything is Poddable: A Podcast about the Boston Celtics,2,1,1,1,19,24
1483494287,Gaslight,12,14,11,5,8,50
1483505341,The Forum Club: A Show About The Los Angeles Lakers,0,2,2,0,3,7
1483510527,The Stack Overflow Podcast,1,1,0,1,0,3
1483513974,Science of Reading: The Podcast,1,0,1,1,11,14
1483517744,Nordic Mythology Podcast,0,1,0,0,26,27
1483525141,Book of Basketball 2.0,34,11,15,21,383,464
1483527353,Cannabis Science Today,0,0,0,0,7,7
1483534241,Affirmation Meditation Podcast with Bob Baker,0,1,0,0,9,10
1483544772,The Modern Homesteading Podcast,0,0,0,0,10,10
1483545272,Keeping-Track,0,0,1,1,36,38
1483548814,Sleeved Believe The Hype Podcast,0,0,0,0,9,9
1483550571,Demon Slayer Podcast,0,0,0,1,0,1
1483563171,No F'n Regrets with Robb Flynn,0,1,0,1,23,25
1483584801,Internal Medicine For Vet Techs Podcast,0,0,0,0,28,28
1483638752,All The Smoke,56,0,5,7,360,428
1483640498,"Hoops, Adjacent with David Aldridge and BIG Wos",1,0,0,1,15,17
1483643216,The Boys & Girl Podcast,2,0,3,1,25,31
1483652001,Drake Hall Memphis,0,0,0,0,6,6
1483654175,Wild,1,0,2,0,6,9
1483670125,ASHPOfficial,0,0,0,0,1,1
1483692776,What A Day,7,5,1,3,34,50
1483708065,Criterion Channel Surfing,0,1,1,0,2,4
1483715963,The Stream Scheme,0,0,0,1,5,6
1483757361,The Greatest Game with Jamie Carragher,0,0,0,1,20,21
1483768296,The Christian Single Moms Podcast,0,0,0,0,11,11
1483861465,Basic Physics 101,1,0,0,0,0,1
1483864185,Mid-Atlantic Championship Podcast,0,0,0,0,20,20
1483865381,The Perfect Pup,0,0,1,0,2,3
1483870610,RunChats with @RonRunsNYC,1,0,0,0,31,32
1483872464,Ask Ronna,0,0,1,1,48,50
1483872549,Hard Landings,0,0,1,0,4,5
1483878553,Midwest Flyways Podcast,0,0,0,0,37,37
1483883027,Locked On Devils - Daily Podcast On The New Jersey Devils,1,2,0,0,8,11
1483941179,Me lo dijo Adela,0,0,0,0,1,1
1483954502,Because I Can Life,0,0,0,0,50,50
1483968471,Conversations With Abraham Hicks,1,0,2,1,5,9
1483974278,FreightWaves LIVE: An Events Podcast,0,0,0,0,1,1
1483999403,The Vibe,0,0,0,0,1,1
1484003537,dj maphorisa's Podcast,0,0,1,4,27,32
1484021704,Blxxk Anime,0,0,0,0,3,3
1484030939,Driven Young,0,0,0,0,6,6
1484071637,Full Chat - With MrJWW,0,0,1,0,5,6
1484087819,Fandible: Warhammer 40k Actual Play,0,0,0,0,1,1
1484090159,Locked On Rangers - Daily Podcast On The New York Rangers,0,1,2,0,3,6
1484099835,Ledlow & Parker,1,0,0,1,32,34
1484101742,Restaurant Hoppen,0,0,1,0,10,11
1484110017,Spiritual Shit,0,0,0,0,43,43
1484112288,The E3Rehab Podcast,0,0,0,0,3,3
1484118591,Yo soy un Gamer,0,0,0,0,1,1
1484123028,Now You Listen Podcast,1,0,0,0,2,3
1484142154,Blood Ties,2,2,5,2,39,50
1484145761,"Bye, Pumkin",0,0,0,0,50,50
1484148938,Fox and Faust | LA Kings,0,0,0,0,4,4
1484152411,Home Inspection Whisperer's Podcast,0,0,0,0,6,6
1484214435,Mom Genes The Podcast,0,0,0,0,26,26
1484220983,MOOD with Lauren Elizabeth,119,33,23,23,247,445
1484277662,Knight Light: A Horror Movie Podcast,3,1,0,0,26,30
1484287750,The Financial Confessions,5,7,8,5,28,53
1484288322,American Roots Outdoors w/ Alex Rutledge,0,0,0,0,41,41
1484292666,The Q Files,0,0,0,0,19,19
1484294695,Welcome to the Uncharted Territories,0,0,0,0,1,1
1484295815,That's Incredible,0,0,0,0,3,3
1484296490,Did I Stutter?? with Drew Lynch,3,0,2,2,43,50
1484300888,Out of Touchstone,0,0,0,0,2,2
1484336413,Kids Short Stories,0,0,2,1,47,50
1484363220,Sam Miller Science,0,0,0,0,50,50
1484378635,Books Unbound,0,1,4,0,27,32
1484379627,Weekly Spooky - Scary Stories to Keep You Up at Night,0,0,0,2,8,10
1484397632,14 Days with Felicity,5,1,2,0,31,39
1484403141,How to Get Over Your Ex,1,0,3,1,66,71
1484406030,The Fraudcast: A 90 Day Fiance Podcast,91,40,19,10,215,375
1484406501,Quantitude,0,0,0,0,7,7
1484407459,Activist #MMT - podcast,0,0,0,0,2,2
1484408677,Boomtown,8,10,16,23,312,369
1484422226,Daily Pop,11,2,4,3,17,37
1484422703,Nightly Pop,1,0,0,0,13,14
1484426115,Crying at the Bar,0,0,0,0,1,1
1484428621,Hunted,3,5,8,3,31,50
1484432609,The Block Party with Seth Kushner,4,0,0,2,70,76
1484438529,Political Scandals,13,5,7,4,21,50
1484445852,The Art Angle,0,0,1,1,13,15
1484451606,The Product Agent: Hurry Up and Wait,0,0,0,0,2,2
1484458838,Coexistence,0,0,0,0,6,6
1484483431,Inside the Musician's Brain,0,0,1,0,22,23
1484484056,Multiclass Theater,0,0,0,0,8,8
1484493484,Playmaker's Corner,0,0,0,0,3,3
1484511465,Cautionary Tales,28,42,35,21,742,868
1484511466,Crazy Over Easy,1,0,0,0,49,50
1484522542,The Back Porch,4,0,0,0,7,11
1484539529,Uncovered by WDRB News,1,0,0,0,2,3
1484555736,Big Apple Buckets: A NY Knicks Basketball Podcast from New York Post Sports,1,0,1,1,15,18
1484564602,Just The Sip,3,0,0,2,45,50
1484569777,Dear Alice | Interior Design,3,4,5,6,182,200
1484576595,Home Team with Sophie Julia,7,0,1,0,32,40
1484579161,Urge to Kill,13,10,18,14,142,197
1484585807,The Bat Boys: A Valencia CF Podcast,0,0,0,0,5,5
1484590767,Lunch Club Podcast,2,0,1,3,43,49
1484599827,The MinnMax Show,1,0,1,2,46,50
1484648662,Sermon Spotlight,0,0,0,1,1,2
1484673743,Digital Marketing Daily,1,0,0,0,1,2
1484729660,Body by Being Podcast by JoaFitness,0,0,0,0,23,23
1484730839,Angler's Happy Hour,0,0,0,1,67,68
1484748807,True Consequences,0,1,3,0,59,63
1484760064,Get Started Investing,0,0,0,0,32,32
1484808020,Listen Now with Matt and Sam,0,0,0,0,7,7
1484824610,Susan Nethercote Studio Insider Art Podcast,0,0,0,0,4,4
1484832819,Live Your Life Kween Podcast,0,0,0,0,36,36
1484841339,Rebel Performance Radio,0,0,0,0,2,2
1484854721,Preds Insiders,0,0,0,0,1,1
1484862164,Politics War Room with James Carville & Al Hunt,6,5,6,14,199,230
1484870469,Relaxing Literature,0,0,0,0,2,2
1484872278,Columbia House Party,0,0,0,0,2,2
1484872409,xoNecole's Happy Hour,1,0,0,3,78,82
1484875120,The XC Podcast,0,0,0,0,2,2
1484889406,Ghost Stories: A Podcast By Hinge,4,6,3,8,43,64
1484895794,Ones Ready,0,0,0,0,50,50
1484912138,The Bill Bert Podcast,15,5,5,0,25,50
1484913342,The Spouse Angle,2,0,0,0,8,10
1484916483,Stupid Fat Hobbits,0,0,0,0,17,17
1484930949,Beyond The Bump,0,0,1,0,89,90
1484940574,The Official Manchester United Podcast,0,1,0,1,22,24
1484995035,La pelota al que sabe,0,0,0,0,1,1
1484996253,IS: Off the Page,0,0,0,0,2,2
1485013213,The Mighty Metahumans,0,0,0,1,21,22
1485020676,How’s My Hand Path?,0,0,0,0,13,13
1485021241,The Reason Interview With Nick Gillespie,1,0,1,2,23,27
1485021246,The Soho Forum Debates,0,0,0,2,7,9
1485026269,The Fed and Fearless Podcast,0,0,0,0,5,5
1485031839,Variant: The Podcast,1,1,3,0,20,25
1485052917,The Official Watchmen Podcast,6,1,4,1,67,79
1485056754,The Healthy Rebellion Radio,2,0,2,1,45,50
1485109198,Rubicon: The First Hundred Days of the Biden Presidency,12,2,4,9,35,62
1485109898,The Old Soul Movie Podcast,0,0,0,0,9,9
1485118950,This Week in Neuroscience,0,1,0,0,0,1
1485129718,Women and Crime,17,5,13,15,181,231
1485144537,FreightCasts,0,0,0,0,8,8
1485152841,Simple Homeschool,0,0,0,0,21,21
1485180302,Bow Down: Women in Art,0,0,0,0,6,6
1485180410,6 Minute Siddur Snippets,0,0,0,0,1,1
1485181083,The Ed Bassmaster Podcast,2,0,1,0,46,49
1485182097,Pink Milk,0,0,0,0,15,15
1485191629,Talking Mopars,1,1,0,0,16,18
1485212738,Georgie Romero Is Done For,0,0,0,0,10,10
1485231813,BatChat,0,0,0,0,1,1
1485245390,4biddenknowledge Podcast,1,0,0,0,6,7
1485253309,The HomeGirls,0,0,0,0,2,2
1485255815,THE AUTISM ADHD PODCAST,0,0,0,0,11,11
1485260474,Two Guys Garage Podcast,0,0,0,0,5,5
1485266884,Litocast,0,0,0,0,3,3
1485277290,Green Light with Chris Long,11,3,5,8,335,362
1485278388,After Midnight: Phish's Big Cypress Festival,0,0,1,0,28,29
1485280958,Locked On Islanders - Daily Podcast On The New York Islanders,0,0,0,0,4,4
1485281031,Feminist Survival Project 2020,0,0,0,0,29,29
1485286986,Irish Breakdown,9,1,1,4,18,33
1485292153,The Vet Tech Cafe's Podcast,0,0,0,0,3,3
1485306667,Dimension 20,0,0,0,0,27,27
1485321758,Titus & Tate,7,5,3,8,475,498
1485328933,Talkin' Nets,1,1,0,0,33,35
1485335620,People Pleaser with Austin Archer,0,0,1,0,17,18
1485345870,"Tomorrow, the Void",0,0,0,1,10,11
1485351658,Bannon's War Room,30,4,8,6,144,192
1485353499,Science and Saucery,2,1,1,2,19,25
1485420399,Be Your Best Horsemanship,0,0,0,0,50,50
1485423775,Ladies & Tangents,0,1,0,0,53,54
1485435369,Old Gods of Appalachia,0,1,0,2,47,50
1485443511,Broker-to-Broker,0,0,0,0,8,8
1485444526,Locked On Hurricanes - Daily Podcast On The Carolina Hurricanes,1,0,0,0,0,1
1485453761,Superman & Lois: The New Adventures,1,0,0,0,4,5
1485462182,Hollywood Remixed,0,0,0,0,1,1
1485466368,The Culture Project Podcast,0,0,0,0,13,13
1485472892,A Beautiful Mess Podcast,1,2,1,0,46,50
1485473251,Wannabe Minimalist Show,0,0,0,0,4,4
1485473929,Greatest Story Never Told,0,0,0,0,10,10
1485474473,Letters to a Dead Friend About Zen,1,0,0,0,3,4
1485484707,Beauty is a Bitch,0,0,0,0,1,1
1485484866,Chelsea Mike'd Up,3,1,5,4,248,261
1485504170,The Homestead Journey,0,0,0,1,10,11
1485521310,The Rugby Bricks Podcast,0,0,0,0,10,10
1485526416,Mother Flipping Awesome,0,0,1,2,35,38
1485527143,Good For You,14,8,7,8,13,50
1485542323,A Zero To A Hero: Learn Spanish!,1,0,3,0,13,17
1485561811,I AM BIO,0,0,0,0,3,3
1485563744,Business of Bouffe,0,0,0,0,3,3
1485567586,The White Witch Podcast,0,0,0,0,18,18
1485570562,Military Murder,7,2,0,3,292,304
1485591430,420 Day Fiance,3,2,2,3,263,273
1485593219,Mile High Hockey: for Colorado Avalanche fans,1,0,0,0,2,3
1485601442,Young and Corporate,11,1,1,1,36,50
1485610570,History Uncovered,2,3,0,0,0,5
1485620901,Recording Artists,0,0,0,0,10,10
1485623466,Rock And Roll Confessional,1,1,0,0,41,43
1485631189,Nightmare Tonight,0,0,0,0,2,2
1485636621,Detective Trapp,24,20,22,27,350,443
1485647662,Giants Brawl,0,0,0,1,9,10
1485656863,Journey through Classical Piano,0,0,0,0,11,11
1485692558,INTO THE ABISCUIT,0,0,0,1,43,44
1485736552,Backyard Time Machine,0,0,0,0,32,32
1485740243,Couple Things with Shawn and Andrew,1,2,2,7,488,500
1485750428,Highly Entertaining,0,0,0,0,3,3
1485752119,The Commander's Quarters,0,0,0,2,35,37
1485754530,"The Fit Farming Food Mom, Connie Nightingale",0,0,0,0,46,46
1485755350,"Alan Watts - Way Beyond the West - Modern Philosophy, Zen Buddhism & Eastern Philosophy Podcast",0,0,0,1,4,5
1485757121,The Crown: The Official Podcast,1,1,2,6,26,36
1485758255,Trace Material,0,0,0,0,8,8
1485759689,Cozy Cryptid,2,0,0,0,13,15
1485780520,The Landscape Photography Show,0,0,0,1,20,21
1485788729,Inside Frozen 2,15,3,9,18,102,147
1485798128,Sibling Revelry with Kate Hudson and Oliver Hudson,41,15,31,40,373,500
1485813110,On the Mic with Mike Peters,0,0,0,0,2,2
1485819528,Spooky Psychology,0,0,0,0,6,6
1485898177,GUNS Magazine Podcast,1,1,0,0,7,9
1485905502,The Late Kick with Josh Pate,6,2,1,3,488,500
1485908967,The Fitness Insider,0,0,1,0,18,19
1485916944,Bitcoin In Asia - Bitcoin Magazine,0,0,0,0,5,5
1485917438,Scry Me a River,0,0,0,0,3,3
1485919205,Let's Talk About Water,0,0,0,0,2,2
1485931128,Against The Stream,0,1,0,0,3,4
1485932439,The David J. Harris Jr Show,3,2,0,1,44,50
1485932663,Hollywood Unscripted,0,0,0,0,21,21
1485935561,Long Lost: An Investigative History Series,2,1,1,1,25,30
1485946726,Thinking in Japanese Podcast,0,0,0,0,2,2
1485950035,Agriculture Adapts by ClimateAi,0,0,0,0,5,5
1485957691,astro[sound]bites,0,0,0,0,1,1
1486034481,METALLIGEEK: Metallica Podcast w/ Andriy Vasylenko,0,0,0,0,13,13
1486045932,The Secret Life of Death Podcast,0,0,0,0,3,3
1486047364,Translating ADHD,0,0,1,1,28,30
1486059381,The FliteCast,0,0,0,0,5,5
1486084649,The Golf Gals,0,0,0,0,3,3
1486096305,The Nasty Galz,2,0,0,0,5,7
1486103594,Hair Metal Memories,0,0,1,0,2,3
1486118282,Cinephobe,1,0,0,0,49,50
1486122533,The Open Mic Podcast with Brett Allan,0,0,0,0,14,14
1486136868,FPL Family,0,0,0,0,1,1
1486179385,Across The Movieverse,0,0,0,0,17,17
1486210336,RP Strength Podcast,3,0,3,3,33,42
1486221160,Hodgetwins,13,2,0,0,179,194
1486229281,The Emily Show,2,0,0,0,44,46
1486230885,Parsha Perspectives,0,0,0,0,1,1
1486274118,Crypto Like A Boss - Adryenn Ashley & Heather Havenwood,0,0,1,0,0,1
1486274409,Linchpin Conversations,0,0,0,0,6,6
1486277800,The Scotchy Bourbon Boys,0,0,0,0,1,1
1486316399,It’s a Vet(Tech)’s Life,0,0,0,1,0,1
1486321854,"Ready, Set, Fetch!",0,0,0,0,3,3
1486375788,Vital Dawn,0,0,0,0,2,2
1486407238,The Morning Show Podcast,1,0,0,0,2,3
1486416236,I Hear You,0,0,0,0,15,15
1486420789,Four Million Years Later,0,0,0,0,4,4
1486434182,"Roots, Wings and Other Things",0,0,0,0,8,8
1486457725,In Culture,0,1,0,0,0,1
1486480336,The Dating After Divorce Survival Guide,0,0,1,0,13,14
1486488039,Limited Level-Ups,0,0,0,0,8,8
1486505917,Don't Miss This Study,2,3,2,5,159,171
1486555402,For All Mankind After Show Podcast,0,1,0,0,3,4
1486579283,Magnificat Ministry Podcast,0,0,0,0,1,1
1486583326,Battleline Podcast,1,0,0,0,48,49
1486595182,Faithful Conversations,0,0,0,0,4,4
1486617071,Reveal: The Revenue Intelligence Podcast,0,0,0,0,25,25
1486621740,Academia de Conspiraciones,2,0,0,1,0,3
1486632372,History of FMW,0,0,0,0,1,1
1486644293,Garbage Days,0,0,0,0,37,37
1486674663,Locker Room Access,0,0,0,0,18,18
1486680299,The Witcher Recap,0,0,0,1,2,3
1486845005,Jabba the Pod: A Podcast About Star Wars,0,1,6,12,223,242
1486873615,Nightdrive,0,0,0,0,12,12
1486881900,Y'all-itics,3,0,1,2,23,29
1486883874,Rates & Barrels: A show about baseball,4,2,3,2,53,64
1486896400,Major League Djz,3,0,4,6,17,30
1486961693,Peak Northwest,0,0,1,1,5,7
1486968407,Locked On White Sox - Daily Podcast On The Chicago White Sox,3,0,1,2,24,30
1486971197,Is This What You Want?,0,0,0,0,2,2
1486988298,EXFIL - An Escape From Tarkov Podcast,0,1,3,1,69,74
1487043575,Something Isn't Right Podcast,0,0,1,0,10,11
1487143525,Sustaining Keto with Maggie Sterling,1,0,2,0,47,50
1487173754,The Economist Morning Briefing,4,2,1,0,13,20
1487184733,Live Yes! with Arthritis,1,1,0,0,4,6
1487190391,Mid Mod Remodel,0,0,0,0,6,6
1487190537,WildFed Podcast — Hunt Fish Forage Food,1,0,0,0,134,135
1487204915,CBS This Morning - News on the Go,4,1,0,0,5,10
1487211928,Surveyor Says!  The NSPS Podcast,0,0,0,0,4,4
1487213874,Motherhacker,0,0,5,3,42,50
1487231767,FRAMES Photography Podcast,0,0,0,0,5,5
1487232558,High Stakes,0,0,0,0,5,5
1487247512,Messy Mom Magic,0,0,0,0,4,4
1487254316,BIG GAY SEX SHOW: THE DADDY YEARS,0,0,0,1,4,5
1487265198,The Heart & Hustle Podcast,0,0,0,1,49,50
1487283992,This Planet Needs a Name,0,0,0,0,9,9
1487288935,Depression and Anxiety in real life,0,0,0,1,7,8
1487325374,Blood Podcast,0,0,3,0,1,4
1487376119,KonKon's Cantina,0,0,0,0,18,18
1487396757,Life of the Record,0,0,0,0,3,3
1487397350,Push the Donut - A Journey Into Music Theory,0,0,0,1,0,1
1487402264,Dave Fox Home Remodeling Show,0,0,0,0,2,2
1487402394,Red Ball,193,68,33,24,182,500
1487406273,The Mindalorian,1,0,0,0,11,12
1487406662,The Program audio series,0,1,0,0,17,18
1487409958,Private Talk With Alexis Texas,2,0,2,1,8,13
1487489835,Star Wars Untold Stories,11,0,0,1,2,14
1487498120,"Raise Your Game Show with Alan Stein, Jr.",0,0,0,0,165,165
1487513861,Get Sleepy: Sleep meditation and stories,35,35,28,35,1008,1141
1487530250,First Contact with Laurie Segall,1,1,2,1,24,29
1487577580,Rock N Roll Bedtime Stories,1,2,0,0,1,4
1487579237,In Bed with Nick and Megan,34,26,18,11,200,289
1487583333,Speeding Bullitt: The Life and Films of Steve McQueen,0,0,0,0,2,2
1487653217,Apology,0,1,0,0,12,13
1487700976,The Complex Sports Podcast,4,1,0,1,46,52
1487701689,The Complex Sneakers Podcast,7,0,4,0,149,160
1487721184,Tawanda's Live Request,0,0,0,0,2,2
1487728168,The AD Aesthete,0,0,1,0,6,7
1487730212,The Catch and Kill Podcast with Ronan Farrow,13,5,6,11,457,492
1487789978,"Drink Beer, Think Beer With John Holl",0,0,0,1,23,24
1487806731,Kalami Q/A,0,0,0,0,1,1
1487820978,Dirty Rotten Church Kids,0,0,1,0,87,88
1487829595,Well There's Your Problem,3,2,1,1,37,44
1487830643,Butcher BBQ Podcast,0,0,0,0,5,5
1487836551,Behind The Screams,0,0,1,0,18,19
1487845680,The Office ASMR - A Podcast to Sleep To,1,1,1,1,46,50
1487854323,After The Buzzer,0,0,0,2,8,10
1487871456,The KC Morning Show,0,0,1,0,8,9
1487877826,I Think You're Dope w/ Eric Nam,0,0,0,0,50,50
1487883748,The Pentertainment Podcast,1,0,0,0,12,13
1487910037,Sorry Bout It,0,0,0,0,18,18
1487953334,Real Simple Tips,0,0,0,0,2,2
1487956745,Max & Ivan: Fugitives,0,0,0,1,12,13
1487968004,The Oddcast Ft. The Odd Man Out,0,0,0,0,5,5
1487980715,Solve,68,41,44,24,175,352
1487984174,Sweet Grace For Your Journey,0,0,0,0,23,23
1487987837,Making Polyamory Work,0,0,0,0,16,16
1488011300,Lamplighter Kids Stories,1,0,0,0,29,30
1488011459,Let's think Earth: Season 12; Season of the Brain,1,0,0,0,0,1
1488012745,Office Horror Stories: True Workplace Nightmares,6,1,4,0,39,50
1488015698,Living Lean,0,0,0,0,14,14
1488017341,Jeranism Podcast,1,1,1,1,3,7
1488020237,Beyond The Beauty with Bobbi Brown,2,1,2,2,8,15
1488035291,Bad Decisions,1,1,1,2,83,88
1488040861,Abide Bible Sleep Meditation,20,9,8,8,15,60
1488057147,National Day Calendar,0,0,0,0,1,1
1488059541,The Science Revolution with Thom Hartmann,0,0,0,0,2,2
1488085383,Star Signs: Go Stargazing!,0,0,0,0,4,4
1488114506,Real Estate 101 - The Investor's Podcast Network,0,0,1,1,26,28
1488128388,LeaderSwift Podcast,0,0,0,0,11,11
1488142262,Sleep Tight Relax - Helping busy minds become calm at bedtime,0,0,0,1,20,21
1488171922,Alienating the Audience,0,0,0,0,42,42
1488187257,A Musical Theatre Podcast,0,0,0,1,16,17
1488187430,Prince | Official Podcast,4,3,1,5,37,50
1488193650,Perilous Storytelling,0,0,0,0,11,11
1488201401,IELTS Speaking for Success,0,0,0,1,7,8
1488234254,The Pigeon Whole Motorcycle Podcast,0,0,0,1,15,16
1488251337,AeroNewsGermany,0,0,0,0,1,1
1488259550,Kids Meditation & Sleep Stories,3,1,3,6,37,50
1488269834,Career Quest with Sydney,0,0,0,0,7,7
1488275879,You Need Therapy,0,0,0,3,36,39
1488278291,The Instinctive Australian Shepherd,0,0,0,0,1,1
1488287205,Very Good Show,0,0,0,0,7,7
1488288341,How to be a Minimalist,0,0,0,1,22,23
1488292026,Nani Ki Kahaniya,1,2,1,1,10,15
1488292749,Princess Stories With Aneira,0,0,0,0,1,1
1488342885,The New Day: Feel the Power,3,1,5,5,486,500
1488347851,The Ticket Daily Dump,1,1,1,1,1,5
1488361243,The Don Cherry's Grapevine Podcast,3,0,0,1,62,66
1488385968,Real Life Weight Loss,0,0,1,0,49,50
1488385970,Behind The Irishman,1,2,1,0,17,21
1488390069,Joke Quest 200,0,0,0,0,4,4
1488391729,Cross Thread Off Road,0,0,0,0,6,6
1488393322,The TriDot Triathlon Podcast,0,0,0,0,50,50
1488397079,"The Best Movies, with Richard Roeper and Roe Conn",0,0,0,0,3,3
1488401177,The Phil Hay Show - A show about Leeds United,0,0,0,0,3,3
1488401364,Straight Outta Cobham - A show about Chelsea,0,0,0,0,8,8
1488401659,The Red Agenda - A show about Liverpool FC,0,0,1,0,4,5
1488401929,Gwlad Tidings - A show about Everton,0,0,0,1,1,2
1488402384,Coffee At New Jersey Audubon,0,0,0,0,15,15
1488414022,The Bookmarked Podcast,0,0,0,1,27,28
1488414403,Manage My Wedding Podcast,0,0,0,0,6,6
1488414960,Hot Take,4,3,2,0,66,75
1488416419,The Broadway Husbands Podcast,0,0,0,0,10,10
1488424047,"SYSTEMIZE YOUR LIFE | Work From Home Mom Tips, Task Management, Time Blocking, Business Systems, Hom...",0,0,1,0,48,49
1488426271,Optimal Living Advice,1,0,0,0,14,15
1488434209,Female Startup Club,0,0,0,0,55,55
1488463073,Black in the Garden,0,0,0,0,27,27
1488484167,"Hunt, Gather, Talk with Hank Shaw",0,0,0,1,13,14
1488488341,"The Chefs Without Restaurants Podcast – Stories and Advice From Personal Chefs, Food Truck Owners an...",0,0,0,0,22,22
1488490323,The Evolution of Torah: a history of rabbinic literature,0,0,0,0,7,7
1488499843,"Sleep Meditation Music - Relaxing Music for Sleep, Meditation & Relaxation",0,0,2,1,9,12
1488521447,The Ornstein & Chapman Podcast,1,1,0,0,5,7
1488521732,Handbrake Off - A show about Arsenal,1,0,1,2,9,13
1488521834,Pod On The Tyne - A show about Newcastle United,0,0,0,0,2,2
1488521882,The Avian Behavior Podcast,0,0,0,0,5,5
1488523269,Zonal Marking - A show about football tactics,0,0,0,1,7,8
1488523485,The View From The Lane - A show about Tottenham,2,1,0,0,8,11
1488526846,The Jann Arden Podcast,0,0,0,0,3,3
1488539768,The Rake,0,0,0,1,4,5
1488541353,Settle the Stars: The Science of Space Exploration,0,0,1,1,20,22
1488541542,RSL Soapbox: for Real Salt Lake fans,0,0,0,0,2,2
1488554600,Brave New Work,0,0,0,0,16,16
1488560381,Inside Tri Show,0,0,0,0,1,1
1488560647,Starting Greatness,1,0,0,1,48,50
1488603839,The TXG Podcast,0,0,0,1,8,9
1488627456,Locked On Stars - Daily Podcast On The Dallas Stars,2,0,0,0,19,21
1488632494,The KLN Podcast,2,0,0,1,39,42
1488654674,The Actual Stretch and Bobbito Show,0,0,0,0,5,5
1488656803,Today By The Way,0,0,0,0,50,50
1488662896,The Lost Art Of Conversation - A Pink Floyd Podcast,0,0,0,0,11,11
1488667608,Meal Prep Monday  Podcast™,0,0,0,0,7,7
1488676545,Gina Bianca Podcast,0,0,0,1,36,37
1488696878,"Gee Thanks, Just Bought It",4,1,3,2,40,50
1488704647,The Antigen,1,1,2,0,19,23
1488713797,The WinAtLife Podcast,0,0,0,0,1,1
1488735954,ThePrint,0,1,0,1,9,11
1488785147,News Cycle,1,0,2,0,4,7
1488815751,The All American Dream,0,0,0,0,6,6
1488820869,Best And The Other One,0,0,0,0,8,8
1488872714,Arena Craft Podcast,0,0,0,0,19,19
1488874171,UFO Chronicles Podcast,2,1,1,2,76,82
1488880049,The Boundaries.me Podcast,2,0,0,1,43,46
1488884489,Songs of Note,0,0,0,0,8,8
1488909340,Good Company,0,0,0,0,1,1
1488921888,Intertidal Talks,0,0,0,0,1,1
1488952626,Moon Rabbit,0,0,0,0,1,1
1488953625,Up In The Blue Seats: A NY Rangers Hockey Podcast from NY Post Sports,1,2,0,0,30,33
1488963583,The Stripe Show,1,0,0,0,6,7
1488975754,The Republican Nation,11,1,0,2,9,23
1488983270,MySwimPro Swimming Technique & Training Podcast,0,0,0,0,6,6
1488983480,The A.V. Club Presents Film Club,1,0,1,1,12,15
1489010496,The Call Sheet with Kris Tapley,0,0,0,0,5,5
1489046721,Panties In The Mouth,0,0,0,0,9,9
1489050218,The Panic Pod,0,0,0,0,9,9
1489061681,Straight Up with Trent Shelton,0,0,0,0,50,50
1489061831,Change Church Podcast,0,0,0,0,6,6
1489072939,The Kinky Pineapple,2,0,1,0,2,5
1489091001,Mismo with Mick Torres & Ashley Argota,0,0,0,0,4,4
1489093693,The Muckrake Political Podcast,4,0,1,2,43,50
1489096844,The Nick Woolley Podcast,0,0,0,0,1,1
1489102438,Dietitian Table Talks,0,0,0,0,15,15
1489109853,24/7 FLAT EARTH DISCORD LIVESTREAM,1,0,2,0,2,5
1489112221,"Jeffrey Epstein, The Prince and the Pervert Podcast",4,3,1,1,30,39
1489123526,Subscription Box Basics with Julie Ball,0,0,0,0,32,32
1489124156,Knot Zen,1,0,0,0,2,3
1489139625,Weeb Nation Podcast,1,0,0,0,35,36
1489154494,Movement Made Better Podcast,0,0,0,0,3,3
1489171190,Infinite Loops,0,0,0,0,10,10
1489189522,Art Affairs,0,0,0,0,5,5
1489199887,This Week At The Box Office,0,0,0,0,3,3
1489220651,F*** Hut Music School for Teens,1,1,0,1,18,21
1489222951,El Washington Post,0,1,0,2,15,18
1489261034,#HerStory,0,0,0,0,9,9
1489302085,The Dirt: the gardening podcast from Grow Your Own magazine,0,0,0,0,3,3
1489326460,Conversations With Coleman,4,1,3,5,79,92
1489335002,Swim Coach in Transit,0,0,0,0,1,1
1489349094,PopRoast,0,0,0,2,24,26
1489356239,Markets Daily Crypto Roundup,1,0,0,0,3,4
1489372037,The Frightmare Theatre Podcast,0,0,0,0,10,10
1489384729,Write in 10 Podcast,0,0,0,0,11,11
1489399975,FASTer Way Podcast,2,0,0,1,15,18
1489400127,CCERP Podcast,0,0,0,0,1,1
1489416686,Fashion Victims Podcast,0,0,0,0,22,22
1489428604,Artie Lange's Podcast Channel,5,0,1,3,41,50
1489428925,Brimstone Valley Mall,0,0,0,0,32,32
1489482036,CounterClock,38,31,34,22,375,500
1489494447,KoopCast,2,1,3,1,75,82
1489505439,Ask Dr. Drew,6,1,1,0,6,14
1489506534,Wellness While Walking,0,0,0,0,18,18
1489510869,Golf Better Podcast,0,0,1,0,10,11
1489519341,TechFirst with John Koetsier,0,0,0,0,7,7
1489534116,Popcorn Culture,3,0,6,2,248,259
1489535585,Locked On Predators - Daily Podcast On The Nashville Predators,1,1,1,0,18,21
1489547249,The Tao Te Ching for Everyday Living,0,0,0,0,7,7
1489552267,Paleo Bites,0,0,0,0,6,6
1489560182,Equine Bodytalks,0,0,0,0,1,1
1489565668,A Cyster & Her Mister: A PCOS Lifestyle Podcast,0,0,0,1,49,50
1489576059,The Carmudgeon Show,1,0,0,1,15,17
1489688908,Confessions of a Stenographer,0,0,0,0,5,5
1489696457,Parlez Away,1,0,0,2,12,15
1489705942,La bottega di Babbel,0,0,0,0,3,3
1489742667,Soul and Wit,2,1,1,2,44,50
1489777359,The Hospitality Podcast with Katherine Sasser,0,0,0,0,2,2
1489808026,Speaking Spanish for Beginners | Learn Spanish with Latin ELE,0,0,0,0,19,19
1489848748,"Meditation music. Peaceful calm music 528, 432 Hz",0,0,1,1,26,28
1489854551,Sex Therapy with Dr. Jones,0,0,0,1,48,49
1489859485,Anime Academy93,0,0,0,0,1,1
1489865274,The Backpacking Experience,0,0,0,0,28,28
1489865544,Feed Your Brain - Podcasts,0,0,0,0,1,1
1489878793,HERself,0,0,0,1,49,50
1489885811,Good Bottle,0,0,0,0,2,2
1489896528,The Devon Kershaw Show by FasterSkier,0,0,0,0,6,6
1489897256,Forensic Psychology,0,0,2,4,2,8
1489901196,Valley of the Nerds,0,0,0,0,7,7
1489932627,Superhumans At Work by Mindvalley,0,0,1,11,122,134
1489978285,The Wire - Fantasy Football Podcast,0,0,1,0,7,8
1489978876,Whiskey Lore,0,0,1,0,11,12
1489983696,A Certain Point of View: A Star Wars Podcast,0,0,0,0,9,9
1489986541,Tales with TR: A Hockey Podcast,1,0,0,0,1,2
1490007487,The Daily Dad,3,0,1,0,29,33
1490017510,The Only Podcast Left - Daybreak,0,0,0,0,8,8
1490024285,The Mom Break Podcast ©,0,0,0,0,18,18
1490026718,The Phone Booth,1,0,1,0,26,28
1490028421,The Best of 3 CoD Esports Podcast,2,0,0,0,67,69
1490032141,The Next Trip - An Aviation and Travel Podcast,0,0,0,0,13,13
1490042085,BRAND PARTY Podcast,0,0,0,0,10,10
1490054246,Feeding The Mouth That Bites You,0,0,0,0,23,23
1490056807,Creator Club | Social Media Marketing & Content Creation,0,0,0,0,38,38
1490058455,Dungeon Dads,0,0,0,0,21,21
1490059833,Trail-Cast,0,1,0,0,1,2
1490065235,Enjoy The Walk Golf Podcast,0,0,0,1,15,16
1490067714,Big Question,0,0,0,1,13,14
1490093968,Filthy F*****g Casuals,0,0,0,0,4,4
1490139404,Worldwide Engineering with Leon Abboud,0,0,0,0,2,2
1490148340,Marvel Squadcast,0,0,0,0,4,4
1490157017,Make It Shine? The Victorious Podcast,3,0,0,1,6,10
1490161547,Modern Electrician,1,0,0,0,9,10
1490167813,The Daily Podcast,0,0,1,1,4,6
1490240263,Magnify Your Miracles Podcast,0,0,0,0,9,9
1490275048,WoW Killer: A World of Warcraft Podcast,2,1,0,1,24,28
1490286333,Tailosive Tech Twitch,0,0,0,0,1,1
1490287845,Conduct Detrimental: THE Sports Law Podcast,0,0,0,0,13,13
1490305762,Boys Shooting Club,0,0,0,0,10,10
1490328984,The Daily Show Podcast Universe,13,1,0,4,32,50
1490332908,Social Media Influencer,1,0,0,0,49,50
1490354763,Rumble with Michael Moore,56,10,21,15,398,500
1490364659,The Maine Fly Fishing Podcast,0,0,0,0,8,8
1490373102,OBS Talk,0,0,0,0,50,50
1490461997,DialogueBox,0,0,0,0,16,16
1490487107,Tailosive EV,0,0,1,0,10,11
1490508777,Murder Mystery,1,1,0,1,0,3
1490592938,Getting High With Plants,0,0,0,0,1,1
1490599327,Astral Projection Podcast from AstralHQ,0,0,0,0,1,1
1490608857,Tomahawk Nation: for Florida State Seminoles fans,1,1,1,0,17,20
1490611029,WeCrochet Podcast,0,0,0,0,9,9
1490615866,Stu Does America,5,1,0,7,474,487
1490621476,"Food, We Need To Talk",4,1,2,1,42,50
1490628056,The Beautifully Enough Podcast - a Christian women devotional,0,0,0,0,40,40
1490637008,Schitt's and Giggles: A Schitt's Creek Podcast,1,2,0,0,3,6
1490654362,Valley Boys Podcast,1,0,0,0,12,13
1490656649,Don't Shit On The Bus,0,0,0,0,18,18
1490664572,The Long Island Volleyball Podcast,0,0,0,0,3,3
1490665560,The Dark Web Unmasked,1,0,2,0,15,18
1490671118,Garden Plots with Skeletor,0,0,0,0,8,8
1490676916,The LoudCasa Talks,5,0,3,4,7,19
1490688184,The Keyboard Chronicles,0,0,0,0,2,2
1490692599,The Pope's Point of View,0,0,0,0,8,8
1490693338,"Palace Intrigue: Meghan Markle, Harry and the rest of the Royal Family",3,2,1,3,4,13
1490696875,The Junior Classics,0,0,0,1,11,12
1490703799,Barks from the Bookshelf,0,1,0,0,2,3
1490718287,Kes & Juice Podcast,0,0,0,1,17,18
1490755368,Movie Mike's Movie Podcast,3,2,5,10,272,292
1490761249,The Roblox PodCast,21,3,2,0,11,37
1490768774,The Well Managed Hive's Podcast,0,0,1,0,1,2
1490769285,stampingonthebackporch,0,0,0,0,2,2
1490769536,No Balls: The Cricket Podcast,0,0,0,0,1,1
1490881800,"The Divorce and Beyond Podcast with Susan Guthrie, Esq.",0,0,0,0,16,16
1490896085,The Ranveer Show,0,0,0,2,32,34
1490899659,Elite Physique University,0,0,0,0,50,50
1490902086,Monster: DC Sniper,22,15,26,36,200,299
1490906255,Anime Uproar Audio (AnimeUproar),0,0,0,0,5,5
1490922665,You Can Heal Your Life®,11,12,10,5,62,100
1490924360,The Steam Room,14,0,4,4,172,194
1490931468,Mythgard's Exploring The Lord of the Rings,0,0,1,0,4,5
1490933138,American Glutton,0,0,1,1,48,50
1490936869,Tomahawk Take Podcast on the Atlanta Braves,1,0,1,0,1,3
1490937170,The Gerry Callahan Podcast,128,9,12,17,334,500
1490986413,"Ew, David: A Schitt’s Creek Giggle Fest",1,0,0,1,2,4
1490993194,Advisory Opinions,13,3,11,8,260,295
1491039436,Personal Genomics - A Podcast from the Center for Cancer Genomics,0,0,0,0,1,1
1491058546,G Talk Garden Podcast,0,0,0,0,1,1
1491064734,PUCKS IN DEEP,0,0,0,0,3,3
1491067099,Empathy Always Wins with Ally Salama,0,0,0,0,4,4
1491072760,Latter-day Ain'ts,0,0,0,0,1,1
1491088065,Meet Cute,5,2,4,2,23,36
1491093016,Giving With Impact,0,1,0,0,0,1
1491093967,Narativ Live with Zev Shalev,1,1,3,5,11,21
1491112396,McKinsey Talks Talent,0,0,0,0,1,1
1491112731,Payday With Rayray,0,0,0,0,100,100
1491145903,De Man en de Maan,0,0,0,0,3,3
1491172864,Your Broccoli Weekly,0,0,0,0,1,1
1491191290,Modern American Diplomacy,0,0,0,0,12,12
1491214324,The Way of the Runner - conversations on running with Adharanand Finn,0,0,0,0,2,2
1491215794,Success Habits of Super Achievers,0,0,0,0,26,26
1491218541,Locked On Blues - Daily Podcast On The St. Louis Blues,4,1,1,1,3,10
1491222938,"Dandelion, The Witcher and The Wardrobe",0,0,2,0,4,6
1491248459,"Coffee, Pods & Wods",0,0,0,0,3,3
1491290269,Servant After Show Podcast,1,1,1,1,3,7
1491320932,The Training Tails,0,0,0,0,1,1
1491335071,BotaniCal,0,0,0,0,1,1
1491349699,Fake Heiress,12,2,7,6,14,41
1491354878,Early Work with Rhys James,0,0,0,0,5,5
1491359985,Cardionerds: A Cardiology Podcast,1,0,0,0,23,24
1491361653,Latter-day Saint Women Podcast,0,0,0,0,44,44
1491376534,The Home Of Horror Podcast,0,0,1,0,3,4
1491377174,Everything is Fine,1,1,2,3,69,76
1491379323,The Disney+ Princess Podcast,0,0,0,0,4,4
1491416976,LA PLATICA,0,2,1,2,67,72
1491442825,Bleav in the Slapdick Podcast,3,1,1,1,38,44
1491459478,REALationships Podcast,0,0,1,1,48,50
1491541414,VALENCE,1,3,0,2,12,18
1491548632,Freak Flag Flying,2,1,0,1,18,22
1491553314,The Shine Online Podcast,0,0,0,0,20,20
1491559787,Critical Care Scenarios,0,0,0,0,13,13
1491570606,friends on FIRE,2,0,0,0,34,36
1491609231,Black Ramen Podcast,0,0,0,0,3,3
1491625501,Ceremonial Weigh-In,0,0,0,0,3,3
1491628026,The Pro-Pilot Playbook Podcast,0,1,0,0,1,2
1491665135,Down,2,1,1,4,9,17
1491681999,"Boobs, Blood & BadAsses",1,1,1,0,2,5
1491689772,Dugout Chatter Podcast Powered by Stick & Ball TV,0,0,0,0,38,38
1491701052,RNZ: The Aotearoa History Show,0,0,0,1,21,22
1491701122,The Running Grind,0,0,0,0,2,2
1491703409,On the Move,0,0,0,0,3,3
1491751989,Hada de Fresa,0,0,0,1,4,5
1491766512,Alix Turoff Nutrition Podcast,2,0,0,0,30,32
1491770221,Auto Amateur,0,0,0,0,3,3
1491784484,Locked On Royals - Daily Podcast On The Kansas City Royals,3,0,0,0,6,9
1491784773,Broncos Brawl,1,0,0,0,42,43
1491790492,Locked On A's - Daily Podcast On The Oakland Athletics,0,0,0,0,4,4
1491808073,Sunbeam,1,0,0,0,38,39
1491813710,Jewish Bedtime Stories,0,0,0,0,1,1
1491835654,WaxPackHero Sports Card Minute,0,0,0,0,41,41
1491849071,Josh Tolley Show,0,0,0,0,1,1
1491870001,All Things Latina Podcast,0,0,0,0,12,12
1491912657,Credit Repair Business Secrets,0,0,0,1,23,24
1491922331,Postcards From Midlife,0,0,1,0,5,6
1491929401,TBD: Technology By Design,0,0,0,0,3,3
1491952153,Two Lives with Olivier,1,0,0,0,9,10
1491958197,Draws N Fades,0,0,0,0,31,31
1491967818,Trot Talk,1,0,0,1,5,7
1491974060,PokeDads: A Pokemon TCG Podcast,0,0,0,0,31,31
1491975558,The Brain Architects,0,0,0,0,3,3
1491984287,Cadillac Jack - My Second Act,1,1,0,1,47,50
1491992805,ROOTLESS LIVING,0,0,0,0,9,9
1491996695,Saints Podcast,0,0,0,0,9,9
1491997778,The First Vision: A Joseph Smith Papers Podcast,11,1,3,3,56,74
1492004492,Totally 80s,0,1,0,0,5,6
1492008134,CreepsMcPasta Creepypasta Radio,0,0,2,3,45,50
1492022689,The Leadership Antidote Podcast,0,0,0,0,1,1
1492037987,Boys' Bible Study,0,0,0,0,20,20
1492098223,Tik Tok,1,0,0,3,5,9
1492124267,Must Love Food,0,0,0,0,1,1
1492124590,Naughty But Nice with Rob Shuter,4,1,1,2,86,94
1492134933,27 Club,18,10,15,5,239,287
1492135529,The Overland Journal Podcast,1,0,0,1,20,22
1492139540,Effective Compassion,0,0,2,0,35,37
1492147103,My Year in Mensa,9,9,9,10,180,217
1492154569,Erskine Radio,1,1,0,0,0,2
1492154837,Total Offroad Podcast,0,0,0,1,42,43
1492162356,Thrifters Villa,0,0,0,0,25,25
1492179907,The Gabby Reece Show,3,2,6,3,36,50
1492196720,Built To Go! A #Vanlife Podcast,0,0,0,1,6,7
1492217846,The Good Dirt,0,0,0,0,11,11
1492263939,"Nature calm music, sounds. Relaxation, background music",3,0,0,5,67,75
1492314881,The Punk Rock MBA,1,1,0,1,40,43
1492327668,The Pyllars Podcast with Dylan Bowman,0,0,0,1,46,47
1492330633,Ordinary Equality,6,0,1,0,43,50
1492358925,1023 Diesel Shop Talk,0,0,0,0,5,5
1492360046,Get a Grip with Max Homa & Shane Bacon,4,2,0,3,249,258
1492391341,"Play, Watch, Listen",5,2,1,3,39,50
1492397139,"Low Tide Boyz, a Swimrun Podcast",0,0,0,0,24,24
1492449580,Dog & Puppy Training | Savvy City Dog,0,0,0,0,7,7
1492482048,The Practice Brave Podcast,0,0,0,0,17,17
1492486688,The Book Show & Rough Note by RJ Ananthi,0,0,0,0,4,4
1492491368,Section Hiking the Appalachian Trail,0,0,0,0,2,2
1492492083,Shawn Ryan Show,1,0,0,2,493,496
1492494816,Jonathan Wier & Ayla Brown Podcast,0,0,1,0,8,9
1492516522,The Game Within The Game,0,0,0,0,1,1
1492527886,Secret Societies,21,20,10,7,30,88
1492533163,The Think Marketing Podcast,0,0,0,0,50,50
1492537855,The Double Shadow,0,0,0,1,0,1
1492584441,The Rebel Capitalist Show,2,2,1,0,23,28
1492587781,"MegAnne is NOT a parent, but...",0,0,0,0,28,28
1492596923,Verified Vibes,0,0,0,0,7,7
1492643431,Unlock the Sugar Shackles Podcast,1,1,0,1,27,30
1492645612,The Unfiltered Podcast: The Bachelor Recap Podcast,11,2,2,0,43,58
1492658244,Six Seasons & a Podcast,0,0,1,0,9,10
1492731320,EW On Set: Schitt's Creek,0,2,1,0,6,9
1492739918,Locked On Wild - Daily Podcast On The Minnesota Wild,0,0,0,0,1,1
1492741786,Fartmouth,0,0,0,0,5,5
1492747637,The Food Code,0,0,0,0,28,28
1492764286,Jungle Prince,10,3,6,7,116,142
1492766207,Surely You Can't Be Serious Podcast,0,0,0,0,19,19
1492787960,Affirmation to Manifestation Podcast,0,0,0,0,32,32
1492819721,Running Lean,0,2,0,0,18,20
1492833196,The Dimension Door Podcast,0,0,0,1,12,13
1492839781,Fascinating? - A Star Trek Podcast,1,0,0,0,9,10
1492841437,The 80/20 BASEBALL MASTERCLASS,0,0,0,0,4,4
1492887322,GroSeries: An MCAT Review Podcast,0,0,0,0,26,26
1492913202,Industry Seating,1,1,0,0,20,22
1492915075,Sex from A to Z,0,0,0,0,3,3
1492928827,Poetry Unbound,1,0,0,1,198,200
1492930430,In the life of a teenage mind,0,0,0,0,3,3
1492934826,Propulsion Swimming Podcast,0,0,0,0,1,1
1492938525,The Paper Outpost - The Joy of Junk Journals!,0,0,0,0,10,10
1492939927,KaisaFit // More Than My Body,0,0,0,0,37,37
1492946397,The InFluency Podcast,0,0,0,0,22,22
1492952876,Let's Gather Podcast,0,0,0,0,2,2
1492959223,Roam,0,0,0,0,3,3
1493002505,Be Well By Kelly,1,1,1,1,46,50
1493022831,The Spa Strong Podcast,0,0,0,0,61,61
1493031991,Dave Lee on Investing,0,1,0,0,4,5
1493035373,Dose Makes The Poison: The Toxcast,1,0,0,0,17,18
1493042189,The Analytics of Dynasty Podcast,0,0,0,0,2,2
1493055485,Wisdom of the Sages,0,2,0,4,170,176
1493066713,The Southern Cannibal Podcast: The Dinner Table,1,0,0,0,2,3
1493068453,The Quarterback Q&A Podcast,0,0,0,0,3,3
1493073432,Elvis The Ultimate Fan Channel,0,0,0,0,4,4
1493074491,Conversations About Art,0,0,0,0,5,5
1493076024,Dante Elephante Podcast,0,0,0,0,1,1
1493080459,Wake Up With Weslie,0,0,0,1,49,50
1493099649,Teaching to the TOP,0,0,2,1,47,50
1493101778,Junk Monk Podcast,0,0,0,0,8,8
1493114445,Reham Podcast with Reham Al-Rashidi,0,1,0,2,28,31
1493126737,Rum Ham and Wild Cards,0,0,0,0,9,9
1493130920,Down to Birth,0,0,0,0,50,50
1493131803,Carpool Critics - a movie podcast!,0,0,2,1,40,43
1493135794,Grada 305,0,0,0,0,2,2
1493137938,Enneagram and Marriage,1,1,3,0,22,27
1493141613,"It’s Not You, It’s Your Trauma - Trauma, PTSD, Abuse, Anxiety & Recovery - Joe Ryan",0,0,0,0,22,22
1493142877,Only One Shot Golf,0,0,0,0,6,6
1493144024,Bardown Beauties,0,0,0,0,15,15
1493148959,The Line with Ashley Wood,5,1,1,0,376,383
1493151811,Honest To Dog Podcast,0,0,0,0,4,4
1493193473,The Officer's Wife,8,3,14,21,107,153
1493193956,Bible Stories,0,0,0,0,1,1
1493206897,Truth and Basketball with George Karl,1,0,0,0,23,24
1493224666,The Homeschool Project Podcast,0,0,0,0,7,7
1493229344,The Dispatch Podcast,21,14,16,15,179,245
1493229910,Queen Of Your Castle,0,0,0,0,14,14
1493233448,SP Streamer Fantasy Baseball Podcast,0,0,0,0,57,57
1493234546,Party Card,0,0,0,0,1,1
1493237206,My Year With Dolly,0,1,0,1,41,43
1493239624,Chihuahua Love,0,0,0,0,1,1
1493240327,Grow Your Self,0,0,0,2,36,38
1493244859,The Hitchcock Minute Podcast,1,0,0,0,0,1
1493245196,The Senior Pet Podcast,0,0,0,0,5,5
1493247879,The Call of the Void,1,1,3,4,31,40
1493287286,"Wake Me Up: Morning mindfulness, meditation, and motivation",2,0,2,2,44,50
1493298222,The Curious Climber Podcast: Chatting with Hazel and Mina,0,0,0,0,8,8
1493309825,36 From the Vault,8,6,9,9,47,79
1493317751,Your Chakra Coach,0,0,0,0,8,8
1493323435,Honest AF Show,0,0,0,1,14,15
1493324091,Tilth Talk Radio,0,0,0,0,1,1
1493328264,Shadowless Podcast: A Pokemon Podcast,0,0,0,5,45,50
1493350559,Lifestyle Overland: Campfire Confessions,0,0,0,0,17,17
1493353296,Cellfie Life,0,0,0,0,9,9
1493353598,BIG FACTS with Big Bank & DJ Scream,0,0,1,0,22,23
1493360254,Like You: Mindfulness for Kids,1,0,0,0,22,23
1493360298,AnthroBiology Podcast,1,0,0,0,11,12
1493360574,Untold Italy travel podcast,1,0,0,0,18,19
1493367819,Money Meets Medicine,0,0,1,0,28,29
1493399176,Talking Heads - a Gardening Podcast,0,0,1,0,2,3
1493403458,And for Off the Block,0,0,0,0,1,1
1493412881,Daf Yomi for Women - Hadran,0,0,0,1,5,6
1493414021,One Hit Thunder,0,0,0,0,13,13
1493424449,The B List with Petshopboy,2,3,1,1,40,47
1493426275,Your Haunted Holiday,0,0,1,1,35,37
1493429798,Troubled,0,0,0,0,10,10
1493436225,We Are History,1,0,3,2,48,54
1493448606,Torat Imecha Nach Yomi,0,0,0,0,2,2
1493450409,The Baron of Botox,35,32,23,14,50,154
1493451207,Bold and Blunt,3,0,1,0,6,10
1493451695,Give Theory A Chance,0,0,0,0,1,1
1493453604,HISTORY This Week,34,7,14,14,146,215
1493504028,"Children's Stories with Grandma: for Bedtime, Quiet Time & Car Rides",2,0,1,1,2,6
1493519857,Rescue Swimmer Mindset Podcast,0,0,2,0,18,20
1493548498,"Betty Life: Behind the Scenes, stories and life lessons",0,0,0,0,1,1
1493558501,Chasing Cosby,6,4,14,12,192,228
1493565947,Complete Human,0,1,0,0,4,5
1493566203,The Chairish Podcast,1,0,0,0,28,29
1493567998,Walk Run Soar with Shawn & Dorina Gilmore Young,0,0,1,0,19,20
1493568231,The NPTE Podcast,0,0,0,0,6,6
1493574102,Coffee and Bible Time's Podcast,0,0,2,2,70,74
1493579571,What's The Juice,2,0,1,1,46,50
1493580150,Let's Talk Global Warming,0,0,0,0,1,1
1493583482,Toxic To Triumph With Matthew Phifer,0,0,0,2,4,6
1493584122,Swamp Stories,0,0,0,0,28,28
1493609456,The Blockchain Debate Podcast,0,0,0,0,2,2
1493613536,Fasting For Life,2,1,1,1,38,43
1493651992,The Cookie Jar Golf Podcast,0,0,0,0,3,3
1493664369,S****y Song of the Week,0,0,0,0,3,3
1493674828,Journal of Special Operations Medicine,0,0,0,0,3,3
1493677721,The LDN Radio Show About Low Dose Naltrexone,0,0,0,1,0,1
1493686250,What Things are What Things,0,0,0,0,5,5
1493692131,Calling Old Hollywood,1,0,0,0,3,4
1493710459,Bagels and Blessings,0,0,0,0,2,2
1493712227,The Quad with Chris Young,1,0,1,2,46,50
1493713982,The Well Told Tale,0,0,0,0,18,18
1493714315,Monte & The Pharaoh,0,0,0,0,1,1
1493717594,The Dr. Axe Show,0,2,0,2,46,50
1493722257,Dingers: A Chicago Cubs Podcast,0,0,0,0,3,3
1493725811,Perfectly Framed | A Fantasy Baseball Podcast,0,0,0,0,2,2
1493729937,The Steve Cortes Show Podcast,1,0,0,0,7,8
1493734164,Inside The Show,0,0,0,0,6,6
1493739261,Talking Talmud,0,0,1,1,7,9
1493745353,Neurology Exam Prep Podcast,0,0,0,1,5,6
1493756268,Big Hormone Enneagram,0,0,0,0,18,18
1493757042,Take One Daf Yomi,1,1,2,7,70,81
1493806566,Mindfulness For Beginners,0,0,0,0,9,9
1493809462,Trucking After Hours,0,0,0,0,1,1
1493819720,Simply Country,0,0,0,0,2,2
1493821328,Empowering Women in Real Estate - The Podcast with Karen Cooper,0,0,0,0,6,6
1493821967,Solidarity Works,0,0,0,0,3,3
1493830206,The Dan Proft Show Podcast,1,0,1,0,11,13
1493839799,RDN Good Roller Pod,0,0,0,0,3,3
1493839846,The Outsider,0,0,3,3,32,38
1493842150,The EveryCalorieCounts Podcast,0,0,0,0,18,18
1493858530,The hood politics with prop's Podcast,1,0,1,0,22,24
1493869819,The S****y Movie Podcast,0,0,0,0,3,3
1493870581,ADVICE FROM AN ARCHITECT,0,0,0,1,18,19
1493882225,The Run Ohana Podcast,0,0,0,0,9,9
1493899905,Pnwild Podcast,0,1,0,1,118,120
1493900500,The Mile You're In,0,0,0,0,31,31
1493902736,Be Better Bettors,0,0,0,0,12,12
1493903684,Positively Positive Podcast,0,0,0,0,8,8
1493904813,Justin Takes The Bach - A Bachelor Recap Podcast,0,0,0,0,17,17
1493905087,The Juice Boxx Podcast,0,0,0,0,4,4
1493908510,4's Up Podcast,0,1,0,0,18,19
1493967587,The Community Rewatch Podcast,0,0,0,2,8,10
1493970390,Hardball Podcast,0,0,0,1,103,104
1493979993,Latina Hotwife Adventures: An Ethical Non-Monogamy Podcast,1,0,0,0,7,8
1493983358,Movies I Love That No One Talks About,0,0,0,0,20,20
1493986824,The DOPE Muslim Woman Podcast,0,0,0,0,3,3
1493998164,BYLATINMEN The Podcast,4,1,1,2,42,50
1494010558,Two Bees in a Podcast,0,1,0,0,12,13
1494022247,Smart Tech Today (Video),1,0,2,0,4,7
1494037881,Checks and Balance,4,1,1,2,42,50
1494040772,Peace of Chaos: a podcast by Matt Neal,0,0,0,0,3,3
1494041647,Turning to The Mystics with James Finley,0,2,1,1,93,97
1494046884,Dictators,32,9,11,11,61,124
1494061398,Nice Shot Pods,1,0,0,0,14,15
1494062667,Straight Outta Footwork,0,0,0,0,2,2
1494066468,Blue Angel Phantoms,0,0,0,0,1,1
1494071081,Midst,0,0,0,0,45,45
1494078847,The Triple R,0,0,0,0,20,20
1494079836,Tea Time UNFILTERED With Lovelyti,0,1,1,1,185,188
1494083770,THE EXPERTS podcast,5,1,0,0,38,44
1494087420,The Schitt's Creek After Show Podcast,0,0,0,0,2,2
1494092727,Life Insurance Academy Podcast,1,0,0,0,15,16
1494161095,Grain Markets and Other Stuff,0,0,0,0,34,34
1494165748,Zima Red,0,0,0,0,1,1
1494165763,More Than Enough,0,0,0,0,8,8
1494167648,Fuorisoglia,0,0,0,0,2,2
1494180954,Making Speed Podcast,0,0,0,0,1,1
1494200876,Guided By A New Podcast,0,0,0,0,3,3
1494208720,The Grawlix Saves The World,0,0,0,0,39,39
1494215228,A 3-Bean Salad,0,0,0,0,1,1
1494229453,Blood Time,0,0,0,0,6,6
1494233187,Impact the World with Lee Harris,0,0,0,2,105,107
1494235724,Dirt Talk by BuildWitt,0,0,0,0,50,50
1494236156,Minnesota Wild Hockey PONDcast,0,0,1,0,1,2
1494236218,The Jacked Up Review Show Podcast,0,0,0,1,0,1
1494237083,Strictly Stalking,72,51,79,48,179,429
1494239542,Fancy Plans & Things Radio,0,0,0,0,7,7
1494245262,The Brandon McMillan Podcast,2,2,2,0,32,38
1494246435,SVPod,5,2,1,0,149,157
1494262016,Kingslingers | A Dark Tower Podcast,0,0,0,0,77,77
1494278350,Dear Jessamyn,0,1,0,0,8,9
1494284839,Simple Farmhouse Life,0,0,0,0,50,50
1494315224,Pillow Talk with Emma Austin,0,1,1,0,3,5
1494336314,Rivals: Music's Greatest Feuds,8,10,4,9,75,106
1494336803,Sober As A Mother,2,1,0,0,6,9
1494344357,Bigger Ten,6,1,1,0,12,20
1494350511,Unlocking Us with Brené Brown,147,42,14,56,1015,1274
1494354554,"Next Level Leaders with Dr. Joseph Walker, III",0,0,0,0,15,15
1494356845,Certified Personal Trainer Podcast,0,0,0,0,1,1
1494356847,Odadaki Fil,0,0,0,0,1,1
1494372037,That's So Hindu,0,0,0,1,0,1
1494375133,Sunstorm with Alicia Garza & Ai-jen Poo,0,0,0,0,31,31
1494388156,Talk to the Internet,0,1,0,2,17,20
1494403834,Permaculture for the Future,0,0,0,0,8,8
1494413767,FearShop.com Horror Podcast,0,0,0,0,7,7
1494440867,In Focus by The Hindu,0,1,2,1,4,8
1494452606,Strong Sense of Place,1,0,1,0,90,92
1494476041,Slime & EXTRAordinary Jobs with Nichole Jacklyne,2,1,0,1,19,23
1494485257,Factual America,0,0,0,0,1,1
1494490229,PPG Grandpa’s Paramotor Podcast,0,0,0,0,3,3
1494500912,The Students' Podcast,0,0,0,1,4,5
1494504009,Girl Flower Podcast,0,0,0,0,2,2
1494505422,TOTs,0,0,0,0,2,2
1494513478,Throwing Fits,2,0,3,0,195,200
1494518220,Esther Club with Esther Povitsky,2,1,0,2,45,50
1494522894,The Medicin,0,0,0,0,45,45
1494523713,Black Goddess Healing and Manifestation,0,0,0,0,7,7
1494530079,Ain't Slayed Nobody | Call of Cthulhu Podcast,0,0,0,0,50,50
1494534953,"Newcomers: The Lord of the Rings, with Lauren Lapkus and Nicole Byer",15,9,10,10,456,500
1494539046,Dead Eyes,5,3,5,2,137,152
1494543360,Naturally Thin for Life,0,0,0,0,26,26
1494549885,Thinking Nutrition,0,0,0,0,5,5
1494555036,Dear Young Married Couple,1,0,0,0,111,112
1494556568,Draft Champions Podcast,0,2,0,2,10,14
1494564673,Rupert Spira Podcast,1,0,0,0,2,3
1494577260,Call Me Candid,8,5,8,10,119,150
1494578952,The Amazing Maine Podcast,0,0,0,0,12,12
1494591375,Powerful Motivational Speech,0,0,0,0,1,1
1494608415,Off The Gram,1,0,0,1,27,29
1494613500,Water Women,0,0,0,0,1,1
1494635006,Risky or Not?,0,0,0,1,4,5
1494638625,Zero Gapped,0,0,0,1,6,7
1494641162,The Rig Biz Podcast,0,0,0,0,2,2
1494643478,Big Conversations with Haley Hoffman Smith,0,0,0,0,50,50
1494702955,The Naked Truth With K&J,0,0,0,0,1,1
1494711931,ShopNotes Podcast,2,1,3,1,11,18
1494718324,Cockpits & Cocktails,0,0,0,0,1,1
1494719756,Locked On Nationals - Daily Podcast On The Washington Nationals,1,1,1,0,16,19
1494722390,Give Them Lala ... with Randall,79,24,22,33,342,500
1494729163,Surviving Sister Wives,1,2,3,7,184,197
1494734206,Love Letters to Kellie... The Podcast,3,1,0,1,41,46
1494760143,Movie Geeks United,0,0,0,0,1,1
1494762850,What You Should Know about Cockatiels,0,0,0,0,1,1
1494763610,Real Coffee with Scott Adams,4,1,1,1,13,20
1494764707,Review Revue,1,0,2,3,44,50
1494774552,Deadly Misadventures,6,7,9,7,95,124
1494774849,Kids Money and More,0,0,0,0,1,1
1494778818,The Run Smarter Podcast,0,0,0,0,21,21
1494781373,WeCrashed: The Rise and Fall of WeWork,36,43,44,20,57,200
1494789051,Locked On Red Wings - Daily Podcast On The Detroit Red Wings,1,0,0,0,12,13
1494790308,Partners,0,0,0,1,31,32
1494796677,Out of Left Field,0,0,0,1,19,20
1494799053,TrainRight Podcast,1,0,1,1,1,4
1494804719,Triple Knot,0,0,0,0,4,4
1494806427,On The Land,0,0,0,0,1,1
1494826152,I've Got A Theory,0,0,0,0,3,3
1494869058,"Porn, Betrayal, Sex and the Experts — PBSE",1,0,0,0,3,4
1494880178,Coffee Break Swedish,0,0,0,0,6,6
1494927467,Forum,0,0,0,0,1,1
1494931261,Real Legitimate Anthology,0,0,0,0,1,1
1494939777,Start The World,1,0,0,1,5,7
1494940088,"Moms Moving On: Navigating Divorce, Single Motherhood & Co-Parenting.",0,0,0,0,28,28
1494944697,"Social Workers, Rise!",0,0,0,0,7,7
1494952242,A Dog's Life with Anna Webb,0,0,0,0,1,1
1494954271,The Wrestling Inc. Daily,7,2,5,0,42,56
1494958256,Otaku Melancholy,0,0,0,0,4,4
1494969423,The Feedfeed,0,0,0,0,50,50
1494978011,Cuda Confidential,0,0,0,0,1,1
1494980365,Afrobeats Dancehall & Hip Hop Mixes,0,0,0,0,1,1
1494993149,The Naked Truth With Claire Jefford,0,0,0,0,7,7
1494999802,Off The Road Again,0,0,0,0,3,3
1495047937,The Backpacking Podcast,0,2,1,0,15,18
1495053060,Honest Money,0,0,0,0,6,6
1495058489,The Naked Leadership Podcast,0,0,0,0,3,3
1495067186,The Joy of x,0,0,0,0,2,2
1495069292,Mama Docs POWR podcast,0,0,0,0,3,3
1495071055,The Esthetician Club,0,0,0,0,1,1
1495072403,Talk of the Devils - A show about Manchester United,0,1,0,0,5,6
1495072830,The Molineux View - A show about Wolves,0,0,0,0,6,6
1495073829,Steilcast - A show about the Bundesliga & German football,0,1,0,1,3,5
1495074090,Why Always Us? - A show about Manchester City,1,0,0,0,5,6
1495074613,Torque Factor,0,0,0,0,1,1
1495077779,Football Cliches - A show about the language of football,0,0,1,0,3,4
1495081742,Casual Magic with Shivam Bhatt,0,0,0,0,4,4
1495087840,Everybody is Awful (Except You) with Jim Florentine,11,0,0,1,38,50
1495088754,The Green Horizon,0,0,0,0,5,5
1495100075,The Convergence - An Army Mad Scientist Podcast,0,0,0,0,2,2
1495103557,Armchair Explorer,0,0,0,0,9,9
1495103898,DNVR Rugby Podcast,0,0,0,0,1,1
1495113118,Claima Stories with Bimma,0,0,0,0,36,36
1495116600,Too Busy to Flush,0,0,0,0,7,7
1495123102,The Hockey Betting Podcast,0,0,0,1,11,12
1495124318,Talking Hockey,0,0,0,0,6,6
1495128359,Mary's Cup of Tea Podcast: the Self-Love Podcast for Women,0,0,0,0,50,50
1495193639,The Lab Report,0,0,0,0,28,28
1495210734,Verity by Phylicia Masonheimer,1,1,0,0,50,52
1495247140,The Rugby Player,0,0,0,0,3,3
1495247798,Wish I'd Known Then . . . For Writers,0,0,0,0,18,18
1495250344,Dear Bob and Sue: A National Parks Podcast,1,0,0,4,246,251
1495251160,John Solomon Reports,11,1,7,8,226,253
1495256257,Take Command: A Dale Carnegie Podcast,0,0,0,0,6,6
1495268229,The Water Cooler with David Brody,2,0,0,1,16,19
1495281764,Cars with Cocktails,0,0,0,0,5,5
1495282644,Locker Room Talk,0,0,0,0,1,1
1495324190,The Supermassive Podcast,2,0,0,1,1,4
1495392900,Dying For Sex,12,2,1,4,481,500
1495396329,More Than One Thing with Athena Calderone,1,0,3,3,39,46
1495401238,Rebel Eaters Club,3,3,1,1,42,50
1495411614,Cutthroat Inc.,10,5,8,10,52,85
1495427631,Strides Forward: Stories of Women Marathon and Ultramarathon Runners,0,0,0,0,5,5
1495463421,The Running Public,0,0,1,1,220,222
1495478113,Automotive Diagnostic Podcast,0,0,0,0,6,6
1495535622,Unshaming,8,3,3,6,35,55
1495540957,2 Wheeled Rider Podcast,0,0,0,0,4,4
1495558165,Off Course Agility,0,0,0,0,2,2
1495563595,Lore OlymPOD,0,0,0,0,50,50
1495573107,The Venus Cuckoldress Podcast,4,0,0,0,10,14
1495592193,Insight Myanmar,0,2,0,0,1,3
1495592803,The North Lot Podcast,0,0,0,0,1,1
1495593341,Notizie a colazione,0,0,0,0,1,1
1495593924,The Reclaimers,1,0,0,0,12,13
1495595715,Devil's Advocate with Rosebud Baker,1,0,0,2,47,50
1495601614,Verdict with Ted Cruz,140,2,2,2,52,198
1495601643,Salmon Trout Steelheader Podcast,1,0,0,0,6,7
1495602444,The Sota Pod,1,0,0,0,9,10
1495603417,Fnaf talk,0,0,1,2,6,9
1495604041,No Dogs in Space,5,3,2,8,175,193
1495604053,70mm,0,1,0,0,36,37
1495608381,The Dropshot - A Call of Duty Podcast,1,1,1,1,46,50
1495609355,Complicated-ish,0,0,0,1,9,10
1495610258,Fun Fables: Bedtime Stories for Kids,1,0,1,0,4,6
1495636313,Folxlore,0,0,0,0,4,4
1495658178,Big Boy Brunch,0,0,0,0,3,3
1495675229,Practice of the Practice: Faith in Practice Podcast,0,0,0,0,76,76
1495681837,"SeaBros Fishing Podcast - Fishing Stories, Tactics, and Interviews from Top Captains, Mates, and Out...",0,0,0,0,21,21
1495692137,Zen Mind,0,0,0,0,5,5
1495694478,Bogey Free,0,0,0,0,1,1
1495710329,You Are Not Broken,0,0,0,0,28,28
1495714614,MeatRx,0,0,0,0,9,9
1495721988,"Activist, You!",0,0,0,0,5,5
1495723246,Little Cabin Knits,0,0,0,0,3,3
1495731756,Locked On Marlins - Daily Podcast On The Miami Marlins,0,0,0,0,30,30
1495733618,FAR AIM | Aviation Regs | Aeronautical Info,0,1,1,0,25,27
1495736205,So All Over The Place Podcast,0,0,0,0,6,6
1495744609,FROM THE NOSEBLEEDS,0,0,0,0,1,1
1495746521,Raising Marriage Podcast,0,0,0,0,9,9
1495750942,Can I Steal You For a Second?,1,0,0,1,7,9
1495754025,The Passive Income MD Podcast,2,0,0,0,11,13
1495820520,The Empowered Wife Podcast,1,1,0,3,45,50
1495889648,Constructional Approach to Animal Welfare and Training,0,0,0,1,2,3
1495927836,"Real Talk For Teens and Young Adults- School, Life, and Relationship Success Strategies For Tweens, ...",0,0,0,0,40,40
1495930854,"Love After Lockup, mmkay",7,3,2,0,7,19
1495941921,Stories with Sapphire,3,1,0,2,92,98
1495970676,Fisherman's Post Fishing Podcast,0,0,0,0,3,3
1496019465,LuAnna: The Podcast,38,2,2,2,50,94
1496033049,Smart Money Mamas Show,0,0,1,0,53,54
1496034764,Let’s Get Vulnerable: Relationship and Dating Advice,0,0,1,0,49,50
1496053918,Stream(H)er,0,0,0,0,120,120
1496056966,Blue Collar Boardroom,0,0,0,0,1,1
1496075248,The NonProphet Podcast,0,0,2,0,7,9
1496156524,Biz Buds,0,0,0,0,37,37
1496169121,The Ask Coach Parry Podcast,0,0,0,0,2,2
1496175941,Raising Fame: Sports Edition,0,0,0,2,45,47
1496181176,Flyers Daily with Jason Myrtetus,0,1,0,5,79,85
1496196120,Sunday Red,0,0,0,0,2,2
1496206148,The Politics of Everything,1,0,0,0,8,9
1496216315,Vegas Revealed,0,0,0,0,12,12
1496233996,Find Your Voice: How to Write When You're Not a Writer,0,0,0,0,50,50
1496265971,Bad Friends,4,0,0,2,44,50
1496288925,The Portrait System Podcast,0,0,0,0,66,66
1496346061,The Modern House Podcast,0,0,0,0,7,7
1496358083,Dynasty Builders | Dynasty Fantasy Football,0,0,1,0,12,13
1496361637,Conspiracy Theories,1,0,1,1,0,3
1496403046,Tuesday Club,0,0,0,2,36,38
1496410518,Sonic Renegades: Exploring Revolutionary Guitar Effects Pedals,0,0,0,0,3,3
1496412542,Not Another Politics Podcast,2,3,0,0,23,28
1496419297,The Pat Thurston Show Podcast,0,0,0,0,2,2
1496421339,The Jeanne Oliver Podcast,0,0,0,0,26,26
1496425948,The Mushroom Hour Podcast,1,0,0,1,20,22
1496428378,The Afterburn Podcast,0,0,0,1,49,50
1496435948,Getting Ethics to Work,1,0,0,0,1,2
1496440479,Mastermind Discussions Podcast,1,0,0,2,29,32
1496447474,One Take Podcast,0,0,0,0,12,12
1496453125,Illini Basketball Podcast,0,0,0,0,1,1
1496458820,ART + MAGIC,0,0,0,0,16,16
1496461804,The US Foxes Podcast- Leicester City from an American perspective,0,0,0,0,4,4
1496462745,Hablemos Ecommerce,0,0,0,0,33,33
1496510095,The Funny Don't Stop Show,0,0,0,0,1,1
1496526751,Candela: Photography & Cinematography Masters,0,1,0,0,10,11
1496529829,Get Out N Drive Podcast,0,0,0,0,6,6
1496534463,Essential Korean,0,0,0,1,2,3
1496540964,Ruck It!,0,0,0,0,1,1
1496557812,BEHIND THE VELVET ROPE,20,10,16,15,438,499
1496560528,Sexier Than A Squirrel: Dog Training That Gets Real Life Results,5,2,7,1,23,38
1496560856,Ladies Who Law School,1,0,0,0,61,62
1496578780,YUTORAH: R' Aryeh Lebowitz -- Recent Shiurim,0,0,0,0,2,2
1496582195,"YUTORAH: R' Aryeh Lebowitz, Daf Yomi -- Recent Shiurim",0,0,0,0,1,1
1496623191,Coast to Coast AM Back in Time,0,0,0,0,7,7
1496657352,The Athletic Fantasy Baseball Podcast,2,1,2,1,33,39
1496682176,Getting Schooled Podcast,3,1,0,0,12,16
1496688913,Modern Day Sniper Podcast,0,0,0,0,13,13
1496689557,Brooklyn Nine-Nine: The Podcast,0,0,1,2,51,54
1496691282,The Rustage Anime Cast,0,0,0,0,14,14
1496709658,Weight Watchers Dad,0,0,0,0,1,1
1496713373,Amy Tenney Yoga + Meditation,0,0,0,0,16,16
1496726066,Final Take,0,0,0,0,7,7
1496798166,The Way Of Will John,0,0,0,0,8,8
1496811695,To The Point - Homes Services Podcast,0,0,0,0,39,39
1496841325,A Skeptic's Path to Enlightenment,0,0,0,0,10,10
1496845323,Twisted History,5,1,1,2,41,50
1496847791,New Scientist Weekly,0,0,2,0,3,5
1496854105,The Montessori Notebook podcast :: a Montessori parenting podcast with Simone Davies,0,0,0,0,16,16
1496859784,Pot Psychology,3,1,0,1,45,50
1496866360,"Estate of Mind, The Art of Selling Luxury Real Estate",0,0,0,0,4,4
1496873135,The Field,4,0,0,1,9,14
1496875926,Declassified College Podcast | College Advice That Isn't Boring,0,0,1,0,46,47
1496882479,Suffer Strong Podcast,0,0,0,0,27,27
1496888420,The Rustoration Podcast,0,0,0,0,4,4
1496891390,The One Piece Virgin,2,3,2,3,40,50
1496912371,Hardpoints,0,0,0,0,7,7
1496969081,Breakfast Balls Podcast,0,0,0,0,18,18
1496982159,Fantasy Baseball in 15,2,1,1,1,17,22
1496987228,Playing A Round With Paige Renee,11,2,6,10,471,500
1497003050,Checking In,1,0,0,1,12,14
1497013901,Coronavirus 4 1 1  podcast,2,2,2,2,19,27
1497024925,Arizona State Parks and Trails Podcast,0,0,0,0,1,1
1497037638,Genome Insider,0,0,0,0,1,1
1497049553,BACK TO YOUR STORY,1,0,0,0,30,31
1497064603,Pre-K Teacher Family,0,0,0,0,15,15
1497065108,The Horticulturati,0,0,0,0,4,4
1497071730,The Tour Breakaway: Cycling Podcast,0,0,0,0,4,4
1497082818,The Nugget Climbing Podcast,0,0,0,1,28,29
1497120132,Goforth & Golf,0,0,0,0,5,5
1497155419,Blind Shots Podcast,0,0,0,0,4,4
1497165479,A People's History of Kansas City,0,0,0,0,8,8
1497168845,Mill House Podcast,1,0,0,0,63,64
1497168868,Stoopkid Stories,3,0,0,2,45,50
1497186736,The WIGO Show: Sex-Talk and Sex Stories,0,0,1,0,5,6
1497189493,The Arbour Affect,1,0,0,1,5,7
1497304097,from Architecture to PROFITecture,0,0,0,0,3,3
1497316466,Smart Family Podcast,0,0,0,0,3,3
1497327828,From Phenom To The Farm,0,0,0,2,16,18
1497329104,LSHTM Viral,0,0,0,0,1,1
1497331086,How to Save the Planet,0,0,0,0,1,1
1497341007,SLP Coffee Talk,0,0,0,0,30,30
1497341367,The Antique Shop,0,0,0,0,40,40
1497348541,This is 40!,0,0,0,0,4,4
1497352566,The Babesment,0,0,0,0,34,34
1497357144,Become an Askable Parent with AMAZE,0,0,0,0,5,5
1497358211,The Cabin,3,0,0,0,70,73
1497367623,Joe List's Mindful Metal Jacket,1,2,0,0,47,50
1497368408,Hot Takes on a Plate,0,0,0,0,10,10
1497374383,Dating While Gray,1,1,3,2,33,40
1497379527,Verified,8,4,16,16,116,160
1497383342,Flyers Talk: A Philadelphia Flyers Podcast,4,2,0,1,7,14
1497388342,Serious Privacy,0,1,0,0,1,2
1497393071,FOR LIFE: The Podcast,0,0,0,1,34,35
1497397097,Horror Movie Maniacs,0,0,0,0,5,5
1497408907,Abraham Hicks,1,0,2,0,13,16
1497427321,Whiskey&Watches,0,0,1,1,4,6
1497432480,Hound Howl,0,0,0,0,4,4
1497438573,The Self Esteem and Confidence Mindset,0,0,0,0,1,1
1497438904,Jeep Life Podcast,0,0,0,0,27,27
1497440322,The Upper Hand: Chuck & Chris Talk Hand Surgery,0,0,0,1,28,29
1497440358,Seven Minute Torah,0,0,0,0,1,1
1497441201,Simple Stories in Spanish,0,2,0,1,12,15
1497442605,Disturbed: True Horror Stories,3,5,2,2,23,35
1497445845,Infectious Groove Podcast,0,0,0,1,32,33
1497447079,The Aviation RC Noob,0,0,0,0,3,3
1497462339,ULSUM RADIO,0,0,2,1,10,13
1497465347,Selling on Amazon with Andy Isom,0,0,0,0,47,47
1497476858,Believer: A Paranormal Mystery,0,0,3,1,19,23
1497478186,Killer Boobies Podcast,0,0,0,0,23,23
1497486348,Fray Foto,0,0,0,0,1,1
1497488754,Dirty Diversity,0,0,0,0,7,7
1497540130,Once BITten!,0,0,0,0,9,9
1497559830,Discovery Park,2,0,0,1,5,8
1497563317,Audible Chess,0,0,0,1,3,4
1497573270,Anthems,0,0,0,0,16,16
1497576248,Always Evolving with Coach Mike Bayer,0,1,1,1,47,50
1497578518,The Revealer,1,0,0,0,2,3
1497580401,Lira Clinical Podcast - A SkinDepth Convo,0,0,0,1,2,3
1497580407,How's Work? with Esther Perel,0,0,0,0,19,19
1497585978,NALC’s Postal Record Audiobook,0,0,0,0,2,2
1497590259,The Insurgents,4,0,1,1,44,50
1497594200,"What If, discussed.",0,0,0,0,9,9
1497602556,Fish and Game Changers,0,0,0,0,7,7
1497611931,Locked On Padres - Daily Podcast On The San Diego Padres,8,1,2,0,6,17
1497622475,Life Handmade by Scrapbook.com,0,0,0,0,50,50
1497630439,Shallow Graves,1,2,1,1,51,56
1497638454,Straight Up Sabres,0,0,0,0,1,1
1497645647,The Pinball Network,1,1,3,4,23,32
1497646343,The Hospice Chaplaincy Show with Saul Ebema,0,0,0,0,3,3
1497658361,This Is Awkward,2,0,1,1,20,24
1497680408,Creative Boom,0,0,0,0,11,11
1497683000,Islanders Never Say Die Podcast,0,0,1,2,1,4
1497698127,On The Chain - Blockchain and Cryptocurrency News + Opinion,0,0,0,0,2,2
1497703143,The Matt Bernier Show,0,0,0,0,3,3
1497740360,Less Is Morgue,0,2,0,0,28,30
1497762464,MusicalSplaining,6,4,2,4,58,74
1497778162,Dreams of Black Wall Street,0,0,1,2,25,28
1497784747,Classic Children's Story Podcast,0,0,0,0,4,4
1497785843,04-May,7,0,3,3,37,50
1497787253,Ferrall on the Bench,2,1,0,0,13,16
1497787709,Finding Your Village,0,0,0,0,32,32
1497791107,Dr. Jockers Functional Nutrition,0,0,0,1,49,50
1497797374,Knot Too Taboo,9,1,1,2,31,44
1497808752,Win Make Give with Ben Kinney,0,1,0,1,48,50
1497829764,The DewSweepers,0,0,0,0,3,3
1497835168,The Victor Davis Hanson Podcast,6,5,4,7,331,353
1497893809,Sister Wives Secrets,5,1,1,2,22,31
1497904898,Coast to Coast With Bee'z And Art Bell,0,0,0,0,1,1
1497921615,God's Big Story,2,0,1,2,45,50
1497937744,Poem-a-Day,0,0,0,0,4,4
1497957978,Dive Bomb Squadcast,0,1,0,1,317,319
1497963218,Charlotte Mason Show,0,0,0,0,13,13
1497964866,Lick The Rapper,1,0,0,0,49,50
1497972998,Backcountry BSing,0,0,0,0,18,18
1497998902,Hot Glue & Bobby Pins,0,0,0,0,6,6
1497999509,Be the Bridge Podcast with Latasha Morrison,2,2,1,1,36,42
1498001114,The Nicolas Cage Oral History Podcast,0,0,0,0,29,29
1498009129,Content Creatives Podcast,0,0,0,0,5,5
1498020377,Sister Act,0,0,0,0,7,7
1498048309,Coaching U Podcast with Coach Brendan Suhr presented by Hudl & Hudl Assist,0,0,0,0,1,1
1498083108,Straight Talk with John Hope Bryant,0,0,0,0,1,1
1498088239,Living a Sensory Life,0,0,0,0,1,1
1498100605,NEXT STOP,12,1,4,2,31,50
1498106610,The Rush Limbaugh Show,59,1,2,3,270,335
1498106654,Keep Shooting,0,0,0,0,13,13
1498112652,The Summer House After Show Podcast,1,0,0,0,3,4
1498113138,The Writers’ Co-op,1,0,0,0,11,12
1498114990,German Ponce - La Biblia Palabra Infalible,0,0,0,0,1,1
1498116036,Inside with Brett Hawke,0,0,0,0,10,10
1498127526,Breaking Green Ceilings,0,0,0,0,27,27
1498130060,WHY YOU SUCK AT GOLF!,0,0,0,0,7,7
1498149200,Hold These Truths with Dan Crenshaw,2,0,0,1,47,50
1498172564,Small Things Often,0,1,1,1,21,24
1498200241,The Bert Show,3,0,1,5,41,50
1498200908,Triple R Teaching,0,0,0,0,14,14
1498232141,In Our Backyard Podcast,0,0,0,0,7,7
1498254607,Embrace Your Real,0,0,0,0,50,50
1498260339,Comeback with Erica Cobb,0,0,0,0,3,3
1498271768,Con Todo: Brown Love,0,0,0,0,96,96
1498286175,The Residency Podcast,0,0,0,1,85,86
1498287880,A Breath of Fresh Earth,0,0,0,0,3,3
1498290126,Running Rivals,0,0,0,0,5,5
1498316156,Air Combat Sim,0,0,0,0,2,2
1498317366,Somos LAFC Podcast,0,0,0,0,1,1
1498326623,Colts Brawl,0,0,0,1,6,7
1498335678,The Coffee Breakup,1,0,0,0,2,3
1498336372,Let's Gut Real - Easy to Digest Nutrition Science,0,0,0,0,3,3
1498344993,Daily Wisdom - Walking The Path with The Buddha,0,0,0,0,1,1
1498382420,Mystery Recipe,3,1,3,3,40,50
1498387060,The Bourbon Life,0,0,0,2,28,30
1498392864,"Pitch, Please",0,1,0,0,3,4
1498396103,Life of the Prophet Muhammad,0,0,0,0,3,3
1498397344,Dumb Money LIVE,1,1,0,0,5,7
1498400907,Hybrid Calisthenics Podcast,0,0,0,0,2,2
1498434412,Love It or Weeb It! Anime Previews and Reviews,0,1,0,0,4,5
1498440647,Dog Nerd Show,0,0,0,0,1,1
1498460662,Guided Jewish Meditations,0,0,0,0,3,3
1498497770,Lush in Lace - Erotic Audio,2,0,0,0,3,5
1498512725,Fortnite,6,0,2,0,10,18
1498522890,Netflix Is A Daily Joke,6,2,2,4,14,28
1498560252,Locked On Lightning - Daily Podcast On The Tampa Bay Lightning,3,0,0,0,2,5
1498601880,Mel Giedroyc is Quilting,0,0,0,0,5,5
1498621703,Faux Reel Podcast,0,0,0,0,7,7
1498623465,Face to Face by Dezeen,0,0,0,0,1,1
1498625027,GOLF's Subpar,0,1,1,6,100,108
1498632035,Perspective For Parents,1,0,0,0,20,21
1498635922,Marathon Training for Beginners,0,0,0,0,48,48
1498674382,Seth Rudetsky's Back to School,0,0,0,0,26,26
1498693494,Setter Talk,1,0,0,1,2,4
1498701727,On the Corner of Main Street,0,0,0,1,23,24
1498713408,"The Dream Team Tapes: Kobe, LeBron & The Redeem Team",9,7,7,2,30,55
1498718446,The Digital Gumbo Podcast,0,0,0,0,11,11
1498719356,Of All Time,0,0,0,0,5,5
1498773151,The United States Constitution,1,1,0,0,2,4
1498801064,Creative Elements,0,0,0,0,75,75
1498802610,The Prof G Show with Scott Galloway,13,6,7,11,129,166
1498806952,The Left Right Game,0,3,12,16,19,50
1498818867,7 in 7 An Educational Podcast for Kids,0,0,1,0,7,8
1498819670,STAR WARS AUDIO ARCHIVES,0,0,0,1,3,4
1498819879,The BosBabes,0,0,0,0,12,12
1498822118,Shadow Work Library,0,0,1,0,8,9
1498826998,DBT & Me,0,2,1,3,2,8
1498829489,The Boyscast with Ryan Long,0,0,0,0,50,50
1498837117,Banking on Digital Growth,0,0,0,0,4,4
1498839261,Chowhound's Table Talk Podcast,0,0,0,0,1,1
1498839718,Fifth Wrist Radio,0,0,0,0,1,1
1498855031,I Weigh with Jameela Jamil,7,3,11,4,53,78
1498875068,Just Interesting People,0,0,0,0,16,16
1498889010,The Neverland Files,0,0,0,0,2,2
1498889653,G.L. Lambert Explains It All,0,0,0,1,3,4
1498891291,MLB Morning Coffee: A Daily MLB Podcast,3,0,0,0,13,16
1498936813,FC Bayern Podcast,0,0,0,0,1,1
1498948272,Everyday Decisions with Jo Firestone,0,0,0,1,49,50
1498951876,The LoveCrafts show,0,0,0,0,5,5
1498971078,What The Func?!,0,0,0,0,35,35
1498981014,The CC Podcast,0,0,0,0,3,3
1498983617,Freaking Out About Cincinnati’s Opening Day with Randy Freking,0,0,0,0,7,7
1498988870,On The Verge - BSL Radio - Baltimore Orioles & Orioles Minor League Talk,0,0,0,0,6,6
1499004284,Focus on Women,0,0,0,0,2,2
1499033719,I'm So Gay,0,0,0,0,13,13
1499034820,Forces for Nature,0,0,0,0,6,6
1499118300,The Loose Head Podcast,0,0,0,0,2,2
1499126562,Coronavirus Update,10,0,1,2,5,18
1499129034,Locked On Fantasy Baseball - Daily MLB Fantasy Podcast,0,0,1,0,5,6
1499133330,Jumping Bomb Audio,3,0,0,0,0,3
1499140700,Are You Garbage? Comedy Podcast,1,0,0,0,49,50
1499147350,Nonstop Nonprofit,0,0,0,0,3,3
1499151378,The Grumpy Economist,1,0,0,0,9,10
1499159204,LISK: Long Island Serial Killer,3,0,5,8,283,299
1499164128,Here's The Sitch with Mike & Laurens,1,0,1,2,46,50
1499175586,Screaming Cinema - A Horror Movie Podcast,0,0,0,0,34,34
1499210008,Fade the Noise with Brad Evans,0,0,0,0,18,18
1499213748,Beat The NMLS Test,2,0,0,0,0,2
1499219571,It's Hertime.,0,0,1,0,11,12
1499233378,Equinox,0,0,0,0,2,2
1499271317,Political Theory 101,0,0,0,0,1,1
1499278997,RUN WILD with Lauren and Bud,0,0,0,0,2,2
1499294498,The APsolute RecAP: Biology Edition,0,0,0,0,24,24
1499298470,Talking Tactics with Coach Gough,0,0,0,1,8,9
1499302360,Boys Watching Girls,0,0,0,0,7,7
1499347005,This Thing of Darkness,0,0,0,0,7,7
1499361133,Philly Prime Podcast,0,0,0,0,6,6
1499362900,Be Organic,0,0,0,0,17,17
1499377165,3LiveREWIND,0,0,0,2,4,6
1499394284,EPIDEMIC with Dr. Celine Gounder,12,2,5,1,30,50
1499409058,Bankless,0,0,1,0,54,55
1499413081,Running New Mexico Podcast,0,0,0,0,1,1
1499413307,Awake with Rabbi Lauren Holtzblatt,0,0,0,1,14,15
1499437570,Fertility Friendly Food,0,0,0,0,1,1
1499469461,Bedtime Stories with R.A. Spratt,0,0,0,0,6,6
1499476590,Hogsmen Podcast,0,0,0,0,5,5
1499506067,The Metrospective: A show about the New York Mets,1,0,3,0,7,11
1499510936,The Quick Daf,0,0,0,0,2,2
1499523663,Your Attention Please,0,0,0,0,4,4
1499533444,Fighting Words with Kurt Schlichter Podcast,2,1,0,0,4,7
1499534919,Z107.7 FM Unique Garden Show hosted by Mike Branning,0,0,0,0,1,1
1499539300,Device Nation,0,0,0,0,7,7
1499544082,Seattle Now,3,1,0,0,46,50
1499544300,Dynasty Theory Fantasy Football Show | Dynasty Fantasy Football,0,0,1,0,53,54
1499562159,I Said No Gifts!,1,1,0,0,48,50
1499563131,Baggs & Brisbee: A show about the San Francisco Giants,2,0,0,0,1,3
1499565720,The Story Seeds Podcast,1,0,0,0,25,26
1499566932,Homemaker Chic,5,3,7,1,34,50
1499587701,AEW Unrestricted,5,6,5,9,117,142
1499594546,The Radiology Review Podcast,0,0,0,0,11,11
1499631337,Terrores Nocturnos,0,0,0,0,1,1
1499643902,The People of Soil Health,0,0,0,0,2,2
1499646507,Real Estate Rookie,6,4,5,5,80,100
1499650446,Mastering Medicare,0,0,1,0,1,2
1499676477,DFS Coach Talk Podcast,0,0,0,0,16,16
1499702975,Prine Time,0,0,0,0,3,3
1499709633,That's So Minnesota,0,0,0,1,4,5
1499734883,Battle for 1600 with Sebastian Gorka and Boris Epshteyn Podcast,2,0,0,2,13,17
1499735786,Rewire Your Attachment Style with Maya Diamond,0,0,0,0,19,19
1499743238,The Take with Willie Mason,0,0,0,0,1,1
1499745500,Enneagram 2.0 with Beatrice Chestnut and Uranio Paes,0,3,3,5,33,44
1499749293,Super Nintendads Entertainment Podcast,0,0,0,0,14,14
1499759500,We Danglin,0,0,0,0,23,23
1499803146,The Lancet Voice,0,0,0,0,2,2
1499813686,The Coop with Meyer Hatchery,0,0,1,0,22,23
1499830163,King Of Keno,0,0,0,1,49,50
1499864083,Max Allotment Podcast,0,0,0,0,2,2
1499872498,The 73rd Hole,0,0,0,0,2,2
1499877854,The Keith Law Show,6,0,0,1,33,40
1499880546,New Discourses,2,0,2,1,45,50
1499884094,All Spoiler Recap,0,0,0,0,41,41
1499897111,The New Music Business with Ari Herstand,0,0,0,0,48,48
1499897596,Ghost Echoes,0,0,0,0,1,1
1499898207,Gospelbound,0,0,0,0,11,11
1499906821,Into America,9,0,0,0,41,50
1499906901,Out Of Nowhere,2,1,0,0,18,21
1499918414,The Scribes of Summer: A show about the Los Angeles Dodgers,0,0,1,0,4,5
1499942603,The Rolling Thunder podcast,0,0,0,0,2,2
1500020128,Soju Bomb,0,0,0,0,1,1
1500023986,Metal From The Inside,0,0,0,0,1,1
1500035260,The Dating Game Killer,64,53,78,47,182,424
1500039589,Picks Central,3,2,3,4,48,60
1500041195,The Gulf,0,0,0,0,1,1
1500044742,GT: Garage Talk,0,0,0,0,2,2
1500048571,The Other Latif,0,1,1,0,7,9
1500054794,Courtney: Beyond the Cake,2,0,1,3,53,59
1500066488,Sales Maven,0,0,0,0,28,28
1500081265,Hair of the Dog Podcast,0,0,0,2,44,46
1500084283,SimplyPodLogical,0,1,0,2,47,50
1500134545,The Genomics Life,0,0,0,0,2,2
1500150078,Hand In The Dirt,0,0,0,0,33,33
1500157502,World Record Podcast with Brendon Walsh,5,0,0,0,45,50
1500164222,Hoy Quiero Contarles,0,0,0,0,4,4
1500164428,Shane's Brilliant Podcast,0,0,0,0,7,7
1500168597,Identity/Crisis,0,0,0,0,3,3
1500173416,Deep Convection,0,0,0,0,5,5
1500186158,SHOEphoria - The Bartold Clinical Podcast,0,0,0,0,1,1
1500186485,Higher Energy,0,0,0,1,19,20
1500201039,Hammer Lane Legends,2,0,0,1,81,84
1500210436,Jesus Unfollower,0,0,0,0,10,10
1500265461,Sew easy,0,0,0,1,1,2
1500266629,21st Century Kindergarten,0,1,0,0,1,2
1500276878,Hex Crypto Podcast | Hexican Backup of Richard Heart,0,0,0,0,1,1
1500281881,Bingers Assemble: Godzilla vs. Kong,1,0,0,0,52,53
1500293933,Dear Asian Americans,1,0,0,0,7,8
1500309091,The Dirty Minds Podcast,0,0,0,0,9,9
1500323023,Calm The Bleep Down Meditation & Mindfulness,0,0,0,1,4,5
1500323362,One MANS Opinion with Jeff Mans,1,0,0,2,51,54
1500326364,Tennis & Bagels Podcast,0,0,0,0,2,2
1500326560,Forestcast,0,0,0,0,13,13
1500327396,The Crawford Talks: A show about the Houston Astros,0,0,0,1,12,13
1500328836,Self-Compassionate Professor,0,0,0,0,3,3
1500338916,Elijah Rising,0,0,0,0,3,3
1500339458,Younger with Dr. Robyn Benson,0,0,0,0,12,12
1500345617,Flat Bottom Girls,0,0,0,0,10,10
1500352112,The Farm Sim Show,0,0,0,0,1,1
1500354709,Act Two Podcast,0,0,0,0,5,5
1500358614,Music And Ideas,0,0,0,0,23,23
1500361934,The Geek Bracket - A Trivia Podcast,0,0,0,0,1,1
1500363170,The Professional Athlete Podcast with Ken Gunter,0,0,0,0,15,15
1500363474,Real Personal Branding Podcast,0,0,0,0,30,30
1500366104,Latter-day Ladypreneur,0,0,0,0,50,50
1500409207,How to Be Superhuman,0,0,0,0,1,1
1500424869,Das Coronavirus-Update von NDR Info,0,0,0,1,25,26
1500430921,Kayfabe Culture,0,0,0,0,1,1
1500436516,The Herbalist's Path,0,0,0,0,9,9
1500442697,"Native Plants, Healthy Planet presented by Pinelands Nursery",1,0,0,0,24,25
1500444735,The High Performance Podcast,1,2,0,4,90,97
1500446408,First Kick Podcast,0,0,0,0,1,1
1500452264,Healthy Runner Podcast,0,0,0,0,46,46
1500453500,Talking Sopranos,20,21,32,28,399,500
1500457449,Battlefield Next,0,0,0,0,1,1
1500460079,Friend Forward,0,0,0,1,8,9
1500465984,Arrive Alive!,0,0,0,0,27,27
1500477470,Even the Rich,160,64,100,68,360,752
1500483774,Locked On Longhorns - Daily Podcast On Texas Longhorns Football & Basketball,0,0,0,0,8,8
1500492987,Daily Mind Medicine,0,0,0,0,20,20
1500499810,The Deep Corner,0,0,0,0,2,2
1500517993,Last Minute Blues Podcast,1,0,0,0,20,21
1500586611,Everyday Mulemanship,0,0,0,0,39,39
1500594534,Like A New Day - A Leica Photography Podcast,1,0,0,0,8,9
1500598131,Cut Maker Podcast,0,0,0,0,2,2
1500604872,The Tony Walker Podcast,0,0,0,0,3,3
1500623380,More Than Profit,0,0,0,0,28,28
1500631254,Driveline R&D Podcast,0,0,0,0,2,2
1500633148,Affirmations 👏,0,0,0,0,2,2
1500633256,Calm Christian Parenting,0,0,0,0,5,5
1500634531,MARVELS,3,2,1,5,24,35
1500652478,Fullerton Unfiltered,1,0,0,0,199,200
1500667276,Beyond the Scrum: The Baseball Stories We Didn't Write,0,0,0,2,4,6
1500667648,Supernatural with Ashley Flowers,28,16,24,26,86,180
1500667684,The Graffiti Machine,0,0,1,1,14,16
1500673800,The Walkthrough | HomeLight's Real Estate Podcast,0,0,0,0,17,17
1500674422,Spies Like Us Podcast,0,0,0,0,3,3
1500682242,Buddhism for Beginners,0,0,0,0,3,3
1500685787,Behind The Feed,0,0,0,1,19,20
1500707657,HAVOC,0,1,0,0,4,5
1500761911,The Anti-MLM Podcast,17,10,7,2,24,60
1500763394,Top 100 bedtime stories for kids,0,0,0,0,1,1
1500763931,A Hot Dog Is a Sandwich,11,1,6,8,174,200
1500764291,Novel Pairings,1,0,1,0,103,105
1500778745,True Underdog,2,1,0,1,96,100
1500782760,Gill Athletics: Track and Field Connections,0,0,0,0,12,12
1500783135,Triple Play Fantasy’s Baseball Show,0,0,0,0,16,16
1500788421,Black Girl Missing,0,0,4,2,35,41
1500794652,Munsons at the Movies,0,0,0,0,5,5
1500799839,The Too Many Men Podcast,2,1,0,0,14,17
1500804455,The Center Cut Golf Podcast,0,0,0,0,7,7
1500810210,Nassaumen Hockey Podcast,0,0,0,0,6,6
1500813737,Mah Jongg Mondays podcast,0,0,0,0,26,26
1500841577,SLP Corner,0,0,0,0,6,6
1500843605,The Cellfie Show,1,0,0,0,49,50
1500848034,Talk To Me In 100% Korean,0,0,0,0,1,1
1500848514,Ordineroli Speaking,1,0,0,0,45,46
1500861437,The Third Party: An Apex Legends Podcast,1,0,0,1,48,50
1500901921,The Last Tenth Podcast,0,0,0,0,6,6
1500909133,Women Influencing Post Production,0,0,0,0,1,1
1500911605,Beyond The Showroom,0,0,0,0,1,1
1500919015,The Uneducated Duo,0,0,0,0,8,8
1500919715,Science Diction,4,0,1,6,54,65
1500920466,Couched,0,0,0,0,4,4
1500927263,I Survived,18,23,21,19,213,294
1500933736,Amazin' But True: A NY Mets Baseball Podcast from New York Post Sports,0,1,2,1,41,45
1500935369,The Imagine Neighborhood,0,0,1,1,48,50
1500946532,I Spy with my Myo Eye...,0,0,0,0,6,6
1500947685,Natural Prodcast,0,0,0,0,3,3
1500948773,Predator Radio,0,0,0,0,4,4
1500955155,10 Percent True - Tales from the Cockpit,0,0,0,0,1,1
1500957498,Heme Review,0,0,0,0,15,15
1500959805,Run For God: Run Club,0,0,0,0,4,4
1500967736,Coronavirus: Everything You Need to Know,0,1,0,1,4,6
1500970749,POLITICO Dispatch,2,1,0,1,20,24
1500976512,Go and See,20,5,0,6,19,50
1500981231,The Societies,0,0,0,0,2,2
1501003193,Creative Ways Podcast,0,0,0,0,7,7
1501005518,"Standup Comedy   ""Your Host and MC""",0,0,0,0,2,2
1501028017,Outgrowth: A Slice of Pro Beauty,0,0,0,2,17,19
1501029683,Coronavirus: Fact vs Fiction,44,11,11,11,342,419
1501035631,Chrissie Mayr Podcast,0,0,0,0,50,50
1501052684,The Dork-O-Motive Podcast,0,0,0,0,41,41
1501057207,The WTF Bach Podcast,0,0,0,0,2,2
1501057347,The North-South Connection,0,0,0,0,8,8
1501057527,The PedsDocTalk Podcast,2,0,0,0,48,50
1501061792,City of Women,0,0,0,0,1,1
1501110958,What's Our Verdict Movies,0,0,0,0,8,8
1501203196,Teamistry,1,0,0,0,31,32
1501222602,It's Not A Crisis,1,0,0,2,28,31
1501232778,The Ceramics Podcast,0,0,0,0,4,4
1501235197,Crush Step 1: The Ultimate USMLE Step 1 Review (An InsideTheBoards Podcast),0,0,0,0,4,4
1501239219,Strictly Anime,0,0,0,0,4,4
1501240462,The Sidewalk Weekly,0,0,0,0,1,1
1501248528,WDW Escape,0,0,0,0,7,7
1501251426,Superman and Lois Radio,2,2,0,0,1,5
1501267072,CrossFade: The Dueling Album Review Show,0,0,0,0,10,10
1501271289,Goalie Hacks Podcast,0,0,1,0,68,69
1501271812,Passion for the Pastime,0,0,0,0,4,4
1501281184,Turn Your Followers Into Clients with Vanessa Lau,0,0,1,0,49,50
1501337450,Trees and PhDs,0,0,0,0,5,5
1501355967,Unfiltered Faith,9,2,3,6,254,274
1501365478,Crimeaholics,1,2,3,6,31,43
1501365760,Destination Sasquatch Podcast,0,1,0,0,1,2
1501374800,Gino Time: A Boston Celtics Podcast,0,1,0,0,22,23
1501379260,The Dabble Co. Podcast,1,0,0,0,49,50
1501379687,The Plot Against America Podcast,4,1,2,0,51,58
1501403387,Jerusalem Lights,0,0,0,0,1,1
1501406448,Dr. NoSleep | Scary Horror Stories,1,0,0,2,27,30
1501412300,Us Weekly's Bachelor Podcast - Here For The Right Reasons,5,1,1,1,18,26
1501413453,The MEND Fly Fishing Podcast with Joe Rotter and Red's Fly Shop,0,0,0,0,4,4
1501415151,The Greg Cote Show with Greg Cote,15,1,1,3,332,352
1501433969,Floodlines,3,0,3,1,43,50
1501456485,Pinstripe Pod: A NY Yankees Baseball Podcast from New York Post Sports,0,0,0,1,5,6
1501466398,Dump 'n Change,0,0,0,1,10,11
1501468628,Positively Trek,0,0,0,0,4,4
1501498668,The Bad Boys Podcast,0,0,0,0,5,5
1501500390,Coronacast,4,1,1,1,84,91
1501533587,Dictionary.com's Word Of The Day Podcast,0,0,0,0,4,4
1501535128,IEP Essentials Pro Tips with Wendy Taylor,0,0,0,0,3,3
1501544101,Kottke Ride Home,11,7,6,4,108,136
1501547110,Melton Forge Works Podcast,0,0,0,0,2,2
1501548680,PlasticPills - Philosophy & Critical Theory Podcast,1,0,0,0,2,3
1501592446,A Teen's Perspective,0,0,0,0,28,28
1501597193,Free Range American Podcast,4,2,5,6,152,169
1501600433,Privacy Please,0,0,0,0,9,9
1501630157,Flying BC - Pilot Stories and Aviation Adventures,0,0,0,0,2,2
1501632357,Rising Tide: The Ocean Podcast,0,0,0,0,2,2
1501641442,The Screenwriting Life with Meg LeFauve and Lorien McKenna,0,0,0,0,84,84
1501643629,Cardinal Aviation Audio Briefings,0,0,0,0,1,1
1501672428,What Do You Call That Noise? The XTC Podcast,0,0,0,0,2,2
1501686296,Hinduism Spirituality,0,0,0,0,1,1
1501694474,The Ottobot Podcast,0,0,0,0,2,2
1501716010,Stories of our times,13,0,7,6,68,94
1501720184,Coronavirus Global Update,2,0,1,2,18,23
1501721699,No Filter: A skincare podcast,0,0,0,0,5,5
1501724513,Coffee With My Ex: Caleb Marshall and Haley Jordan,0,0,0,1,33,34
1501735272,Texx Talks,0,0,0,0,16,16
1501747305,Prepared Disc Golfers,1,0,0,0,5,6
1501752113,SBJ Unpacks,1,0,0,0,1,2
1501752408,Coffee and Cauldrons,0,0,0,1,29,30
1501755896,One Minute Scripture Study: A Come Follow Me Podcast,1,0,0,0,74,75
1501761047,The Blackthorn Grove,0,0,0,0,2,2
1501769114,Bootleg Football,0,1,0,1,23,25
1501780446,Adults Talking Anime +,0,0,0,0,1,1
1501789052,The Homegirl Fox,1,0,0,0,29,30
1501794571,F*** You Dad,0,0,0,0,6,6
1501817168,Wheels On Fire : An Absolutely Fabulous Podcast,0,0,0,1,14,15
1501850375,D&D Minus,0,0,0,2,48,50
1501878304,The SoleSavy Podcast,0,0,0,0,3,3
1501880187,Multiplayer Gaming Podcast,3,0,0,2,94,99
1501886993,Stock Market Options Trading,0,0,0,4,20,24
1501891506,Leadership Next,0,0,0,1,3,4
1501895003,The Big Melt,2,1,1,1,28,33
1501905538,The Real Python Podcast,1,0,0,0,5,6
1501910881,Ghost Stories – A Rolls-Royce Podcast,0,0,0,0,1,1
1501911064,Getting Over: Wrestling Podcast,1,1,1,3,147,153
1501918811,Military History By Kids For Kids,0,0,0,3,5,8
1501929208,Thirteen,5,3,3,1,38,50
1501975271,Sailor Moon Fan Club,0,0,0,0,4,4
1501993614,Queens of Adventure: Legends,0,0,0,0,5,5
1502016933,Black Spin Global: The Podcast,0,0,0,0,2,2
1502035061,Simple Doesn't Mean Easy,0,0,0,0,11,11
1502037429,The Mysterious and Unbelievable Case of the Batboy and the Hot Dogs,0,0,0,0,7,7
1502040576,Lean With Plants,0,0,1,0,49,50
1502050737,Rondail's Unpopular Opinion,0,0,0,0,2,2
1502050948,The Shelf Life: A Podcast Sitcom,0,0,0,0,3,3
1502110628,Crossing Animals - an Animal Crossing New Horizons Podcast Series,0,0,0,1,48,49
1502114024,Build Your Brand Podcast with Jeff Echols,0,0,0,0,3,3
1502126614,ABC News Radio Specials,8,3,2,2,19,34
1502149340,Surprisingly Brilliant,4,4,6,1,60,75
1502150213,Strange Arrivals,8,7,4,2,29,50
1502150297,The Unplugged woodworking podcast,0,0,0,1,1,2
1502164270,Simple Homesteading Life,0,0,0,0,1,1
1502168719,The Beauty Lounge,0,0,0,0,11,11
1502171248,The Confessional with Nadia Bolz-Weber,10,1,8,6,278,303
1502178774,Blowback,6,4,2,3,86,101
1502184032,Dump N' Change Podcast,0,0,0,0,7,7
1502184498,This Matters | Daily News Podcast,0,0,0,0,1,1
1502199229,Heart Shaped Leaves After Dark Podcast,0,0,0,0,14,14
1502221185,The BMW Podcast | Changing Lanes,4,1,1,0,3,9
1502259910,No Puedes Jugar Boxeo El Podcast,0,0,0,0,1,1
1502260943,Pair of Kings,0,0,0,0,30,30
1502290884,Generation Jihad,2,0,1,1,30,34
1502295220,The Fitness Movement: Training | Programming | Competing,0,0,0,0,14,14
1502298896,Another Woodshop Podcast,1,0,1,0,48,50
1502307717,Fiction Writing Made Easy,0,0,0,2,87,89
1502311153,MLS Gone Wild,0,0,0,0,11,11
1502321024,Mind of the Meanie,0,0,0,0,27,27
1502321920,The Triton Incident,0,0,0,1,2,3
1502324399,The Suga,0,0,0,5,45,50
1502327319,The Missing Link for SLPs,0,0,0,0,1,1
1502338676,MetFlex and Chill,0,0,0,0,50,50
1502347693,Top of the Mook,0,1,2,0,47,50
1502349340,Country Club Adjacent,1,0,0,0,29,30
1502353442,Rink Stories,1,0,0,0,7,8
1502403282,Dynamic Dialogue with Danny Matranga,0,0,1,0,49,50
1502420566,Protection Dog Podcast,0,0,0,0,4,4
1502426191,"From Borderline to Beautiful: Hope & Help for BPD with Rose Skeeters, MA, LPC, PN2",1,0,1,0,13,15
1502426932,Dog Mom Podcast,6,0,0,1,15,22
1502444433,The Unfiltered Motherhood Podcast,0,0,1,1,48,50
1502466042,Interleaved: A Talmudic Podcast,0,0,0,0,4,4
1502468251,Mike Gallagher Podcast,0,0,0,0,2,2
1502472591,TFLTalk,0,1,2,1,10,14
1502474233,The Larry Elder Show,1,0,0,2,47,50
1502476673,Ask Kati Anything!,0,0,0,0,29,29
1502481411,Behold Israel,2,0,0,0,31,33
1502483536,Anime Brothers,0,0,0,0,1,1
1502493574,Becoming Mama™: A Pregnancy and Birth Podcast by Motherly,2,1,0,0,3,6
1502494666,Learn Taiwanese Mandarin,0,0,0,0,3,3
1502498072,Mommin' With Friends,0,0,0,0,1,1
1502515358,Beyond the Basement: The Attack on Titan Podcast,1,0,2,1,15,19
1502568407,SGT Report's The Propaganda Antidote,5,3,0,3,36,47
1502587318,Weaving Community w/Amy D. McKnight,0,0,0,0,1,1
1502593062,Trail to 100,0,0,0,0,3,3
1502600383,The Fight Site Podcast Network,0,0,0,0,1,1
1502631179,GardenDC,0,0,0,0,2,2
1502634775,Start - Le notizie del Sole 24 Ore,0,1,0,0,0,1
1502653546,The Villager's Voice - an Animal Crossing podcast,4,2,1,0,35,42
1502673603,Prince Kumi Live!,0,0,0,0,2,2
1502683214,The Viral Volley Podcast,0,0,0,0,3,3
1502692172,Books and Beyond with Bound,0,0,0,0,18,18
1502728078,The Lefty’s Lounge,0,0,0,0,7,7
1502728938,This Day in Esoteric Political History,1,2,5,3,39,50
1502730132,frisellasallaroundtheyard's podcast,0,0,0,0,1,1
1502739330,Dangerous World Podcast,3,1,0,0,40,44
1502759777,Holding Kourt Podcast,0,1,0,0,42,43
1502765577,Mythology & Fiction Explained,0,0,0,0,14,14
1502765919,Work Matters With Ken Coleman,0,0,0,0,7,7
1502769552,Trent Loos Podcast,0,0,0,0,1,1
1502771083,Red Valley,0,0,0,1,23,24
1502773257,Witchcraft Off the Beaten Path,0,0,0,0,15,15
1502773822,Oscar Wild,0,0,0,0,4,4
1502776821,Who's Saving the Planet?,0,0,0,0,15,15
1502780406,The Sakara Life Podcast,2,0,3,3,42,50
1502783139,Rigs of Dad Prodcast,0,0,0,0,2,2
1502792903,Grow or Die Podcast,3,0,1,0,46,50
1502800211,Find Your Beach,0,0,0,0,50,50
1502805303,The PAPER STREET Podcast,0,0,0,0,1,1
1502843493,SLP Nerdcast,0,0,0,0,6,6
1502847590,"The Prather Point.  Uncensored, Unafraid, Outside the Box",1,0,0,0,5,6
1502853894,Saltwater Edge Podcast,0,0,0,0,11,11
1502871393,"All-In with Chamath, Jason, Sacks & Friedberg",19,5,5,11,137,177
1502904619,Macro Hive Conversations With Bilal Hafeez,0,0,0,0,4,4
1502915722,Kids Listen Activity Podcast,0,1,1,0,11,13
1502942214,Meaningful People,0,1,0,1,125,127
1502954097,Do You F*****g Mind?,4,2,2,0,168,176
1503046035,Strange News Daily,2,1,2,1,30,36
1503048364,The No Good Podcast,1,0,0,0,1,2
1503054214,I Don't Need an Acting Class,1,0,0,0,12,13
1503059400,Sarah Bowling - Living Genuine Love,0,0,0,0,1,1
1503061520,Podioslave Podcast,0,0,0,0,12,12
1503065691,Token CEO,13,4,3,3,177,200
1503070840,I AM Beautiful Wild Free: A Guided Affirmation and Meditation Podcast,0,0,0,0,40,40
1503075963,Quilt Buzz,1,1,0,5,43,50
1503076403,Forerunners: The Surfline Podcast,0,0,0,0,1,1
1503081270,Skyjacks: Courier's Call,0,0,0,0,21,21
1503086929,Mind Yeti,1,0,0,1,1,3
1503149669,Home Cooking,0,0,1,0,199,200
1503186849,Dudes Talkin' Sports,0,0,0,0,2,2
1503193641,Tripping on My Roots,0,0,0,0,1,1
1503203797,Yes UConn!,0,0,0,0,3,3
1503225348,The Dadass Podcast,0,0,0,0,4,4
1503226625,Consider This from NPR,70,30,10,8,78,196
1503227159,Animal Testing,0,0,0,0,1,1
1503232531,Get With The Programming,1,0,0,0,25,26
1503234937,Complete Spanish,0,0,0,0,6,6
1503236243,Wild Ride! with Steve-O,5,1,1,5,162,174
1503242769,Mind-Jam Podcast: Pet Health & Longevity,0,0,0,0,2,2
1503243332,Marietta Daily Journal Podcast,0,0,0,0,20,20
1503243986,Da Rona Report with Mandii B,0,0,0,0,2,2
1503246373,UpNFlamez,0,0,0,0,11,11
1503250521,Hunger Hunt Feast | Strategic Fitness,0,0,0,0,3,3
1503262084,House Of Hockey Podcast,0,0,0,0,4,4
1503268053,From Lab to Leader,0,0,0,0,2,2
1503268151,Passport,0,0,0,2,40,42
1503271831,The Hang with Ramin Karimloo,0,0,0,0,10,10
1503278459,Nate The Hate,1,0,0,0,11,12
1503292149,Mansplain Baseball Elsewhere,2,0,0,1,20,23
1503336296,The Boat Life Podcast,0,0,0,0,14,14
1503340113,The Simple BioTech Podcast,0,0,0,0,5,5
1503340855,"Cancel Me, Baby!",0,0,0,0,1,1
1503346367,How Long Gone,6,1,4,2,37,50
1503347206,A BA Study Podcast,0,0,2,0,30,32
1503364948,Elle’s Cottage Podcast,0,0,0,0,1,1
1503378052,Locked On Big 12 - Daily College Football & Basketball Podcast,1,1,0,0,4,6
1503381853,HSL Retriever Talk,0,0,0,0,1,1
1503383606,#EnCasadeMara,0,0,0,0,1,1
1503388186,Crypto-Z,13,5,2,3,27,50
1503407041,"Psyched : Convos on Psychology, Relationships and Personal Growth",0,0,2,0,1,3
1503421427,NurseSpeak,0,0,2,3,59,64
1503491843,Faith 'N Fish'N,0,0,0,0,2,2
1503517959,Timcast IRL,14,4,5,7,169,199
1503540842,Black Box Down,11,6,14,10,332,373
1503549065,Middle Children,0,0,0,0,50,50
1503549205,TFL Talkin' Trucks,1,0,0,0,16,17
1503551826,Dragonfly Tales,0,0,0,0,7,7
1503557247,Criminalia,21,12,18,19,73,143
1503559501,"Fake Doctors, Real Friends with Zach and Donald",8,8,11,12,298,337
1503567654,Both World Tarantulas,0,0,0,1,2,3
1503568775,Theo Rossi's THEOry with Kim Coates,1,0,0,2,289,292
1503581022,But It Was Aliens,0,0,0,0,28,28
1503581478,Swan Signal - A Bitcoin Podcast,2,0,0,0,14,16
1503583059,The Cheat Code,2,1,0,3,52,58
1503591370,Chad Ford's NBA Big Board - NBA Draft Podcast,5,0,1,6,22,34
1503592895,Prophet Muhammad Podcast,0,0,0,0,2,2
1503599999,StraightioLab,0,0,0,1,49,50
1503605638,The Content Mines,0,0,0,0,5,5
1503612631,Captain Kindergarten,0,0,0,0,5,5
1503645220,Living your best life Podcast,0,0,0,0,6,6
1503648883,Over the fence podcast,0,0,0,0,10,10
1503683498,Shut The Front Door,0,0,0,0,1,1
1503697266,What are YOU going to do with THAT?,0,0,0,0,3,3
1503705068,Alice Cooper's Vintage Vault Podcast,0,0,0,0,14,14
1503715670,TK PRODUCTIONS/MUSIC CRITIC,8,0,0,0,0,8
1503739245,Commit Or Quit,2,0,0,3,492,497
1503749968,Freedom Challenge Online,0,0,0,0,4,4
1503772303,"Say Less With Kaz, Lowkey and Rosy",2,0,1,0,31,34
1503778407,Field Ethos Journal,0,0,0,0,4,4
1503810723,Casper Dog Training,0,0,0,0,1,1
1503830168,The 9Gs Podcast - An Aviation Podcast,0,0,0,0,1,1
1503832008,The Coronavirus Effect - Where Do We Grow From Here?,0,0,0,3,0,3
1503837381,Daigle Bites,0,0,0,0,50,50
1503847664,Tell Me About Your Pain,0,0,2,0,48,50
1503861443,Ultimate Swimmer,0,0,0,1,3,4
1503878544,Red Inker With Jarrod Kimber,0,0,0,0,6,6
1503887245,The Plan on Purpose Podcast,0,0,0,0,6,6
1503895708,Podcast M.D. for medical students By Erfan Sheikhbahaei|پادکست مشاوره پزشکی ام دی با عرفان شیخ,0,0,0,0,1,1
1503897906,The Resetter Podcast,0,1,0,0,62,63
1503921457,Phoebe Reads a Mystery,0,0,0,0,5,5
1503926981,The Socially Distant Sports Bar,0,1,2,1,366,370
1503928088,Deviant Gentlemen Podcast,2,0,1,0,47,50
1503931590,The Wild Photographer,0,0,0,0,1,1
1503951481,"Peace Lutheran Church, Sussex, WI",0,0,0,0,1,1
1503957688,His and His,0,1,2,0,57,60
1503959427,Henry Danger Universe With Maralyn Negron,0,0,0,1,4,5
1503962700,Cancelled Movie Report,0,0,0,0,2,2
1503965353,Greaux Rugby by GiftTime Rugby Network,0,0,0,0,1,1
1503984858,Cajun and Creole Talk,0,0,0,0,2,2
1503992871,Track and Field History with Jesse Squire,0,0,0,0,3,3
1503994111,The Morning Ritual,0,0,0,0,39,39
1503998686,Riled Up with Arielle & Matt,6,0,0,3,41,50
1504008131,Tiny Toreros Story Time,0,0,0,0,2,2
1504020473,Athletic Motion Golf- The Podcast,0,0,0,0,48,48
1504023870,The Angry Joe Show Podcast,0,0,0,0,2,2
1504026755,Sunday League: The Podcast,0,0,0,0,2,2
1504048545,The Rachman Review,0,0,0,1,3,4
1504048609,Pilates With Kate,0,0,0,0,3,3
1504075237,Living with Landyn with Landyn Hutchinson,13,9,1,7,448,478
1504117547,Daily Spiritual Antidote by Rabbi Simon Jacobson,0,0,0,0,1,1
1504128553,In the Bubble: From the Frontlines,8,2,3,8,208,229
1504140597,The Intercooler,0,0,0,0,10,10
1504146192,Veterans Corner Radio,0,0,0,0,2,2
1504147062,"Podcast in Hindi on Kids Moral Stories & Indian History, Hindi Kahaniya, हिंदी कहानियाँ, बाल",0,0,0,0,1,1
1504150946,STRUCK: An Aerospace Engineering & Lightning Protection Show,1,0,0,0,1,2
1504177366,All God's Women,0,0,0,0,11,11
1504179077,Soy Claretiano,0,0,0,0,1,1
1504187933,Time To Die,0,0,0,0,7,7
1504201754,Banjo Studio Podcast,1,0,0,0,4,5
1504218804,CannMed Coffee Talk,0,0,0,0,1,1
1504249857,The Uptime Wind Energy Podcast,0,0,0,0,1,1
1504250328,Barron's Streetwise,5,3,4,4,119,135
1504262283,The Outlaw Nation Podcast Network,1,0,0,0,10,11
1504264388,Barndominium Lifestyle,1,0,0,0,1,2
1504273613,The Boneyard Podcast,0,0,0,0,15,15
1504280230,Dark Side of Wikipedia | True Crime & Dark History,5,1,5,3,36,50
1504283429,Modern Medicine Movement,0,0,0,0,46,46
1504295708,Five-Tool Fantasy Baseball Podcast,0,1,0,0,13,14
1504295732,UNHhhh,1,0,2,0,41,44
1504298199,Blocked and Reported,20,11,6,8,247,292
1504301339,At a Distance,0,0,0,0,13,13
1504303593,A Runner’s Life,0,0,0,0,4,4
1504305051,Headmirror's ENT in a Nutshell,0,0,0,0,17,17
1504319251,Bob Saget's Here For You,3,3,4,5,35,50
1504326014,Skeptics vs. Believers Podcast,0,0,0,0,5,5
1504330338,Real Relationships Real Revenue - Video Edition,0,0,0,0,9,9
1504360345,The Osterholm Update: COVID-19,8,2,5,8,206,229
1504361992,The Mind Of George Show,0,0,0,0,50,50
1504363373,The Latched Mama Podcast,0,0,0,1,4,5
1504371732,The XLR8 Performance Lab Podcast,0,0,0,0,1,1
1504483141,Charter Cities Podcast,0,0,0,0,4,4
1504484631,Animalia,0,0,0,0,1,1
1504486636,Real Narcos,1,0,1,7,41,50
1504503533,Did You Wash Your Hands?,0,0,0,0,7,7
1504509247,Seerah of Prophet Muhammad (sws) - Yasir Qadhi,0,0,0,0,2,2
1504518726,The Wizard Scroll,0,0,0,0,3,3
1504530276,"Your Enneagram Coach, the Podcast",0,1,1,2,53,57
1504546930,Visionaries Audio Drama,0,0,0,0,35,35
1504565792,The Funky Farm Girl,0,0,0,0,28,28
1504569318,The Headgum Podcast,1,0,1,1,47,50
1504590677,PetAbility  Podcast,0,0,0,0,4,4
1504592760,The Game Changing Attorney Podcast with Michael Mogill,0,0,0,0,88,88
1504596643,Checking In with Susan David,0,0,0,0,40,40
1504619325,Reptile Talk,0,0,1,0,14,15
1504691050,The Ask Joe Powder Powdcast,0,0,0,0,1,1
1504706537,The Hidden Gnome Podcast,0,0,0,0,5,5
1504716222,WorkWoman,0,0,0,0,17,17
1504721836,Traffic Secrets: The Underground Playbook for Filling Your Websites and Funnels with Your Dream Cust...,1,0,1,0,48,50
1504732282,The Plot Thickens,13,7,5,16,278,319
1504738445,Don't Shoot The Messenger,0,0,0,3,41,44
1504738476,Beyond Belief,0,0,0,1,24,25
1504750996,"Lockdown Universe (A UFO, ALIEN, BIGFOOT, SCI FI AND PARANORMAL PODCAST!!)",0,0,0,0,2,2
1504764007,Girl Mom Podcast,0,0,0,0,11,11
1504776737,Trauma ICU Rounds,0,0,0,0,50,50
1504781339,Seeking the Truth - Searching for Answers.,1,0,0,0,1,2
1504787005,Serhant Soundtracks,0,0,0,0,3,3
1504795544,MSL Talk,0,0,1,0,16,17
1504815062,The Shit Show,2,1,0,0,10,13
1504843635,The Tiger King After Show Podcast,5,1,0,1,1,8
1504844026,Running Things,0,0,0,0,4,4
1504901716,The Weight Loss Shift Podcast,0,0,0,0,17,17
1504903598,The Pogcast,0,0,0,1,3,4
1504907233,"Be Reasonable: with Your Moderator, Chris Paul",13,0,0,0,66,79
1504907503,Seek Outside Podcast,0,0,0,0,3,3
1504917517,Finding Humanity,0,0,0,0,7,7
1504928110,Time For Lunch,0,0,0,0,6,6
1504933102,Sony Alpha Photographers,0,0,0,0,2,2
1504936576,Early Call Time,0,0,0,0,5,5
1504938146,Dear Fathers Podcast,0,0,0,0,19,19
1504940209,Talk'n Shop,2,0,0,2,184,188
1504942580,Bananas,0,0,1,1,48,50
1504942990,Treasure Island 2020,1,0,1,4,44,50
1504956988,Birth Of A Nation,0,0,0,0,10,10
1504964033,The Modern Homemaker,0,0,0,0,8,8
1504990147,Questions from the Closet,1,0,1,0,93,95
1504993674,The Emcee Podcast,0,0,0,0,5,5
1505065686,knitting with confidence & hope,0,0,0,0,1,1
1505081153,The Weekly Take from CBRE,0,0,0,0,8,8
1505083611,Wine Blast with Susie and Peter,0,0,0,0,4,4
1505084442,FRESHSQUEEZED 🍋,0,0,0,0,1,1
1505100929,The Future of Learning and Development Podcast,0,0,0,0,6,6
1505114760,Otaku Host Club,0,0,0,0,2,2
1505116116,We're Having Gay Sex,2,1,1,0,46,50
1505117036,Jurisprudence Course,1,0,0,0,7,8
1505121336,The Compound - MLB Player Podcast,0,2,0,0,330,332
1505146787,The GOTDamn Kylan Show,3,0,1,0,20,24
1505222643,Coach Morton and Friends Real Talk,0,0,0,0,1,1
1505232583,The Accidental Swingers,0,0,0,0,6,6
1505240713,The Podcast from The Temple,0,0,0,0,4,4
1505257665,Outbreak Alabama: Stories from a Pandemic,0,0,0,2,1,3
1505257676,The Growth Equation Podcast,0,1,0,0,49,50
1505260479,Fist Full of Dirt,0,0,0,0,61,61
1505309977,Tokyo Inklings,1,0,0,0,21,22
1505330814,The Fire Pit with Matt Ginella,0,0,0,0,108,108
1505357433,Tomlin's Harmonica Podcast,0,0,0,0,7,7
1505357863,What Would Love Do?,0,0,0,1,24,25
1505371927,Let's Go! Hockey Podcast,0,0,0,0,17,17
1505383075,Rough Cut Golf Podcast,0,0,0,1,5,6
1505387845,Us Weekly's Getting Real with the Housewives,0,2,0,0,6,8
1505387960,The CHEF Radio Podcast,0,0,0,2,10,12
1505388703,Rudy Giuliani's Common Sense,15,0,0,0,35,50
1505391691,Dish on Dogs Podcast,0,0,0,0,3,3
1505392890,Spanking & All Things FemDom,1,0,0,0,0,1
1505404932,TeapotOne - Bru Time,0,0,0,0,3,3
1505415700,It's the Pictures that Got Small,0,0,0,0,8,8
1505419097,Road to the Skeleton Coast,0,0,0,4,57,61
1505433591,Rene Ritchie,2,1,0,1,17,21
1505444385,Selling The Scream,0,0,0,0,3,3
1505459510,The Frequency: Daily Vermont News,0,1,0,0,9,10
1505460817,Sex and Psychology Podcast,1,0,0,0,8,9
1505466130,Out with Suzi Ruffell,0,0,0,0,4,4
1505468758,Inside The Groove - Madonna's Music,0,0,0,0,24,24
1505477063,On Your Mark Wrestling Podcast,0,0,0,0,18,18
1505489762,Journeys in Greenery with Hilton Carter,0,0,0,0,3,3
1505520809,The Straight Shooter Recruiter,0,0,0,0,7,7
1505558670,The Gunkhole State Park Podcast,0,0,0,0,6,6
1505581039,The Art of Happiness with Arthur Brooks,0,0,4,0,45,49
1505581618,Relatos De Horror (Historias De Terror),1,0,2,1,8,12
1505592692,The Family Pupz Podcast,0,0,0,0,2,2
1505597825,REimagine,1,0,0,0,1,2
1505605345,The Kame House Podcast,0,0,0,0,2,2
1505606643,Just Pod Baby! - A Las Vegas Raiders Podcast,0,0,0,0,2,2
1505618760,Seeing Other People,7,3,5,4,40,59
1505624059,NASA's Curious Universe,0,0,1,1,26,28
1505635442,I'll Find Myself When I'm Dead,0,0,0,0,4,4
1505638569,What's Gaby Cooking in The Wild,1,0,0,0,24,25
1505640020,Knitting Nerdcast,3,0,0,2,19,24
1505646152,The Measure of an Episode,0,0,0,0,2,2
1505650828,K9 Mindfreak,0,0,0,0,2,2
1505658869,Turtle Creek Lane,0,0,0,0,9,9
1505689225,The Girls Uninterrupted,0,0,1,0,16,17
1505690963,The Thomas Eriksen Podcast,0,0,0,0,6,6
1505703522,"Self Care Club: Wellness, road tested",0,0,1,0,34,35
1505770428,The Mom's Organization Motivation Podcast,0,0,0,0,39,39
1505771769,Tango Alpha Lima Podcast,0,0,0,0,3,3
1505774466,Ableton & Music Habits Podcast,0,0,0,0,1,1
1505786417,Shaun101's Podcast,0,0,0,2,24,26
1505790434,Common Goal,0,0,0,0,11,11
1505804327,The Deep-Sea Podcast,0,0,0,0,3,3
1505840733,Definitely Dylan,0,0,0,0,6,6
1505843600,Lights Out Podcast,16,9,13,15,447,500
1505846969,Brunch with Desb Podcast,1,0,1,0,48,50
1505853304,The Debrief with Major Garrett,0,0,1,1,40,42
1505854159,Road to Redline : The Porsche and Car Podcast,0,0,0,0,3,3
1505855709,GoodFellows: Conversations from the Hoover Institution,3,3,1,1,12,20
1505855943,The Detailing Business Class Podcast,0,1,0,0,7,8
1505859024,Transformational Leadership with Henna Inam,0,0,0,0,2,2
1505873854,"Oh, Hello: the P'dcast",0,0,0,0,50,50
1505875687,My New Life,1,0,0,0,49,50
1505879525,America's Offroad Podcast,0,0,0,0,2,2
1505881667,WWE's The Bump,0,0,0,0,6,6
1505886326,Dark Topic,1,1,1,2,253,258
1505894059,Brutally Blunt with Jennifer & Katie,0,0,0,0,5,5
1505907186,The My Little Eater Podcast,0,0,0,0,12,12
1505921069,In The Light with Dr. Anita Phillips,0,0,0,1,49,50
1505921624,The 7investing Podcast,1,0,1,0,7,9
1505922797,Mostly Movies with Aaron Woodall,0,0,1,0,4,5
1505934042,We Speak Beauty,0,0,0,0,45,45
1505959146,Real Talk with Snoop and Lady S,0,0,0,0,1,1
1505987963,Vanguard of Hollywood,0,0,0,0,5,5
1505993848,Apokalypse & Filterkaffee,1,0,0,0,0,1
1506014619,Erotic Audio by Audiodesires.com,0,1,0,0,0,1
1506017781,"The Mistholme Museum of Mystery, Morbidity, and Mortality",0,1,0,0,5,6
1506042912,EMS Today,0,0,0,0,1,1
1506045350,At Last She Said It,0,0,0,1,32,33
1506059763,Philanthropy 360 Podcast,0,0,0,0,1,1
1506062783,How I Did It!,0,0,0,0,5,5
1506063411,The Jesse Kelly Show,8,1,0,0,181,190
1506065732,Backroad Exploration Podcast,0,0,0,0,2,2
1506070703,Kennedy Dynasty,1,1,5,0,43,50
1506087242,The Best Friends Podcast,0,0,0,0,9,9
1506097509,Sunday Papers,8,4,2,2,34,50
1506103145,The Breakdown with Robbie,0,0,0,0,27,27
1506108739,MobCast Mafia Anime,0,0,0,0,6,6
1506110143,Live Sound Bootcamp,0,0,0,0,4,4
1506126477,Podcast Minute Talk Show,0,0,0,0,16,16
1506127536,Making the Argument with Nick Freitas,2,0,0,0,36,38
1506177020,Dear Culture,1,1,0,0,6,8
1506207997,The Last Archive,8,4,4,7,27,50
1506227206,Opinion Science,0,0,0,0,11,11
1506245957,Lost Fore Words,0,0,0,0,3,3
1506258670,Feedstuffs Precision Pork,0,0,0,0,1,1
1506259735,Heal Your Heartbreak,1,0,0,1,48,50
1506271689,The Paranormal Files (Official Podcast),0,0,0,0,29,29
1506277024,Toward Light: Practical Buddhism for the Modern World,0,0,0,0,2,2
1506286335,Jewelry Artist,0,0,0,0,9,9
1506293305,The Joe and Todd Show,0,0,0,0,2,2
1506309574,The Media Hijacked,1,0,0,0,3,4
1506312134,The Sheep Show podcast,0,0,0,0,1,1
1506330860,Feed Room Chemist: An Equine Nutrition Podcast,0,0,0,0,19,19
1506381603,Mixed Tag,0,0,0,0,11,11
1506387898,Glorious Professionals,0,0,0,0,39,39
1506393207,Red Dice Diaries RPG Podcast,0,0,0,0,1,1
1506395878,Teamcast,0,0,0,0,6,6
1506403751,Madame Magenta: Sonos Mystica,0,0,0,0,10,10
1506404790,Rebel Entrepreneur with Alan Donegan,0,0,0,0,21,21
1506405294,Self Sufficient Hub,0,0,0,0,6,6
1506416879,Gettin Gritty Wit It,0,0,0,0,1,1
1506418752,Billy Gene Is Marketing Offends The Internet,2,0,0,0,48,50
1506434236,Love What You Love,0,0,0,0,6,6
1506436093,The Commercial Break,0,0,0,0,10,10
1506438521,"Stop Scrolling, Start Sewing",1,0,0,0,4,5
1506441329,Lessons Learnt with the Greats,0,0,0,1,1,2
1506469669,Making Sense,0,0,0,0,14,14
1506479205,Cousins By Blood,27,5,5,4,58,99
1506481900,Mr Charlton’s Audio Stories,0,0,0,0,17,17
1506494706,Bourbon & Banter,0,0,1,1,11,13
1506496647,Jazz Focus,0,0,0,0,1,1
1506501256,Imagine a Place,0,0,0,0,14,14
1506503059,Flusterclux With Lynn Lyons: For Parents Who Worry,0,0,0,0,23,23
1506524886,"Better Men, Better Ballplayers",0,0,0,0,1,1
1506525565,OT: The Podcast,0,0,1,0,8,9
1506563333,Saving Apollo 13 👨‍🚀,0,0,2,1,10,13
1506585676,The Stubborn Light of Things,0,0,0,1,14,15
1506607849,The Double Cleanse,2,1,0,0,197,200
1506615910,Spencer Berke Podcast,0,0,0,0,8,8
1506619717,Everything is Super Marvel,1,0,0,0,14,15
1506622356,Holding Court with Patrick McEnroe,0,0,0,0,27,27
1506622904,Conversations with Mike Milken,0,0,0,0,5,5
1506638053,The #EladPod,0,0,0,0,1,1
1506638299,"Dear Crochetpreneur® Podcast for Crochet Business Owners: Sellers, Designers, and Bloggers",0,0,0,1,6,7
1506640611,History of the Second World War,0,1,1,6,14,22
1506644304,Dog In The Yard,0,0,0,0,8,8
1506647422,21st Century Spielberg,0,0,1,1,21,23
1506654127,The Singing Success Show,0,0,0,0,1,1
1506661167,HYDRATE with Tracy Duhs,0,0,0,0,50,50
1506666354,Flour Hour Baking Podcast,0,0,0,1,4,5
1506666599,Radio Advisory,0,0,0,0,14,14
1506668751,Legal Talk Today,0,0,0,0,2,2
1506670499,Yoga Inspiration,0,0,0,0,26,26
1506676040,No Mercy: A Cobra Kai Kickback,1,0,0,0,4,5
1506676994,'The Wire': Way Down in the Hole,65,25,31,31,181,333
1506680847,Bawk Tawk! Welcome to Chickenlandia's 100% Friendly Chicken Show,0,0,0,1,3,4
1506683181,Glitter and Garbage,0,0,0,0,21,21
1506683386,The Slice,1,0,0,0,10,11
1506689528,Zoned Out Turf and Golf,0,0,0,0,1,1
1506689946,The Curious Competitor with Connor Carrick,0,0,0,0,16,16
1506779922,Flashback: History's Unintended Consequences,5,0,2,3,40,50
1506782444,The Way We Live Now,4,1,0,1,14,20
1506786262,Light House,5,8,4,7,26,50
1506805265,The Loud Boys,0,0,0,0,32,32
1506808834,Real_bitch_shit,1,0,0,1,4,6
1506811083,The Daytripper Podcast,0,0,0,0,2,2
1506814439,Freestylin Life And Swim,0,0,0,0,2,2
1506815544,Thomas & Friends™ Storytime (US),2,0,0,1,47,50
1506816225,Missing in Alaska,84,76,45,29,144,378
1506817736,Eric Krasno Plus One,0,0,0,0,27,27
1506821154,The Shack Show,2,1,1,0,12,16
1506830920,Startline,0,0,0,1,1,2
1506832307,"Magnum, podcast - revisiting ""Magnum P.I.""",0,0,0,1,6,7
1506834133,The Best of RSlash | Best Reddit Stories,2,1,4,1,9,17
1506835516,Coronavirus (COVID-19) Q&A,1,0,5,0,8,14
1506835710,The DFD Podcast: Live From Sunset Sound,0,0,0,0,3,3
1506839151,The Style Files: Conversations with Creatives,3,1,1,4,36,45
1506843615,La Pizarra con Nicky Mondellini,0,0,0,0,1,1
1506846872,The Office Grunts,0,0,0,0,3,3
1506858064,LOLz : A DFS Show,0,0,0,0,2,2
1506868183,Don Juan’s of Dynasty,0,0,0,0,5,5
1506906961,Everyday Māori,1,0,0,1,3,5
1506931432,Life Coaching for Women Physicians,0,0,0,0,50,50
1506933027,"The Sexiest Voice ASMR - Erotic Audio For Women, Romance Novels, Erotic Stories, Erotica And Much Mo...",14,0,1,0,1,16
1506945324,Devin Townsend Podcast,0,1,0,0,24,25
1506945879,Empowering Industry Podcast - A Production of Empowering Pumps & Equipment,0,0,0,0,15,15
1506955575,Greatest Music of All Time,0,0,0,0,1,1
1506959744,6th and Jump,2,0,1,0,70,73
1506965494,The Critical Care Obstetrics Podcast,0,0,0,0,7,7
1506974014,Kon-tiki Podcast,0,0,0,0,1,1
1507007339,Dig & Swing,0,0,0,0,1,1
1507011207,ENigmas unCHAINED,0,0,0,0,1,1
1507022247,Beneath The Grandstand,0,1,0,0,3,4
1507043026,The I/O Tower,0,0,0,0,1,1
1507051441,"Rig Doctor Podcast: Tone Tips, Pedalboard Tricks, & Easy DIY Hacks",1,0,0,0,2,3
1507067688,MTV Challenge Accepted,2,0,0,1,8,11
1507116817,The Briefing,2,4,7,7,54,74
1507122938,What The Flip Podcast,0,0,0,0,1,1
1507148315,Katherine Ryan: Telling Everybody Everything,16,5,7,6,162,196
1507196347,The Sociology Show,0,0,0,0,2,2
1507202428,Gardening Utah Podcast,0,0,0,0,1,1
1507241783,YHH Hockey Podcasts,1,0,0,0,3,4
1507242785,Plantopia,0,0,0,0,1,1
1507249060,Girl Why,0,0,0,0,50,50
1507249383,Open Question,0,0,0,3,54,57
1507254355,Cinema 9,0,0,0,0,10,10
1507265432,TheWrap-Up,0,1,0,0,2,3
1507271234,The Forza Napoli Calcio Podcast,0,0,0,0,5,5
1507276251,"Hope, Through History",6,3,3,1,37,50
1507293016,Diet Disruptors Podcast,0,0,0,0,6,6
1507293907,Masters of Scale: Rapid Response,0,0,0,0,13,13
1507302667,World of Warbirds,0,0,0,0,3,3
1507329859,Jocko Unravelling,1,0,0,1,48,50
1507349475,The Jboy Show,2,0,1,0,23,26
1507407651,AJFF In Conversation: The Jewish Film Podcast,0,0,0,0,1,1
1507408404,Millionaire Secrets,0,0,0,0,8,8
1507413433,I Will Write Your Book,0,0,0,0,30,30
1507414129,The Caddie Network Podcast,0,0,0,0,6,6
1507420302,Bedtime Stories for Adults,2,0,0,0,4,6
1507420814,Wealthy Mom MD Podcast,0,0,0,0,23,23
1507423923,Rabbit Hole,12,9,9,6,87,123
1507425010,The Daily Shine,0,0,0,0,23,23
1507433269,Clean Comedy Time,0,0,0,1,5,6
1507435921,PorterFlute Pod,0,0,0,0,4,4
1507444393,X22 Report,44,4,3,5,185,241
1507446314,Shout! A football podcast on the Buffalo Bills with Matt Parrino and Ryan Talbot,0,0,2,0,32,34
1507467528,InsideEVs - Electric Vehicle News,0,0,0,1,0,1
1507468902,Just Trek Podcast,0,0,0,0,10,10
1507469180,Lady Don't Take No,0,0,0,1,65,66
1507477014,The Beers on Heads Pod,0,0,0,0,1,1
1507481039,Let's Do Life with Autumn Calabrese,2,1,1,3,43,50
1507502534,Hot Takes & Deep Dives,15,3,2,2,158,180
1507539214,Smith and Sniff,0,2,0,0,11,13
1507570457,The Teaching Behavior Together Podcast,0,0,0,1,3,4
1507574218,Hypnosis for Permanent Weight Loss,0,0,1,0,11,12
1507612020,Garden Basics with Farmer Fred,0,0,0,0,18,18
1507621076,Tech Won't Save Us,0,0,0,0,4,4
1507673502,The ION Pod,1,0,1,0,7,9
1507675711,Total Skin Nerds: Your Appt with the World’s Top Derms & Docs,0,1,0,0,3,4
1507694609,On Deez Hoes,1,0,0,0,11,12
1507699163,One Piece D&D,0,0,1,0,29,30
1507706346,Built To Birth,0,0,0,0,12,12
1507712213,BAPS Better Living,0,0,0,0,7,7
1507714387,Surveillance Report,0,0,0,0,2,2
1507722004,Town,0,0,0,0,5,5
1507742759,"From Tip to Tail, a Podcast Dedicated to Animal Welfare",0,0,1,0,12,13
1507758896,The Divorce Club,0,0,0,0,3,3
1507787035,THE MOM CAST,0,0,0,0,4,4
1507787405,Talk Nasty to Me,1,0,1,1,196,199
1507796048,Killing Eve: Post Show Recaps,1,0,1,0,1,3
1507796551,Watch With Jen,0,0,0,0,4,4
1507803861,Design is Everywhere,0,0,0,0,7,7
1507806575,What's a Grip?,0,0,0,0,6,6
1507809649,Blue Collar Zen,0,0,0,0,3,3
1507811918,The Best Advice Show,0,0,0,1,49,50
1507819011,Bible Brothers,0,0,0,0,39,39
1507827503,Serch Says,0,0,0,0,1,1
1507831868,The Negro Baseball Leagues - Chattin' With The Legends with Byron Motley,0,0,0,0,4,4
1507832825,Time To Say Goodbye,0,0,0,1,14,15
1507834679,Triple Click,19,10,10,8,73,120
1507839530,POPlitics,5,0,0,0,45,50
1507846173,Pelvic PT Rising,0,0,0,0,23,23
1507890204,"The Lights, Camera, Pro! Podcast",0,0,0,0,17,17
1507895729,The Deliberation with Jacquis Neal and Rae Sanni,2,0,0,1,52,55
1507920724,Spirituality,0,2,0,0,10,12
1507968100,Fort Salem Witching Hour,0,0,0,0,10,10
1507973577,Cracking One Health,0,0,0,0,1,1
1507975080,Road Dog Podcast,0,0,1,2,35,38
1507979834,The Jeff Ward Show,0,0,0,0,15,15
1507980282,Lab in the Time of Coronavirus,0,0,0,0,3,3
1507980417,Julie’s Library,0,0,3,5,42,50
1507987834,Humorous Mathematics,1,0,0,1,2,4
1507993475,Let's Get Technical,0,0,0,2,11,13
1507997770,Primus Tracks,0,0,0,0,31,31
1507999599,Nailed It Ortho,0,0,0,0,19,19
1508006520,WHERE’S WALLO267,0,0,0,0,18,18
1508013775,NATAL,1,0,0,0,34,35
1508021574,Wording is Hard,0,0,0,0,3,3
1508028250,Cake for Breakfast,2,1,0,0,91,94
1508029296,The Choir Room: A Glee Podcast,0,0,0,0,34,34
1508030596,Customer Service Revolution,0,0,0,0,1,1
1508033807,There Is Always A Way with Dr. Jay Strack,0,0,0,0,21,21
1508034109,Interracial Relationships,0,0,0,0,1,1
1508034707,Dog in the Spotlight,0,0,0,0,4,4
1508034918,The Waxing Podcast,0,0,0,1,24,25
1508035189,The LA Report,0,0,0,0,1,1
1508071924,DarbyCast,0,0,0,0,32,32
1508075065,Closer Look with Rose Scott,0,0,0,1,4,5
1508082483,The North Texas Gardener,0,0,0,0,7,7
1508094957,LIW Anthology Series Review,1,0,0,0,0,1
1508098400,Murder With My Husband,1,0,2,6,215,224
1508115704,OceanPoddy,0,0,0,0,2,2
1508122332,Philosophy of Psychoanalysis,0,0,0,0,3,3
1508131098,Homeschool History,0,0,0,2,40,42
1508158975,Jalen & Jacoby - The Aftershow,0,0,0,0,2,2
1508177311,Brawl On - A Brawl Stars Podcast,2,0,1,1,19,23
1508186490,Heroics,0,0,0,0,12,12
1508201757,ETF Edge,0,0,0,1,6,7
1508202790,The New Abnormal,48,27,38,36,351,500
1508218598,Outrageous Love the Podcast: Our Journeys to Responsiveness,0,0,0,0,2,2
1508223763,For Fact's Sake! Podcast,0,0,1,0,49,50
1508234740,Barrel Racing,1,0,0,1,3,5
1508237021,"Coach P's Perspective | Where Coaching, Inspiration, and Faith Collide.",0,0,0,0,64,64
1508243662,Bigwater Fishing with Ross Robertson,0,0,0,0,1,1
1508243785,Hebrew School,0,0,0,0,4,4
1508244785,The Dog Show,0,0,0,0,1,1
1508245322,Profit Answer Man: Implementing the Profit First System!,0,0,0,0,5,5
1508247726,Trailer Trashing,0,0,0,0,62,62
1508264897,Inside the Wires | Platform Tennis and Paddle podcast,0,0,0,0,3,3
1508351023,"Good Morning, Kids",0,0,0,0,4,4
1508367753,NESN Bruins Podcast,0,0,0,0,1,1
1508390381,All Things Gymnastics Podcast,0,1,0,1,9,11
1508393084,Basketball Journeys,0,0,0,0,3,3
1508399270,Cut the Craft,0,0,0,0,22,22
1508422144,The Joe Beaver Show,0,0,0,0,1,1
1508426239,Not At The Dinner Table,0,0,0,0,2,2
1508443909,Unpack ‘n Bounce Back,3,0,0,3,473,479
1508454456,The Mermaid and The Lion,0,2,1,1,39,43
1508455193,Movie Therapy with Rafer & Kristen,0,1,1,4,87,93
1508462223,The BBR Podcast,0,0,0,0,7,7
1508522747,True Spies: Espionage | Investigation | Crime | Murder | Detective | Politics,8,4,11,11,87,121
1508544490,Beyond The Ring,1,2,0,0,24,27
1508549519,I Married a Weeb - Anime Podcast,0,0,0,0,1,1
1508552713,James Acaster's Perfect Sounds,0,0,0,0,13,13
1508572777,The Long Thread Podcast,0,0,0,0,2,2
1508585135,The Grant Williams Podcast,0,1,1,0,98,100
1508609486,No Nonsense Catholic,0,0,0,0,2,2
1508614133,The Sheridan Tapes,0,0,2,0,17,19
1508617743,Steve Stine Guitar Podcast,0,0,0,0,10,10
1508623013,Ladies Let's Talk About Sex,0,0,0,0,1,1
1508627690,Full Impact: A Neon Genesis Evangelion Exegesis,0,0,0,0,2,2
1508666561,From The Jingweeds,0,0,0,0,2,2
1508680599,Sydney Sloth's Bedtime Stories (Lectio Divina for Kids),0,0,0,0,1,1
1508718451,Making Stitches Podcast,0,0,0,0,1,1
1508721102,DJ Ravish Remixes,0,0,0,0,2,2
1508768336,Hushlife Podcast,0,0,0,0,21,21
1508773996,Growing With It,0,0,0,0,1,1
1508776656,Cinematic Heartland: A Filmmaking Podcast,0,0,0,0,2,2
1508788886,Tales From A Gemini,0,0,0,0,4,4
1508803043,Girl Gang Craft The Podcast,0,0,0,0,21,21
1508809928,The Real DNA Podcast,0,0,0,0,2,2
1508820684,Crew 1st Culture Podcast,0,0,0,0,5,5
1508820894,The Poco a Poco Podcast with the Franciscan Friars of the Renewal,1,1,0,2,496,500
1508835305,Armbar Audio,0,0,0,0,1,1
1508853028,Living By The Lore,0,0,0,0,1,1
1508892492,The Actual Astronomy Podcast,0,0,0,0,3,3
1508898501,Modern Miss Mason,0,0,0,0,49,49
1508914142,Slo Mo: A Podcast with Mo Gawdat,0,2,0,0,52,54
1508917484,The One Minute News with Derek O'Shea,0,0,0,0,13,13
1508927190,Matt and Alex - All Day Breakfast,3,0,0,3,87,93
1508930770,The Church Boys,0,0,0,0,3,3
1508932075,It's Not Just In Your Head,1,0,0,0,8,9
1508946017,Inherited,1,1,0,0,22,24
1508967644,Phoenix Cast,0,0,0,1,4,5
1508985962,Grounded with Louis Theroux,8,8,4,16,364,400
1508992867,Talking Politics: HISTORY OF IDEAS,0,1,1,1,50,53
1509030561,Talking All the Things with Grace,0,0,1,0,1,2
1509032518,Safari Stories,0,0,0,0,3,3
1509054125,Creative Conversations with Suzy Menkes,0,0,0,0,7,7
1509059063,NOQ Report,0,0,0,0,4,4
1509061352,The Fairy God Barber,0,0,0,0,1,1
1509074854,The Trey Gowdy Podcast,3,0,2,1,44,50
1509075849,Banned Biographies,0,0,0,0,4,4
1509077272,I Have Notes,0,1,0,0,3,4
1509092730,Economics & Beyond with Rob Johnson,1,3,0,0,8,12
1509106272,The Dharius Daniels Podcast,1,0,0,1,80,82
1509124376,Profit First Nation,0,0,0,1,17,18
1509138429,Corvette Today!,0,0,0,0,4,4
1509140101,Blk Pod Collective: The Podcast,0,0,0,0,26,26
1509144704,The Laughing Couple,0,0,0,0,19,19
1509183042,Deep Dive Dynasty Podcast,0,0,0,0,1,1
1509202063,The Ars Amorata Podcast,0,0,0,0,2,2
1509210702,Quran for All Seasons,0,0,0,0,13,13
1509214627,Two Pints with Will & Ralf,2,1,3,4,153,163
1509226583,Block In The Back: Dynasty Fantasy Football,0,0,0,0,4,4
1509235234,Making Fun of MacGyver,0,0,0,0,1,1
1509241243,Biblical Genetics,0,0,0,0,2,2
1509249324,Genetic Drift,0,0,0,0,4,4
1509260445,The Urban Lab,0,0,0,0,12,12
1509261864,"This Podcast is Making Me Thirsty (The ""Place to Be"" for Seinfeld fans)",0,2,0,0,4,6
1509269608,LA MAGIA DEL CAOS con Aislinn Derbez,0,1,1,0,28,30
1509275011,Kasher vs Kasher,0,0,0,0,5,5
1509276485,The Founder's Journal,2,0,0,0,131,133
1509290866,Molecule to Market: Inside the outsourcing space,0,0,0,0,4,4
1509291370,Ask Dr. Ben,0,0,0,0,29,29
1509294531,Inside-Out,0,0,0,0,1,1
1509296338,Being Planful,0,0,0,0,5,5
1509307460,Wind of Change,36,23,31,17,188,295
1509308798,Closening with Jessie Kahnweiler,0,0,0,0,1,1
1509311279,Brake Check,0,0,0,2,27,29
1509323322,Stay Human,1,0,1,0,32,34
1509330635,WBFO Brief,0,0,0,1,2,3
1509331826,Gay Card Revoked,0,0,0,0,9,9
1509337661,This Is Palestine,0,0,0,0,7,7
1509346585,Learnings from Leaders: the P&G Alumni Podcast,0,0,0,0,15,15
1509360076,Don't Be Ugly,0,0,0,0,2,2
1509363651,The Insert Credit Show,0,0,0,0,48,48
1509376531,United Basketball and Leadership Podcast,0,0,0,0,22,22
1509476734,Titillating Stories,2,0,0,1,1,4
1509495701,18Forty Podcast,0,0,0,0,17,17
1509502591,On The Pond,0,0,0,0,6,6
1509509021,Food Freedom Podcast,0,0,0,0,14,14
1509526556,The New Generation Entrepreneur Podcast,0,0,0,2,90,92
1509537727,Facing It,0,0,0,0,4,4
1509543583,I'm Losing It! with Brian Krock,0,0,0,0,15,15
1509561884,TEDx SHORTS,0,0,0,0,7,7
1509573353,Bastard Radio,2,0,0,1,47,50
1509587394,Fancy Scientist: A Material Girl Living in a Sustainable World,0,0,0,0,3,3
1509599014,The ABMP Podcast | Speaking With the Massage & Bodywork Profession,0,0,0,0,4,4
1509599164,ARE WE ON AIR ?,0,0,0,0,17,17
1509638793,K9 Aptitude,0,0,0,0,16,16
1509703697,Baby-Led Weaning Made Easy,0,0,0,0,50,50
1509724432,North American Missions UPCI,0,0,0,0,1,1
1509730329,The Showtime Podcast with Lakers Legend Coop,0,0,0,0,22,22
1509749824,Dynasty Hotsauce Podcast,0,0,0,0,3,3
1509765016,Trek Untold: The Star Trek Podcast That Goes Beyond The Stars!,0,0,0,0,6,6
1509768737,Ramen Hunter,0,0,0,0,1,1
1509769101,The Owlsteins,0,1,0,0,9,10
1509773163,Big Lists,0,0,0,0,4,4
1509776802,Going to Bed with Garcelle,0,0,0,0,50,50
1509779016,All Ears with Abigail Disney,1,0,0,0,7,8
1509792131,More Than Running with Dana Giordano,0,0,0,0,4,4
1509793326,The Squidge Rugby World Cup Retrospective,0,0,0,0,1,1
1509798709,Name Drop San Diego,0,0,0,0,8,8
1509799955,Physics After Hours,0,0,0,0,1,1
1509800617,The Human Experience,0,0,0,0,4,4
1509836398,Duel of the Fates,0,0,1,0,5,6
1509862898,Real Talk with Pastor Rema,0,1,0,0,3,4
1509863670,Teens Talk,1,0,0,0,0,1
1509872385,Tales of Space: Noksvale Moon,0,0,0,0,2,2
1509884894,The Oklahoma Breakdown with Ikard and Lehman,2,0,3,0,87,92
1509892361,The Fill with Phil Podcast,0,0,0,0,6,6
1509965103,My Favorite Friendship,0,0,0,0,3,3
1509990900,Let's Go Together,0,0,0,1,20,21
1509993910,Thrilling Tales of Modern Capitalism,3,0,0,1,6,10
1510010481,Keep It Locked With Simon Hill,0,0,0,0,1,1
1510016468,It Starts With Attraction,0,0,1,2,47,50
1510026530,Tama's Island,2,0,2,1,38,43
1510027046,During The End Phase - A Yu-Gi-Oh Podcast,1,0,0,1,6,8
1510056899,No Stupid Questions,8,7,8,10,137,170
1510061193,On the Step with thatmallardguy,0,0,0,0,32,32
1510063326,Conversations with Big Rich,0,0,0,0,3,3
1510091672,The Juicy Hour with Nene,0,0,0,0,3,3
1510121292,NWCZradio's Down The Rabbit Hole,1,0,0,0,20,21
1510123754,MARK CROSSFIELD GETTING STUCK INTO GOLF,0,0,0,0,8,8
1510124746,In Moscow's Shadows,0,0,0,0,6,6
1510134890,Off Topic with Tom Arnold,1,0,1,0,12,14
1510135763,The RC Hangout,0,0,0,0,8,8
1510139224,The Balanced Parent Podcast,0,0,0,0,12,12
1510142364,A Touch More with Megan Rapinoe & Sue Bird,0,0,0,0,23,23
1510164143,Can't Stop Watching,0,0,1,0,13,14
1510167745,Dirty Giants,0,0,0,0,3,3
1510168933,Legendary Mindset,0,0,0,0,2,2
1510176165,Just Trust Us,0,0,0,0,1,1
1510179210,The Alphabetical Fugazi,0,0,0,0,10,10
1510217375,Eidolon Playtest,0,0,0,0,8,8
1510235310,Top Landing Gear,0,0,0,0,1,1
1510235989,Stacking Slabs,0,0,0,0,16,16
1510239526,Michael Jackson: Unspun,0,0,0,2,4,6
1510240831,The MeidasTouch Podcast,1,1,1,3,44,50
1510248182,The WILDCAST,0,0,0,0,50,50
1510250998,Trey and Kevin Change the World,0,0,0,0,4,4
1510251497,Rob Beckett and Josh Widdicombe's Lockdown Parenting Hell,6,4,0,8,482,500
1510254570,6 Ranch Podcast,0,0,0,0,9,9
1510267532,4th Line Voice Podcast,0,0,0,0,4,4
1510271104,IS THIS ON?,0,0,0,0,1,1
1510274772,Ho Ho Hong Kong,0,0,0,0,15,15
1510277822,Learn Spanish and Go,0,0,0,1,30,31
1510289401,I Think We're Good Here: Volleyball Podcast,0,0,0,0,8,8
1510331947,ROHStrong Podcast,0,0,0,0,3,3
1510363127,Until All Are Free,0,0,0,0,35,35
1510365500,Motive for Murder,22,32,38,12,80,184
1510380637,The HomeKit Show,0,0,0,1,2,3
1510415610,Field of Vision Sports - Fantasy Football & Baseball Podcast,0,0,0,2,239,241
1510419423,Rise Through Style,0,0,0,0,23,23
1510423200,724 STG: Insight Thru Experience Podcast,0,0,0,0,2,2
1510424100,The Rabbi's Husband,0,0,0,0,4,4
1510430194,Cooking In Mexican From A to Z,0,0,1,1,5,7
1510449533,East2West_WLS: The Podcast,0,0,0,0,11,11
1510453081,Experimental Aircraft Channel's Podcast,0,0,0,0,1,1
1510464423,The Epic Order of the Seven - The Podcast,0,0,0,0,4,4
1510466962,Lab Notes,0,0,0,0,1,1
1510469396,Final Gravity,0,0,0,0,1,1
1510471758,Second Serve Tennis,0,0,0,0,17,17
1510472957,Spooky Science Sisters,0,0,0,0,6,6
1510485046,The Road to Medical Sales Podcast,0,0,0,0,50,50
1510515030,The Johanna Konta Podcast,0,0,0,1,0,1
1510526299,Tribe of Hackers Podcast,0,0,0,0,3,3
1510572442,Cyclist Magazine Podcast,0,0,0,0,1,1
1510581518,Five Questions,0,0,0,0,1,1
1510581764,The PathPod Podcast,0,0,0,0,9,9
1510582080,Truth vs Hollywood,6,9,7,9,69,100
1510587218,Waldy and Bendy's Adventures in Art,0,0,0,0,13,13
1510604046,The Scope of Practice Podcast,0,0,0,0,55,55
1510604439,The Eddie Jones Coaching Podcast,0,0,0,0,1,1
1510608498,Homemade,1,0,2,4,40,47
1510610914,Lark: Fallen Gods,0,0,0,0,16,16
1510617981,The Sarah Scoop Show,0,0,1,0,2,3
1510623465,The Dissenters with Debra Messing and Mandana Dayani,22,1,2,0,123,148
1510623480,Biscuits & Jam,0,0,0,1,39,40
1510625488,Get Tucked!,0,0,0,0,6,6
1510629695,Heated,0,0,0,0,1,1
1510633468,Kickin' Back,0,0,0,0,13,13
1510635988,PODCAST-19: FiveThirtyEight on the Novel Coronavirus,5,2,3,5,20,35
1510638084,Team Deakins,2,0,0,3,55,60
1510639221,Beverly Hills 90210 Show,2,1,3,1,30,37
1510639391,The Outer Reach: Stories from Beyond,0,1,0,1,18,20
1510643681,"The Hat-Trick, presented by the ICC",0,0,0,0,18,18
1510644457,Beaver State Podcast,0,0,0,1,8,9
1510644467,The Last Looks Podcast,0,0,0,0,12,12
1510645180,Annie and Eddie Keep Talking,2,2,1,1,494,500
1510645597,Free Email List Building Course with Jenna Kutcher,0,0,0,0,2,2
1510649799,Media Roundtable,0,0,0,0,3,3
1510654902,The Directors Box  |  A Football Business Podcast,0,0,0,0,1,1
1510664120,Son of a Hitman,26,4,9,4,22,65
1510668009,Fox News Rundown Evening Edition,0,1,0,0,0,1
1510671938,The RAF and Backcountry Flying,0,0,0,0,1,1
1510686946,Down The Line,0,0,0,0,5,5
1510697412,The Relaxed Dog,0,0,0,0,3,3
1510718251,The Open Podcasts,0,0,0,0,52,52
1510728368,In Bad Taste,0,0,0,0,9,9
1510749650,The Pursuit of Outdoor Clues,0,0,0,0,5,5
1510757354,The Run Healthy Podcast,0,0,0,0,7,7
1510768639,Enough Wicker: Intellectualizing the Golden Girls,0,0,0,0,15,15
1510772995,Do Your Crap,0,0,0,1,42,43
1510777741,FactSet U.S. Daily Market Preview,0,0,0,0,2,2
1510778585,Girl At The Game,1,0,0,1,20,22
1510783723,Roger Moore's Cubby Hole,0,0,0,0,4,4
1510793933,One Visit Away,0,0,0,0,40,40
1510801583,TAC Right Now,1,1,1,1,7,11
1510802808,How'd You Do It?,0,0,0,0,14,14
1510815694,DumpStat - A D&D Podcast,0,0,0,0,3,3
1510820647,MMA UNCENSORED,0,0,0,0,19,19
1510820746,Just Being ERNEST,0,0,0,0,21,21
1510831562,Movies That Changed My Life,0,0,3,0,50,53
1510832806,Professional Weaver Podcast,0,0,0,0,3,3
1510837889,The Keys To The Kingdom,0,0,0,0,4,4
1510840337,Interdependence,0,0,1,0,3,4
1510842451,Shank Happens,2,0,0,0,76,78
1510842862,My Jewish Parents,0,0,0,0,2,2
1510853470,Chris Chan: A Comprehensive History,0,0,0,0,4,4
1510861233,30 Minutes to President's Club | No-Nonsense Sales,0,0,0,1,49,50
1510862926,Can You Survive This Podcast?,2,2,1,2,21,28
1510881120,Fertility Education,0,0,0,0,13,13
1510926198,Scaredy Cats,0,0,0,0,1,1
1510963695,The Destination Angler Podcast,0,0,0,0,1,1
1510975732,Talking Sleep,0,0,0,0,4,4
1510976757,The Online Business Show,0,0,0,0,62,62
1510978437,Legends Never Die,2,1,0,1,3,7
1510981488,Radio Headspace,5,0,2,6,34,47
1510984356,Moldcast,0,0,0,0,3,3
1511011050,On The Journey Conversations,0,0,1,2,25,28
1511035793,Meant For This,0,0,0,0,18,18
1511040757,Pretty Soul,0,0,0,0,7,7
1511046507,God Hears Her Podcast,0,1,0,3,127,131
1511047964,Control the Controllables,0,0,0,0,7,7
1511050225,Let's Talk About Cool Animals!,0,0,0,0,18,18
1511057761,The Boulet Brothers' Creatures of the Night,0,0,0,0,105,105
1511058574,Ink & Paint: A Journey Through the Disney Animated Classics,1,0,0,0,1,2
1511061614,Sowing and Reaping Audio Podcast,0,0,0,0,1,1
1511086572,Break the Diet Cycle,0,0,0,0,12,12
1511098925,POP ART,0,0,0,0,4,4
1511113080,Story time for Kids,0,1,0,0,4,5
1511113374,Get Some with Gary Owen,0,0,0,0,11,11
1511121397,That UFO Podcast,0,0,1,0,16,17
1511124427,To The Pen,0,0,0,0,1,1
1511158172,KPMG Financial Reporting Podcast Series,0,0,0,0,1,1
1511167286,Out and Back,1,1,2,1,33,38
1511191961,The Daily Smile,3,2,3,4,131,143
1511202808,DODReads: What are you reading?,0,0,0,0,21,21
1511214890,Living with Reality with Dr. Robert Svoboda,0,0,0,0,2,2
1511223976,Vertical Farming Podcast,0,0,0,0,4,4
1511226621,Millennial Life Crisis,5,2,3,4,86,100
1511237036,This Is Not A Cult Podcast,0,0,0,1,16,17
1511330712,From Rock Bottom to Rockin' It,1,0,0,1,15,17
1511349427,Liquor and Liqueur Connoisseur,0,0,0,0,2,2
1511351502,No Doubt: A Shin Buddhist Approach,0,0,0,0,1,1
1511353017,Spanish to English,1,0,0,0,3,4
1511353580,TheSync Podcast,1,0,1,1,281,284
1511359658,Next Shift - More Than A Hockey Podcast,0,0,0,0,24,24
1511388970,The History Of European Theatre,0,0,0,0,3,3
1511417277,We're Listening: A Frasier Podcast,0,0,0,0,10,10
1511419117,The Colion Noir Podcast,1,0,1,3,81,86
1511420962,How'd She Do That?,1,0,0,0,22,23
1511423234,TommyInnit Life Lessons,2,0,0,0,22,24
1511426315,Dynasty Addicts Podcast Network,0,0,0,0,8,8
1511456063,The Delta Flyers,2,3,4,9,115,133
1511457901,Laidlaw's Harley-Davidson,0,0,0,1,11,12
1511470624,The Valorant Show,0,0,0,0,53,53
1511485972,MoneywebNOW,0,0,0,1,7,8
1511486861,Inspire To FIRE Podcast (Financial Independence Retire Early),1,0,0,1,21,23
1511490913,Cat Chronicles,0,0,0,0,1,1
1511493299,Scarlett Moffatt Wants to Believe,4,0,0,2,71,77
1511497482,PSI/Persona,0,0,0,0,3,3
1511526418,ASCP Esty Talk,0,0,0,0,3,3
1511548993,News Du Jour,0,0,0,0,12,12
1511567639,JOANNA BECK PODCAST,0,0,0,0,14,14
1511576665,Okashi Na Podcast: Anime With Friends!,0,0,0,2,2,4
1511588213,State of Demand Gen,0,0,1,0,11,12
1511614931,Good in Theory: A Political Philosophy Podcast,0,0,0,0,8,8
1511633648,"Dom's Club: Film, TV, Comedy & Books with Dominique Mobley",0,0,0,0,1,1
1511640923,Two Funny Mamas,2,1,1,2,124,130
1511655379,Sick Empire,0,0,0,0,31,31
1511658074,Alicast,0,0,0,0,50,50
1511739170,JuHeardMe,0,0,0,0,15,15
1511755585,Not Invisible: Native Womxn on the Frontlines,0,0,0,0,5,5
1511794096,The ADHD Good Life Podcast,0,0,0,0,10,10
1511794520,Inside the Wolf’s Den an Entrepreneurial Journey with Shawn and Joni Wolfswinkel,0,0,0,0,2,2
1511796352,RomComPods,4,1,3,3,39,50
1511802512,"Send Me To Sleep Podcast - World's Sleepiest Stories, Meditation & Hypnosis",1,0,4,6,39,50
1511805380,Instagram Insider Hacks,0,0,0,0,50,50
1511824849,Nature Centered from Wild Birds Unlimited,0,0,0,0,17,17
1511827218,The blondEST,2,0,0,0,198,200
1511834329,Hoot & a Half with Matt King,4,7,3,4,32,50
1511838454,Instrumental with JJ Heller,0,1,0,0,161,162
1511838803,Podraculous: A Miraculous Ladybug Podcast,0,0,0,1,0,1
1511842652,One Bell Trader Joe's,0,0,1,0,0,1
1511872914,SLASH HER,0,0,0,0,4,4
1511874445,This Universe,0,0,0,0,1,1
1511877009,Mindfulness for Kids,0,0,0,0,1,1
1511878916,Ugh! You're So Good!,0,1,1,2,18,22
1511895229,The business of vulnerability,0,0,0,0,1,1
1511985679,You Are Not Alone w/ Spiritual Medium Erika Gabriel,3,0,0,1,44,48
1511993897,Package Design Unboxd - with Evelio Mattos,0,0,0,0,9,9
1512013782,Monster Fuzz,0,0,0,0,7,7
1512016028,Deep Sleep Sounds,4,1,1,5,32,43
1512021532,247Sports Football Recruiting Podcast,1,3,2,2,44,52
1512025497,Adventures in Quilting,0,0,0,0,3,3
1512032536,Talking Tennis Southern Style,0,0,0,0,1,1
1512036219,Baseball BBQ,5,3,1,4,31,44
1512090867,Plum Forest Podcast,0,0,0,1,10,11
1512092799,The Jets Way,0,0,0,0,9,9
1512102345,KnightSA89 - MidTempo Sessions Uploads,0,0,0,1,11,12
1512104137,Tori Dealing With,0,0,0,0,50,50
1512107382,WHY GACHA LIFE IS A TOXIC COMMUNITY,2,1,2,4,13,22
1512276867,Black & White & Read All Over: for Juventus fans,1,0,0,0,5,6
1512277474,Donuts and Devos,0,0,0,0,9,9
1512279025,Podcast Of The Planet Of The Apes,2,0,0,0,3,5
1512287199,Qanon FAQ,44,0,0,0,6,50
1512300461,A Sense of Well-Being with Shayna Taylor,0,0,0,1,13,14
1512313331,AA Big Book Workshop,0,0,0,0,5,5
1512338578,Redditor,5,0,2,2,41,50
1512340672,Hop Culture,0,0,0,0,6,6
1512393903,The Ace Space,0,0,0,0,3,3
1512472564,We're Getting a Dog,0,0,0,0,1,1
1512473374,Hot and Rich,0,1,0,1,48,50
1512484964,B.M.W. (Black Millennial Women),0,0,0,0,20,20
1512490345,Fantastic Tales: A Bedtime Podcast for Kids,1,0,1,1,23,26
1512499760,Birdies & Bourbon,0,1,0,0,25,26
1512499997,"Learning to Surf - Talks on Buddhism, Dharma and riding the waves of life",0,0,0,0,1,1
1512500403,Breaking Balls with Emily Nyman,0,0,0,0,17,17
1512507900,Mile Marker,0,0,0,0,1,1
1512510969,Hard Men Podcast,3,0,0,0,26,29
1512537188,Fantasy Golf Pod,1,0,0,0,27,28
1512546569,Dare To Be,0,2,0,1,52,55
1512546904,Equip and Empower with Christine Caine,0,0,0,0,5,5
1512551828,Hey It's The Luskos,0,2,0,1,42,45
1512582252,FIREFIGHTER AND EMS STORIES,0,0,0,0,2,2
1512585839,The Secret Adventures of Black People,0,0,0,0,18,18
1512600700,AEW Uncensored Podcast,1,0,0,0,8,9
1512600944,The Mrs. Bush's Story Time Podcast,0,0,0,0,2,2
1512605962,The Wayward Pilot Podcast,0,0,0,0,7,7
1512610218,The Grunge,0,0,1,0,5,6
1512615438,Acid Horizon,0,0,0,0,4,4
1512654905,The Defiant,0,0,0,0,2,2
1512655909,The Happy Runner,1,0,0,0,0,1
1512658098,The Plant Nook,0,0,0,0,3,3
1512670962,Science + God with Dr. G,0,0,2,0,13,15
1512674737,Where We Live,0,0,0,0,9,9
1512675323,Genuine JBH,0,0,0,0,4,4
1512683338,Quarantine Creatives with Heath Racela,0,0,0,0,9,9
1512702672,Quality Queen Control,0,0,1,1,18,20
1512706358,Print Design Podcast,0,0,0,0,12,12
1512721188,The HC Insider Podcast,0,0,0,0,17,17
1512764779,Global Health Pursuit,0,0,0,0,12,12
1512798720,The Program Podcast,0,0,0,0,4,4
1512822115,Committed to Create,0,0,0,0,174,174
1512837291,make joy normal:  cozy homeschooling,0,0,0,0,5,5
1512844649,The Kingcast,7,1,4,3,62,77
1512845730,Let's Vibe With It,0,0,0,0,10,10
1512847066,WHAT WENT WRONG,0,0,2,1,61,64
1512848110,Hot Takes With Matt Gaetz,46,0,3,1,377,427
1512861386,The Darin Olien Show,1,1,2,5,41,50
1512871821,The Direct Sales Podcast: the BEST advice from top leaders and coaches,0,0,0,1,7,8
1512874641,Hope in Darkness: The Josh Holt Story,17,15,26,8,51,117
1512881360,2PAC MUSIC PODCAST,0,0,0,0,1,1
1512891164,Let's Have a Drink - with Denver Sean,1,0,1,3,38,43
1512907291,Stand Up Comedy,0,0,0,0,1,1
1512908482,Ariana Grande,0,0,0,0,4,4
1512934794,We Are What We Eat: Pay The Farmer Not The Pharmacy,0,0,0,0,3,3
1512939444,The Tech Edit by Vogue Business,0,0,0,0,1,1
1512947875,People & Music Industry,0,0,0,0,1,1
1512960196,The Contact Sheet,0,0,0,0,20,20
1512968943,AMAPIANO PANDEMIC,0,1,0,0,8,9
1512982617,Learn Spanish Vocabulary (Cognates),0,0,0,0,1,1
1512983316,From the Woodshed,0,0,0,0,16,16
1513014547,The Devil's Music with Pleasant Gehman,0,0,0,0,9,9
1513070482,Boom/Bust: HQ Trivia,5,3,5,2,53,68
1513075859,Water Colors Aquarium Gallery,0,0,0,0,5,5
1513077596,The Humble U Podcast,0,0,0,0,6,6
1513081940,The Justin Moore Podcast,0,0,0,1,170,171
1513089125,The Non Essentials Podcast,0,0,0,0,1,1
1513102098,EMS 20/20,0,1,0,0,37,38
1513116308,(De eso no se habla),0,0,0,0,3,3
1513155901,The Nagging Naturalist,0,0,0,0,2,2
1513176599,The Proven Principles Hospitality Podcast,1,0,0,0,4,5
1513197489,CROSSNET Volleyball Podcast,0,0,0,0,15,15
1513202272,We Get Dubbed,0,0,0,0,10,10
1513213967,Wine 101,1,0,0,0,15,16
1513216353,Empire Building,0,0,0,1,68,69
1513222646,Greekly Speaking,0,0,0,0,1,1
1513231552,Spanish for Beginners Pedro,0,0,0,0,4,4
1513231788,Wisteria Gays | A Desperate Housewives Podcast,1,0,0,0,10,11
1513234081,Wrestle Buddies,0,0,0,0,10,10
1513237410,Citizen Chef with Tom Colicchio,3,0,1,1,27,32
1513250928,nesmith tork goffin & king,0,0,0,1,0,1
1513251211,Women Birders (Happy Hour),0,0,0,1,4,5
1513283009,Calm Kids,0,0,0,1,0,1
1513285647,What's Essential hosted by Greg McKeown,0,0,1,1,48,50
1513290707,Strong Men Strong Marriages,0,0,0,0,15,15
1513297026,The Korean Beauty Show Podcast,0,0,0,0,7,7
1513361283,Stand up comedy for everyone,0,1,0,0,1,2
1513388730,Vanity Lab,0,0,0,0,6,6
1513389544,Life of Coco Chanel,0,0,0,0,1,1
1513390324,Off The Mound with Ryan Dempster,1,0,0,0,1,2
1513391500,Cubs Weekly,0,0,0,0,4,4
1513392472,JR SportBrief,0,0,0,0,2,2
1513393349,Crazy Dog Lady Podcast,0,0,0,0,3,3
1513405224,Wong Notes,0,0,0,0,22,22
1513422232,Caribbean Cricket Podcast,0,0,0,0,1,1
1513430448,It Was Simple: The Betty Broderick Murders,43,35,31,25,49,183
1513430808,3ABN Sabbath School Panel,0,0,0,0,2,2
1513438033,Radio Chicken,0,0,0,0,1,1
1513442833,Everything Real Estate: Connecting Ideas With Action,0,0,0,0,7,7
1513460728,Tae & Todd Washington Football Podcast,0,0,0,0,8,8
1513477929,Behind the Bima,1,0,0,1,49,51
1513479877,Island Crime: Gone Boys,0,2,4,1,10,17
1513489117,Heaven Bent,0,0,0,0,4,4
1513500047,Dirty John Season 2: The Podcast,2,0,0,0,1,3
1513502656,Champions for HD Podcast,0,0,0,0,2,2
1513503484,Behind the Golf Brand Podcast with Paul Liberatore,1,1,0,7,191,200
1513507967,That's What Schur Said,0,0,0,0,1,1
1513529873,Purple Insider - a Minnesota Vikings and NFL podcast,2,3,1,1,105,112
1513553272,Spooked,2,0,0,0,3,5
1513602865,The Functional Breeding Podcast,0,0,0,0,6,6
1513630621,De Todo Un Mucho,1,0,0,0,20,21
1513632362,Thanks For Coming In,0,0,0,0,2,2
1513640702,Borrasca,1,2,0,3,44,50
1513645507,WWF: The Legacy Series,0,0,0,0,1,1
1513646861,You Tube,1,0,0,0,0,1
1513649875,The Superset,0,0,0,0,7,7
1513670059,Inside Joke: Space Force,0,1,0,0,4,5
1513671470,REACH A Space Podcast for Kids,0,0,0,1,15,16
1513701906,Any Given Monday,0,0,1,0,3,4
1513705349,Where Do I Start,0,0,0,0,7,7
1513720863,Wylde In Bed: Erotic Audio Stories at Bedtime,0,0,0,1,7,8
1513728098,Let's Talk,0,1,4,0,123,128
1513751855,Hollywood Party,0,0,0,0,17,17
1513759789,My Town,0,0,0,0,50,50
1513765512,The Prosecutors,12,6,3,9,364,394
1513783873,Transparency - The Podcast | w/ Eshon & Zara,0,0,0,0,8,8
1513788887,Mindful Moments for Families and Schools,0,0,0,0,3,3
1513789286,Get Hard! With Jaide Alicia,0,0,0,0,3,3
1513817377,The Collin Kartchner Podcast,2,0,0,0,48,50
1513824157,Left to Our Own Devices with Erica Keswin,0,0,0,0,19,19
1513824548,Tottenham Podspur,0,0,0,0,5,5
1513842328,Conversations with the Hostess,0,0,0,0,9,9
1513845007,BFDI - Bedtime Stories For Children,1,0,0,0,0,1
1513851432,Project Medtech,0,0,0,0,1,1
1513853437,Sports Performance Training,0,0,0,0,28,28
1513860930,The Fourth Messenger Podcast - Teachings and Art from the Sangha,0,0,0,0,1,1
1513903056,Recap and Gown,2,0,0,0,15,17
1513928504,Box 13,0,0,0,0,2,2
1513949547,Action Filmmaking Decoded- The Story of Action Films,0,0,0,0,6,6
1513949584,Prepare to Brace! The Snowpiercer Podcast by Pod Clubhouse,0,0,0,0,2,2
1513977522,We Need to Calm Down: a Taylor Swift Podcast,0,1,0,0,16,17
1514000241,Bottom Bracket Biking,0,0,0,0,5,5
1514009373,The Album Years,0,1,1,1,85,88
1514010062,Far Flung with Saleem Reshamwala,1,2,0,3,72,78
1514019509,Canis Hoopus: for Minnesota Timberwolves fans,0,0,0,0,4,4
1514030624,"NONSENSIBLE w/ Sam, Dave, and Saul",1,1,1,2,110,115
1514035625,Movies That Raised Us,0,0,0,0,12,12
1514038286,Prairieland Paranormal Podcast,0,0,0,1,8,9
1514043751,The Mikhaila Peterson Podcast,4,3,2,5,80,94
1514059210,Time Has Come,0,0,0,0,19,19
1514069529,Let's Talk - Movies,0,0,0,0,1,1
1514135597,Golf Under Par Podcast,0,0,0,0,3,3
1514141036,In Your Shoes With Mauro Porcini,0,0,0,0,4,4
1514175045,The U.S. Soccer Podcast,0,0,2,0,11,13
1514180523,Money 4 Nothing,0,0,0,0,3,3
1514201335,The Curious Clinicians,0,0,1,0,15,16
1514205605,Space Policy Pod,0,0,1,0,1,2
1514222573,The Aviation Spotters Podcast,0,0,0,0,3,3
1514228397,Imperfect Strangers,0,0,0,0,129,129
1514231064,Dr. GPCR Podcast,0,0,0,0,1,1
1514231439,The Next Stage,0,0,0,0,2,2
1514235382,Axios Today,23,14,11,8,89,145
1514252887,Xbox Empire,1,1,0,0,8,10
1514259866,Run Pure Sports DFS Pods,0,0,0,0,12,12
1514261284,The Tomorrowland Times Podcast,0,0,0,0,2,2
1514266254,Easy Peasy Finance for Kids and Beginners,0,0,0,0,1,1
1514309212,The Wakeup,0,0,0,0,7,7
1514325670,The Ten News,2,1,1,0,29,33
1514332833,Find Your Focus,0,0,0,1,98,99
1514349296,Speaking of Resilience,0,0,0,0,3,3
1514431779,Elite Week - Your American Elite Dangerous Podcast,0,0,0,0,5,5
1514460634,THE DARLING JOURNEY,1,0,0,0,28,29
1514486517,The Mistress Carrie Podcast,0,0,0,0,42,42
1514486702,"Husband Help Haven Podcast: Marriage Advice for Men Facing Separation, Affair or Divorce",0,0,0,0,7,7
1514489746,Two Sides of the Spectrum,0,0,0,0,6,6
1514510059,Beyond Solitaire,0,0,0,0,3,3
1514522005,Black History for White People,4,2,0,2,28,36
1514536280,Ultra Hope Girls: A Danganronpa Podcast,0,0,0,0,11,11
1514547852,The Yamcast,0,0,0,0,5,5
1514561839,DTC Podcast,0,0,0,0,1,1
1514565859,Nibblybits,0,0,0,0,18,18
1514607987,Horror Movie Crew Podcast,1,0,1,1,21,24
1514638013,There R Giants,0,0,0,0,4,4
1514642671,Wholesale Hotline,0,0,0,0,69,69
1514660485,"Real Money, Real Experts",0,0,0,1,5,6
1514662398,Everyday American English,0,0,0,0,1,1
1514680476,The Lo Life,0,1,1,3,495,500
1514681763,"Dear Diary, You're Effed!",1,0,1,0,72,74
1514682248,Laughing with Myself,0,0,0,0,24,24
1514694896,Modern Jewish Girl,0,0,0,0,13,13
1514696441,Good for a Weekend: A Taylor Swift Podcast,0,0,0,1,36,37
1514704765,La Oficina de Hoy,0,0,0,0,16,16
1514706044,I Quit ____ and Started Running,0,0,0,0,5,5
1514792212,The Official The Last of Us Podcast,1,0,0,0,49,50
1514812591,The New Craft House Podcast,1,0,0,0,0,1
1514814400,Shop Sounds Podcast,0,2,0,0,30,32
1514824294,The Trauma-Informed Lawyer hosted by Myrna McCallum,0,0,0,0,4,4
1514839782,The Golden Hour,0,0,0,0,5,5
1514844994,KristianUltra Trail Running Podcast,0,0,0,0,1,1
1514847247,How I F*ck,0,0,0,0,16,16
1514849865,All That Glitters,0,0,0,1,59,60
1514858786,Sex Stories by Audiodesires.com,0,0,0,0,2,2
1514860368,Dirt Rich,0,0,0,0,1,1
1514867862,Sorry We're Stoned with Tish & Brandi Cyrus,2,0,0,0,165,167
1514877650,Sunny Side Up Nutrition,0,0,0,0,4,4
1514889839,The Medical Sales Podcast,0,0,0,0,29,29
1514897753,Affirmation Kids,0,0,0,0,1,1
1514907838,I'm New Here: A Podcast for New Instructional Designers and E-Learning Developers,0,0,0,0,12,12
1514938838,"Past, Present, Future, Live!",0,0,0,0,8,8
1514948028,MIKED UP with Mike Woellert,0,0,0,0,13,13
1514949294,Planet Normal,1,0,0,0,9,10
1514957887,Preferred Lines Podcast,0,0,0,1,31,32
1514962810,The Open Seat,0,0,0,0,19,19
1514967645,Titan Upload Network,0,0,0,0,2,2
1514968525,Politicology,37,6,8,9,440,500
1514972297,But I Played One on TV,0,0,0,0,1,1
1514989021,Spill the Beans Podcast,0,0,0,0,4,4
1514994034,Overshare with Joslyn Davis & Lily Marston,0,0,1,1,21,23
1515008450,Talking Shtick,0,0,0,0,3,3
1515027050,F**kface,0,0,1,2,47,50
1515028740,Emotional Storytelling with Twyla Jones,0,0,0,0,25,25
1515029320,Hughes and Mincks: Ghost Detectives,0,0,0,0,2,2
1515033137,The Podcast by KevinMD,0,0,0,0,28,28
1515039084,#moldfinders: RADIO,0,0,0,0,13,13
1515042150,Seven Deadly Sinners,5,1,8,2,112,128
1515049774,Science Fiction Remnant,0,0,0,0,6,6
1515057059,The BUMP Podcast,0,0,2,2,17,21
1515060371,The Daily Study,0,0,0,0,2,2
1515060551,The Deep,0,0,0,0,3,3
1515070058,The Iced Coffee Hour with Graham Stephan,1,0,2,0,22,25
1515070645,You Can’t Disappoint a Podcast,0,0,0,0,3,3
1515095231,The Tap and Go,0,0,0,0,1,1
1515125475,Pod Sing Se: An Avatar The Last Airbender Podcast,0,0,0,0,6,6
1515133543,Cryptocurrency for Beginners: with Crypto Casey,0,0,0,0,4,4
1515148476,Back of the Shul,0,0,0,0,15,15
1515152489,Higher Learning with Van Lathan and Rachel Lindsay,28,1,4,0,466,499
1515158139,A Man on a Mattress who Watches Movies,0,0,0,0,3,3
1515160979,What Makes It Great?,0,0,0,0,1,1
1515162327,Conversations About Running,0,0,0,0,1,1
1515162816,Primas Chismosas,0,0,0,0,3,3
1515164436,Opening Weekend,0,0,0,0,14,14
1515169815,"Actually, It's Good",0,0,0,1,4,5
1515175286,EVERYNIGHTNIGHTS PODCAST,0,0,0,0,78,78
1515179631,The Company of the Mad: The Stand Podcast (Discussing The Stand by Stephen King in a Global Pandemic...,4,1,2,1,18,26
1515182828,Burst,0,0,0,0,5,5
1515214229,Refining Politics and Culture,4,0,0,0,99,103
1515215888,A Quilting Life Podcast,0,1,1,0,44,46
1515259703,Rise of the Divine Feminine,0,0,0,0,3,3
1515264934,Maximum Growth Live!,0,0,0,0,3,3
1515310869,Bulgogi Pod,0,0,1,0,32,33
1515341022,Autism Parenting Secrets,0,0,0,0,21,21
1515342765,Monday's With Mindy,0,0,0,0,15,15
1515349498,festivalPass Stories,0,0,0,0,5,5
1515370358,Doing It Different,1,0,0,0,49,50
1515373751,Real Food. Real Conversations.,0,0,1,1,21,23
1515385282,A Bit of Optimism,0,0,0,0,3,3
1515399726,50 Years of Music w/ 50 Year Old White Guys,0,0,0,0,23,23
1515399733,No Lie with Brian Tyler Cohen,5,1,2,5,487,500
1515402985,The Riffhard Podcast,0,0,0,0,15,15
1515409311,Left of Boom | A Military.com Podcast,0,0,0,0,8,8
1515419751,Mike Birbiglia's Working It Out,0,0,0,0,50,50
1515426451,The Nifty Show: Digital Collectibles and NFTs Podcast,0,1,0,0,5,6
1515528948,XO Higher Self,0,0,0,0,34,34
1515530237,Cosmic Gestures : A Vedic Astrology Podcast,0,0,0,0,1,1
1515536209,Robservations with Rob Liefeld,1,0,1,2,55,59
1515538909,"THE FROTH with RHOD GILBERT, SIAN HARRIES & Friends - Comedy Podcast",0,0,0,0,5,5
1515539182,Agents of Change Social Work Test Prep,0,0,0,0,1,1
1515539384,The Knees Over Toes Podcast,0,0,0,0,7,7
1515542917,The Iran Podcast,0,0,0,0,18,18
1515559882,NBA Draft Junkies,0,0,0,0,5,5
1515561931,Citizen Farmers,0,0,0,0,22,22
1515565692,Lookin’ For Game w/ Freeway Ricky Ross,0,1,0,0,1,2
1515586433,New Growth with Nikki Walton,0,0,0,0,9,9
1515595812,Madison's Notes,0,0,0,0,5,5
1515596660,Tuk Tuk Till I Die,0,0,0,0,1,1
1515598219,Beyond Crafting: Creating Your Most Inspired Life.,0,0,0,0,50,50
1515607844,"Tools of Titans: The Tactics, Routines, and Habits of World-Class Performers",10,6,1,0,17,34
1515609437,Deep Cover: The Real Donnie Brasco,0,0,1,1,42,44
1515613179,Stories Of Mahabharata ( From Beginning),0,0,0,0,2,2
1515625083,Raw vs Nitro - Reliving The War,0,0,0,0,10,10
1515631301,Nuclear Waste: The Whole Story,0,0,0,0,11,11
1515633176,The Modesty Files,0,0,0,1,16,17
1515649028,Speaking to Influence,0,0,0,0,45,45
1515769007,Black Plant Chick Pod,0,0,0,0,13,13
1515771832,The TBC Provoke Podcast,0,0,0,0,1,1
1515775394,Donkey Podcaster,0,0,0,0,1,1
1515786216,Deep Questions with Cal Newport,2,4,3,3,139,151
1515789022,House on Fire,0,0,0,0,10,10
1515795909,A Film and A Movie,0,0,0,1,20,21
1515808276,The Consistency Project,0,0,0,0,29,29
1515827446,Conspirituality,22,5,4,4,65,100
1515831128,The Vanishing Act,0,0,1,0,10,11
1515834398,HomeKit Insider,0,0,1,0,40,41
1515835838,The Godfrey Audio Guide,0,0,0,0,3,3
1515839766,The Electric Theater with Clown,0,0,0,0,2,2
1515856905,"Deep Dives and Deep Cuts: the History of Punk, Post-punk and New Wave (1976-1986)",0,0,0,0,9,9
1515894443,Hand Made,0,0,0,0,15,15
1515911255,Running and Fitness With Raj,0,0,0,0,2,2
1515932214,On the Edge with Andrew Gold,0,0,0,1,9,10
1515949228,That Jiu Jitsu Podcast,0,0,0,1,1,2
1515971195,Happy & Healthy with Jeanine Amapola,2,0,0,0,48,50
1515990538,The Sabian Podcast,0,0,0,0,1,1
1515997831,Type Talks,0,0,0,0,3,3
1515999752,Fear the Talking Queers,0,0,0,0,8,8
1516008453,Severed Studios,0,0,0,0,2,2
1516016002,You've Heard It Said,0,0,0,0,10,10
1516025992,African Folktales: Traditional Bedtime Stories for the Modern Kid,0,0,0,0,25,25
1516037494,Untitled Beatles Podcast,0,1,0,0,3,4
1516039889,The Render,0,0,0,0,7,7
1516050976,Fit For Golf,1,0,0,0,4,5
1516051176,MCU in Review - WandaVision and All Marvel Cinematic Universe,2,1,1,0,24,28
1516058806,When Belief Dies,0,1,0,0,4,5
1516098500,The Podcast of Power: A She-Ra Companion Podcast,0,0,0,0,7,7
1516104108,Marathon Swim Stories,0,0,0,0,1,1
1516113085,Glow Up with LaLa,0,0,0,0,5,5
1516114233,So Much Pingle,0,0,0,0,14,14
1516114405,The Wrestling Life Support Podcast,0,0,0,0,3,3
1516120123,Hello Ranger,0,0,0,0,15,15
1516131058,Rollin' With The Punches,0,0,0,0,1,1
1516148098,"Sleep Calming and Relaxing ASMR Thunder Rain Podcast for Studying, Meditation and Focus",0,0,0,1,6,7
1516168488,2 Cents FC,0,0,0,0,1,1
1516182632,Burning Man LIVE,1,0,0,0,6,7
1516194847,Real Dictators,0,1,0,0,8,9
1516213908,Up to Par golf podcast,0,0,0,0,1,1
1516222380,RC Scrap Pile,0,0,0,0,6,6
1516230692,Judo No Mi,0,0,0,0,1,1
1516259107,Terrible Lizards,0,0,0,0,8,8
1516293360,Coffee and Cosleeping,0,0,0,0,15,15
1516295176,Tap it In Podcast,0,0,0,0,3,3
1516310726,The Bad Broadcast,1,0,0,0,49,50
1516326666,Shonen Flop,0,0,0,0,50,50
1516334100,Movement Podcast,0,0,0,0,20,20
1516334638,GirlTrek's Black History Bootcamp,2,1,2,4,84,93
1516336192,Sound Expertise,0,0,0,0,1,1
1516339567,The Antithesis of Superwoman,0,0,0,0,3,3
1516343565,The Saad Truth with Dr. Saad,0,0,1,0,34,35
1516349482,Joe Bonamassa's Live from Nerdville Podcast,0,0,0,0,5,5
1516353313,The Nick & Matt Show,0,0,0,0,34,34
1516357517,The Turnbuckle Tavern,0,0,0,0,17,17
1516360420,#IMOMSOHARD,0,0,0,0,50,50
1516361778,The Joe Walsh Show,1,0,0,0,6,7
1516367817,Kiss My Aesthetic Podcast,0,0,0,0,7,7
1516375359,GI EndoCast,0,0,0,0,4,4
1516375747,The XRP Bully Show,0,0,0,0,2,2
1516377691,"Sports Talk with Jason, Ed & B-DOE",1,0,0,0,0,1
1516380592,The Kojima Frequency,0,0,0,0,4,4
1516391543,Krew Season Podcast,0,0,0,0,42,42
1516396084,Muriendo de Bella,0,0,0,0,2,2
1516400856,Hungry Generation Leadership,0,0,0,0,5,5
1516403452,We Got The Runs,0,0,0,0,9,9
1516443513,Double Century with Jarrod Kimber,0,0,0,0,5,5
1516479802,DRONERESPONDERS,0,0,0,0,1,1
1516491523,Cinematic Underdogs,0,0,0,0,1,1
1516502675,Real Marriage with Mark & Grace Driscoll,0,0,0,0,31,31
1516517779,10 Minutes With AY,0,0,0,1,2,3
1516523741,Living Mirrors with Dr. James Cooke,0,0,0,1,3,4
1516524444,Broadway Biz with Hal Luftig,0,0,0,0,1,1
1516524780,"British History: Royals, Rebels, and Romantics",0,0,0,0,9,9
1516529429,Will Run For...,0,0,0,0,26,26
1516533502,The Jew Next Door,0,0,0,0,1,1
1516535623,Un petit caoua? (French Podcast for beginners),0,0,0,0,2,2
1516541392,Dune Pod,0,0,0,0,18,18
1516543558,Norris Nuts Fan Podcast,2,1,0,0,2,5
1516595082,Blow Your Mind (BYM S02),0,0,0,4,4,8
1516628654,TRILLOQUY,0,0,0,0,6,6
1516633638,The Car Throttle Podcast,0,0,0,0,8,8
1516634378,"Makers, Figuring It Out",0,0,0,0,1,1
1516638494,Ten Minutes in Scrapbooking,0,0,0,1,3,4
1516638524,Late Night Shots,0,0,0,0,2,2
1516642192,The Wintering Sessions with Katherine May,0,0,0,0,2,2
1516658885,The Strangest Secret by Earl Nightingale,0,0,0,0,2,2
1516664274,California City,5,5,2,3,35,50
1516675672,Games To Play On Roblox!,4,0,0,1,3,8
1516680750,The Institute of Black Imagination.,0,0,0,1,15,16
1516680937,Long May You Young,1,0,0,0,25,26
1516681509,The Hoffman Podcast,0,0,0,1,4,5
1516705248,Unfinished,17,6,9,12,177,221
1516708783,Audiolibros,0,0,0,0,3,3
1516716555,The Coaches Network Podcast,0,0,0,0,2,2
1516737944,Pathways - With the Free Jacks,0,0,0,0,3,3
1516756085,Tennis Legend Podcast,0,0,0,0,1,1
1516770387,9XM Song Secret,0,0,0,0,2,2
1516839200,Biblical Meditations To Restore Your Soul,0,0,0,0,1,1
1516843565,Get WIRED,1,2,0,0,12,15
1516844211,The Pitchfork Review,6,3,1,2,9,21
1516849884,Cuentos y Leyendas de Honduras,0,0,0,0,1,1
1516850676,The Divine Messages Podcast,0,0,0,0,5,5
1516852358,The PCOS Girls Podcast,0,0,0,0,9,9
1516891147,Crying In Public,1,0,0,1,74,76
1516892636,A Feminine Impression,1,1,0,2,28,32
1516892910,Motivational Speeches,0,0,0,0,1,1
1516910620,Ward Wrestling Live,0,0,0,0,2,2
1516924684,Chesapeake Conversations,0,0,0,0,1,1
1516926791,Aliens & Artists,0,0,0,0,6,6
1516991173,"HammerCast - Fantasy Football, BBQ, Bourbon, and Beer",0,0,0,0,15,15
1517057787,Back to Bayside,0,0,1,1,19,21
1517065166,Meta Pod: A Pokemon TCG Podcast,0,0,0,0,24,24
1517079631,Dadz,0,0,0,0,10,10
1517084663,MCAT Modules - Review,0,0,0,0,1,1
1517087857,Cafecito con Estrellita,0,0,0,0,35,35
1517105131,Evanston Rules,0,0,0,0,15,15
1517108825,Pathfinder,0,0,0,0,1,1
1517116280,The Science of Personality Podcast,0,0,0,1,2,3
1517120713,Wizarding World,0,0,1,0,3,4
1517135449,Chasing Frets,0,0,0,0,6,6
1517136703,The Rice Stuff,0,0,0,0,3,3
1517137653,Law of Attraction Changed My Life,3,1,3,4,289,300
1517142717,The Quackalope Podcast,1,1,1,1,35,39
1517144428,Chomping Down the Dietetic Exam,0,0,0,0,22,22
1517156345,The Paper Fold,0,0,0,0,3,3
1517169338,How Did This Not Get Made,0,0,0,0,1,1
1517200740,Here Lies Amicus,0,0,0,0,2,2
1517210705,The Fresh and Fit Podcast,1,0,0,0,0,1
1517215030,SolveItForKids's podcast,0,0,0,0,4,4
1517235074,Purposeful Social Selling,0,0,0,0,66,66
1517244171,Two Mikes with Michael Scheuer and Col Mike,0,0,0,1,3,4
1517246188,TechNoBros,0,0,0,0,7,7
1517254441,That Beauty Podcast,0,0,0,0,4,4
1517256758,Two Messianic Jews,0,0,0,0,3,3
1517259960,Morning Scoop: Daily Buckeye Show,1,0,1,0,13,15
1517263429,Spanish Stories for Kids,0,0,0,0,15,15
1517300464,The DK DFS Show,0,0,0,0,7,7
1517302239,Dennis Prager Podcasts,3,0,0,0,31,34
1517308923,"Richard Diamond, Private Detective",0,0,0,0,1,1
1517310439,Within & Between,1,0,0,0,3,4
1517312717,The Shadow,0,0,0,1,2,3
1517313007,Hugh Hewitt Podcast,2,0,1,0,1,4
1517318479,Extra Spicy,5,1,1,1,11,19
1517326646,True To The Culture Podcast,0,1,0,0,32,33
1517327004,90 Day Fiance Crazy In Love,1,0,1,2,27,31
1517334184,Wear It Down: The Queer Killing Eve Podcast,0,0,0,1,2,3
1517335575,The CPG Guys,0,0,0,0,17,17
1517406283,Victory The Podcast,9,2,5,8,476,500
1517413168,An Even Bigger Fly On The Wall,0,0,0,0,2,2
1517421323,The Quash,2,0,1,1,48,52
1517423541,Moontower Soccer: An Austin FC Podcast,0,0,0,0,4,4
1517447418,Gone Flyin,0,0,0,0,2,2
1517467663,EcoRight Speaks,0,0,0,1,24,25
1517484833,The ultimate minecraft podcast,7,0,3,10,27,47
1517514059,Smart Talks,0,0,0,0,6,6
1517530134,FOOD TRUCK JOURNEY,0,0,0,0,5,5
1517530142,"Girls Gone Healthy - Workout Motivation and Food Guide to Live a Cheap, Easy Healthy Lifestyle for C...",0,0,0,0,50,50
1517537206,The Bright Morning Podcast,0,0,0,0,50,50
1517600614,The Hypnobirthing Podcast,0,0,0,0,6,6
1517609645,Makers of Maine,0,0,0,0,2,2
1517640300,UNKUT KRITIKA,3,1,1,4,80,89
1517646639,Spiritually Hungry,0,0,1,1,55,57
1517651197,Park Predators,70,65,90,43,232,500
1517657532,Colors: A Dialogue on Race in America,0,0,1,0,1,2
1517659188,Uncommon Core,0,0,0,0,34,34
1517662735,Gunsmoke,0,0,0,0,1,1
1517677305,Behind The Skies,0,0,0,0,1,1
1517684140,Long Shots,0,0,0,0,1,1
1517698133,Dadville,0,0,0,0,50,50
1517709981,Welcome to Your Fantasy,3,0,0,0,0,3
1517715431,Bleav in Rugby Talk,0,0,0,0,11,11
1517717406,Autism In Real Life,0,0,0,0,2,2
1517729177,Chasing Justice,0,0,0,1,28,29
1517754353,Sports Gambling w/ Moneyline Monaco,0,0,0,0,13,13
1517788197,The Turn,0,0,0,0,3,3
1517809596,Commute Internal medicine board review,0,0,0,0,1,1
1517810344,Potwatchers,0,0,0,0,1,1
1517861438,Coffee Break Conversations,0,0,0,0,1,1
1517861929,Maino Presents: Kitchen Talk,0,0,1,2,9,12
1517879554,Spy Stories,0,0,0,0,1,1
1517885837,Blue Earth,0,0,0,0,1,1
1517893876,Ask Away,0,0,0,0,1,1
1517894054,Sound Mind Set,0,0,0,0,1,1
1517896702,"McIntosh ""for the love of music…”",0,0,0,0,2,2
1517915666,The Quilting Arts Podcast,0,0,1,1,12,14
1517920715,SoFi Daily Podcast,1,0,0,0,4,5
1517954480,Rotten Mango,1,0,0,3,22,26
1518010100,Bare With Us,2,0,1,2,100,105
1518035422,Swinging Flamingos,0,0,0,0,1,1
1518036400,Talking Derry Girls,0,0,1,1,11,13
1518106322,Salty Stories: The Ship's Log,1,0,0,0,4,5
1518137109,What's Up with Docs Podcast,0,0,0,0,1,1
1518158884,The Weekly Scrap,0,0,0,0,2,2
1518162863,Complex Trauma Recovery; We Are Traumatized M***********s,0,0,0,0,11,11
1518181081,Nani no Anime Podcast,0,0,0,0,50,50
1518217955,The New Mom Boss Podcast,0,0,0,0,50,50
1518292579,Dungeons & Drimbus,0,1,0,0,44,45
1518293182,ocean sounds,1,0,0,1,1,3
1518299062,Marketplace Minute,5,3,0,1,14,23
1518299610,Plat Chat VALORANT,0,0,0,0,5,5
1518306347,Let’s talk Gacha,0,0,0,0,2,2
1518308647,Running Stitch - A QSOS Podcast,0,0,0,0,5,5
1518311126,ROBLOX Piggy,10,1,1,1,10,23
1518311858,"Should I Buy It, Though?",0,0,1,1,32,34
1518312662,The Product Marketing Experts,0,0,0,0,6,6
1518313105,Eyewitness Beauty,4,3,4,2,74,87
1518313873,The Groupchat Golf Podcast,0,0,0,0,17,17
1518314121,God & a Gram,0,0,0,0,5,5
1518315074,The Harrowing,0,0,0,1,29,30
1518315540,The Moving To Florida Show,0,0,0,0,2,2
1518321301,History Is Dank,0,0,0,1,49,50
1518324177,Prose in Practice,1,0,0,0,0,1
1518324870,The Roast of Your Teenage Self,1,1,0,1,33,36
1518325298,The Right Side with Doug Billings,7,1,0,0,22,30
1518326010,Elevate Construction,0,0,0,0,8,8
1518349298,Allerton Park Bird Club Podcast,0,0,0,0,6,6
1518356658,Richest Men in Town,0,0,0,0,4,4
1518363401,SENTINELS: POINT OF NO RETURN,0,0,0,2,12,14
1518372507,The Voices of The Vic,0,0,0,0,1,1
1518397412,We Suck At D&D,0,0,0,0,8,8
1518398558,E-Ticket to Broadway,0,0,0,0,43,43
1518399549,Savage Love,1,0,1,3,3,8
1518400160,America The BREW-tiful,0,0,0,0,5,5
1518407097,Kids Mindfulness Meditations. A Podcast for Kids,0,0,0,0,4,4
1518409427,Dive Stories,0,0,0,0,28,28
1518416085,The Last Hit,0,0,0,0,1,1
1518416850,Alcohol-Free Lifestyle,0,0,1,0,36,37
1518425016,The 42nd Stitch Podcast,0,0,0,0,2,2
1518498812,When Calls The Heart Aftershow,0,0,0,0,2,2
1518499528,Next Possession,1,0,0,0,7,8
1518509480,2 Shots on a Barrel,0,0,0,0,2,2
1518513947,Calming Music :),0,0,0,0,2,2
1518515458,INXS: Access All Areas,0,0,0,0,2,2
1518526756,Mackaroy Uncovered,0,0,0,1,49,50
1518537743,Same Brain,1,0,0,4,355,360
1518588224,Wilde On,0,0,0,0,13,13
1518589138,The Tinsel Factory: A Film History Podcast,0,0,0,0,5,5
1518591571,Wait A Damn Minute,0,0,0,0,9,9
1518595989,The Birdy Bunch Podcast,0,0,0,0,9,9
1518595991,Gacha Life Procasts,0,0,1,0,5,6
1518612470,THE ANYTHING SHOW WITH JON FRANCOIS,0,1,0,4,294,299
1518613194,Jungkook,0,0,0,0,2,2
1518620504,Kids BedTime Stories,0,0,0,0,1,1
1518622561,Script Apart,0,0,0,0,5,5
1518631274,Generation Iron Podcast,0,0,0,1,3,4
1518637624,Israel Daily News Podcast,0,0,0,0,7,7
1518650275,Latinx Lens,0,0,0,1,13,14
1518652051,The Anxious Love Coach,0,0,0,0,3,3
1518658944,Grow Weed at Home with Homegrown Cannabis Co,0,0,0,0,2,2
1518666256,HousingWire Daily,0,0,0,0,6,6
1518666689,Digging in with Tripp,1,0,0,0,21,22
1518683867,Trash Taste Podcast,0,0,1,3,46,50
1518687797,Aghoreshwar's Pearls of Wisdom with Commentary By Baba Harihar Ram,0,0,0,0,1,1
1518710069,Red Table Talk,10,2,1,4,74,91
1518716023,Had I Known,0,0,0,0,3,3
1518750946,Parenting Today's Teens,0,0,0,0,8,8
1518752185,Six Minute Mile,0,0,0,0,3,3
1518754053,Would You Rather...,0,0,0,0,3,3
1518796171,Language Hacking,0,0,1,1,21,23
1518811931,Ranking The Beatles,0,0,0,0,11,11
1518818543,Full Time with Meg Linehan: A show about women's soccer,0,0,0,0,112,112
1518819034,Notes From The Pen - Prison,0,0,0,2,27,29
1518820081,Practice Disrupted with Evelyn Lee and Je'Nen Chastain,0,0,0,0,3,3
1518820915,The Bob McCown Podcast,0,0,0,0,6,6
1518831341,The Tip of the Cap Podcast,0,0,0,0,1,1
1518834614,Blackpink,1,0,0,1,1,3
1518839824,Guru: The Dark Side of Enlightenment,60,53,78,59,193,443
1518844334,Cork'd Up: A Wine Podcast with a Splash of Baseball,1,0,0,1,3,5
1518858357,Make Marriage Work,0,0,0,0,9,9
1518859017,Where Optimal Meets Practical,0,0,2,0,15,17
1518861947,Beauty Needs Me,0,0,0,0,8,8
1518866785,Overcoming Betrayal & Addiction,0,0,0,0,2,2
1518869052,The Dynasty Drive,0,0,0,0,2,2
1518871633,The Bolin Alley,3,0,0,2,1,6
1518878481,Your Most Obedient & Humble Servant,0,0,0,0,12,12
1518878514,Spotify,0,0,0,0,1,1
1518878923,LAMBTALK,0,0,0,0,3,3
1518903701,Sasquatch Tracks,0,2,0,1,19,22
1518908403,Tween Talk,0,0,0,0,2,2
1518970246,MUSIC VIDEOS,1,1,1,5,26,34
1519009936,TNA Cross The Line Podcast,0,0,0,0,1,1
1519024926,Octavia's Parables,0,0,0,0,54,54
1519035231,For the Love of Literacy podcast,0,0,0,0,6,6
1519036770,Origins & Evolution,0,0,0,0,9,9
1519070307,Are You Smarter Than a 5th Grader?,1,0,2,0,3,6
1519070539,UPT Bound,0,0,0,0,3,3
1519100248,Looking Up with Dr. Deepika Chopra,0,0,0,0,11,11
1519113552,The Eben Flow,0,0,1,0,49,50
1519114534,Pretty Lies & Alibis,4,1,2,3,30,40
1519121584,Sleep and Relaxation Sounds,0,1,0,0,6,7
1519129134,Stories Mother Told: African Folktales,0,0,0,0,2,2
1519130222,HBO's I'll Be Gone In The Dark Podcast,3,1,0,2,18,24
1519132902,Unconditionally Unfiltered,6,0,0,0,33,39
1519141734,The Simple Nursing Podcast - The Simplest Way To Pass Nursing School,0,0,0,0,3,3
1519147221,Raiders Of The Lost Podcast,1,2,4,3,393,403
1519155512,The Naptime Hustle Podcast,0,0,0,0,28,28
1519262923,The Inner Game with Lindsey Wilson,0,0,0,0,15,15
1519268664,The Joe Show,1,0,0,0,2,3
1519270348,Friends Who Talk About Money,0,0,0,1,5,6
1519291796,Life Possible Podcast,0,0,0,1,2,3
1519298515,Rating roblox games,5,1,3,6,34,49
1519299517,Jokermen: a podcast about bob dylan,0,0,1,2,11,14
1519301662,The Balanced Band Director,0,0,0,0,1,1
1519303133,Honduras Now Podcast,0,0,0,0,4,4
1519308210,The Running Pod,0,0,0,0,6,6
1519323740,"Good Night, Black Child",0,0,0,0,3,3
1519344870,Crime Countdown,67,32,28,24,197,348
1519350904,Propagated Podcast,0,0,0,0,8,8
1519359642,Conflict Radio,0,0,0,0,3,3
1519361907,Pull Hitter Fantasy Baseball,0,0,0,0,37,37
1519456164,10 to LIFE!,0,0,0,0,13,13
1519458581,Hey Black Child: The Podcast,0,0,0,0,15,15
1519477544,On The Issues With Michele Goodwin,0,0,0,0,20,20
1519498903,Guides Gone Wild,0,0,0,0,5,5
1519511826,Little Angles,0,0,0,0,1,1
1519515127,NITE LIFE NATION - The Coon Hunter's Podcast,0,0,0,0,49,49
1519599986,Rugby Wisdom,0,0,0,0,4,4
1519601518,Unmasked History of Scooby Doo,0,0,0,0,3,3
1519689024,Democracy Paradox,0,0,0,0,2,2
1519723673,The Koren Podcast,0,0,0,0,1,1
1519727121,The Goat Room Podcast,3,1,2,1,17,24
1519781711,The Busy Latter-day Saint,0,0,0,0,8,8
1519793459,School of the Rock,0,0,0,0,1,1
1519797515,Eatrite Nutrition Podcast,0,0,0,0,17,17
1519798932,"Food, Sex & Money",0,1,0,0,49,50
1519800362,The Horse Traders Diary,0,0,0,0,3,3
1519801297,Make More Art,0,0,1,0,2,3
1519821570,Cherry Jam - A Gloucester Rugby Supporter Podcast,0,0,0,0,1,1
1519830825,Pediatrics On Call,0,1,0,2,22,25
1519839250,Driving the Green Book,1,0,1,4,67,73
1519850086,The Power Hungry Podcast,0,0,0,0,8,8
1519858840,The Longest Stride,0,0,0,0,12,12
1519878239,FactSet Evening Market Recap,0,0,0,0,4,4
1519880315,Your Dog Wants You To Know This!,0,0,0,0,15,15
1519896831,The Cosmic Controversy Podcast,0,0,0,0,2,2
1519901948,In the Red Clay,5,3,2,5,485,500
1519960682,Unfuck Nation with Gary John Bishop,0,0,0,0,50,50
1520010193,Bible Bedtime Stories with Blessing Afolabi,0,0,0,0,1,1
1520010749,DIA Connections,0,0,0,0,4,4
1520011310,The NanoPod,0,0,0,0,1,1
1520013287,"Food, But We Digress...",0,0,0,0,10,10
1520017029,The Back Row Redskins Show - A Washington Redskins Podcast,0,0,0,0,10,10
1520022230,The Big Homies House,0,0,0,0,3,3
1520048055,W.O.C. at Work,0,0,1,0,16,17
1520054173,The Real Estate Rebel with Scott McGillivray,0,0,0,0,2,2
1520069029,The Successful Screenwriter with Geoffrey D Calhoun: Screenwriting Podcast,0,0,0,0,7,7
1520070952,Seizing Freedom,1,0,0,0,12,13
1520074622,Songs for Life,1,0,1,0,10,12
1520087841,Sincerely Unqualified,0,0,0,0,5,5
1520093149,IMPACT: The Podcast,1,0,0,0,6,7
1520102889,The Way the World Works: A Tuttle Twins Podcast for Families,1,0,2,3,22,28
1520105905,Unscripted,0,0,0,0,18,18
1520106150,Where Wine Takes You - A Paso Wine Podcast,0,0,0,0,27,27
1520121119,Greg Brown: Cockpit Adventures from the Flying Carpet,0,0,0,0,5,5
1520131270,10 Minute Murder,1,1,0,0,39,41
1520148776,Act One Podcast,0,0,0,0,3,3
1520185909,The Cribsiders,0,0,1,0,15,16
1520189814,Shaped by Dog with Susan Garrett,0,1,0,0,49,50
1520209098,Pounding The Table,0,3,3,0,36,42
1520209791,What Had Happened Was,0,0,0,0,101,101
1520216207,The First Ever Podcast,0,0,0,0,44,44
1520218327,Kids Bible Stories & Songs,0,0,0,0,1,1
1520229508,Flow Research Collective Radio,1,0,2,1,25,29
1520245457,Drafted,0,0,0,0,15,15
1520263700,The Jane Goodall Hopecast,0,0,0,0,17,17
1520269301,The Bakari Sellers Podcast,10,0,4,2,68,84
1520270769,The Outcomes Conference Podcast,0,0,0,0,1,1
1520283846,Beyond Blathers,0,0,0,0,6,6
1520289350,The Chop with Latrice Royale & Manila Luzon,10,4,5,4,74,97
1520307583,Rebel Human Resources Podcast,0,0,0,0,1,1
1520351953,The Man To Man With DB & AB,0,0,0,0,19,19
1520368162,Three Black Halflings | A Dungeons & Dragons Podcast,1,0,0,0,28,29
1520392054,Putt That Podcast,0,0,0,0,8,8
1520403988,The Ancients,0,0,2,0,12,14
1520404460,Hello Relationships,0,0,0,0,5,5
1520414107,Jazz United: A Podcast From WBGO,0,0,0,0,3,3
1520425174,Straight To Video,0,0,0,0,2,2
1520426877,Sober Powered,0,0,0,0,35,35
1520436135,Sequence with Trevor Plouffe,0,0,0,0,8,8
1520444026,Sleep Tight Science,0,0,0,1,3,4
1520445401,Intersect Ed,0,0,0,0,1,1
1520451082,Big Facts No Cap,0,0,0,0,8,8
1520457603,Design Time,3,0,4,1,46,54
1520465627,What Could Possibly Go Right?,0,0,0,0,2,2
1520470850,Vegan Abattoir,0,4,6,6,125,141
1520478046,Turley Talks,2,1,2,1,49,55
1520478402,Deep Cover: The Drug Wars,5,2,4,6,97,114
1520480337,IN THE TREES PODCAST,0,0,0,1,9,10
1520489068,One Next Step: Management Tips & Tools for Small Business Owners,0,0,0,0,11,11
1520492563,Suburban Boys,0,0,0,0,11,11
1520509804,The Old Kids Movies,0,0,0,0,5,5
1520602529,The oursociallandscape's Podcast,0,0,0,0,1,1
1520670193,JOLLYLAND,0,0,0,0,9,9
1520676302,Get Behind Fanny,0,0,0,0,2,2
1520676988,The CripesCast Podcast,2,1,0,1,46,50
1520679444,CREEK DEVIL,1,0,0,0,1,2
1520710294,Game Changers in Medicine,0,0,0,0,13,13
1520715708,Anime in America,0,0,1,0,23,24
1520715907,There Are No Girls on the Internet,16,0,1,1,76,94
1520750638,"The Hiker Podcast | Day Hiking, Backpacking, Thru Hiking",0,0,0,1,26,27
1520754832,Metrosource Minis: The LGBTQ World & Beyond,0,0,0,0,3,3
1520761785,Rumpel and the Frog,0,0,0,0,11,11
1520762610,The Decrypt Daily: Bitcoin & Cryptocurrency  News Podcast,0,0,1,1,32,34
1520763407,CBS Radio Mystery Theater,0,0,0,0,2,2
1520774800,The Johnny Mitchell Show,0,0,0,0,10,10
1520782329,Radiant Rest  Podcast with Tracee Stanley,0,0,0,0,5,5
1520789736,The Orange Tree,21,17,26,15,324,403
1520796424,Holistic Life Navigation,0,0,0,0,10,10
1520837959,Fullmetal Analysts,0,0,0,0,6,6
1520843815,The Yacht Rock Show with Eddie Ganz,0,0,0,0,1,1
1520846483,The Last Tapestry,0,0,0,0,10,10
1520852609,Kids Meditation,0,0,1,0,14,15
1520856346,The Mallory Bros Podcast,0,0,1,1,48,50
1520894322,"GET REAL w/ Peniel, BM, and Ashley Choi",0,0,2,7,491,500
1520996089,Authentic Obsessions,0,0,0,1,6,7
1521021519,Fur the Culture,0,0,0,0,3,3
1521024603,EuroSteppin Podcast,0,0,0,0,1,1
1521036396,ABC Cryptozoology,0,0,0,0,4,4
1521036457,Ship Chasing,0,0,0,0,59,59
1521052113,Our Numinous Nature,0,0,0,0,10,10
1521053843,Digging for Kryptonite: A Superman Fan Journey,0,0,0,0,3,3
1521067784,The Yellowstone Podcast with Stef and Sheila,0,0,1,0,5,6
1521068608,The Daily Mastery Podcast by Robin Sharma,0,0,2,4,58,64
1521107610,Respect The Drive,0,0,0,0,2,2
1521118944,High Stakes Heat,0,0,0,0,19,19
1521164316,The Volleyball By Design Podcast,0,0,0,0,9,9
1521171499,Secret Life,0,0,0,1,52,53
1521180615,Can't Take the Heat,0,0,0,0,6,6
1521191482,Dyslexia Mom Life,0,0,0,0,11,11
1521195137,The StoryTinker,1,0,3,1,3,8
1521272581,Omarhuss,0,0,1,0,6,7
1521300909,An Oral History of The Office,10,3,5,4,109,131
1521303143,Red Web,10,1,16,10,247,284
1521313918,Middle Ground Podcast,0,0,2,1,147,150
1521314987,Weekly Specials with Will Guidara,0,0,0,0,3,3
1521324737,DVC Newscast by My DVC Points,0,0,0,0,4,4
1521330247,Better Me with BodyByBree,1,0,0,0,39,40
1521332138,Psychoanalysis: A Horror Therapy Podcast,4,0,2,3,41,50
1521348064,Daily Rundown,0,0,0,0,2,2
1521352778,Trawler Talk,0,0,0,1,4,5
1521380672,The Iggy Parents,0,0,0,0,9,9
1521388821,Off Track: Meeting of the Unknowing Minds,0,0,0,0,1,1
1521391469,"Ready, Set, TEACH",0,0,0,0,9,9
1521406876,Passing Judgment,1,0,0,0,36,37
1521454822,Thomas & Friends™ Storytime (UK),0,0,0,0,3,3
1521470438,American Songcatcher,0,0,0,0,6,6
1521477945,Abuse of Power with David Rudolf and Sonya Pfeiffer,4,0,0,1,36,41
1521478601,The Raincoat Report,0,0,0,0,1,1
1521480607,Camping Out with Dan Camp,0,0,0,0,10,10
1521483126,GameKeeper Podcast,0,0,0,2,17,19
1521487253,Sistas with Sabers,0,0,0,2,14,16
1521520146,The Dr. Epicopolis & 1102 Show of Shows,0,0,3,1,11,15
1521522245,Make Shift Happen with Samantha Daily,0,0,0,0,22,22
1521527314,Black Frasier,2,0,0,0,48,50
1521530338,Ask a Matchmaker,3,1,2,0,27,33
1521530802,Festival Circuit: New Orleans,0,0,0,0,30,30
1521532548,Middle Market Mergers and Acquisitions by Colonnade Advisors,0,0,0,0,12,12
1521532868,"Some Work, All Play",1,1,0,0,70,72
1521535384,Into the Zone,1,3,2,5,53,64
1521547343,The Shi Show,0,0,0,0,1,1
1521551570,The Memo by Howard Marks,0,0,0,0,16,16
1521578868,SmartLess,34,36,46,58,774,948
1521581436,The Overland Philosopher,0,0,0,0,3,3
1521585095,Your PA Mentor - From Physician Assistant Student to PA-C,0,0,1,0,43,44
1521600842,BetweenNerds,0,0,0,0,5,5
1521632905,Newsy Jacuzzi,0,0,0,0,16,16
1521641293,You Can Sit With Us,3,0,4,8,35,50
1521655911,The Mom Room Podcast,0,0,0,1,49,50
1521673878,EYELASH EXCELLENCE - THE LASH CHAT,0,0,0,0,1,1
1521691431,Rounds to Residency (from MedSchoolCoach),0,0,0,0,3,3
1521693509,The Nateland Podcast,0,0,0,0,50,50
1521716542,Charting The Territories Podcast,0,0,0,0,7,7
1521741221,The Two Tall Jews Show,0,0,0,0,31,31
1521742221,"""So Look Bro"" Podcast",1,1,0,2,162,166
1521750872,Soul on Ice: The Podcast,0,0,0,0,7,7
1521758188,99 Potions,0,0,0,0,5,5
1521758802,Theories of Everything with Curt Jaimungal,1,0,0,0,5,6
1521798872,unCUT - The Makers' Podcast,0,1,0,0,3,4
1521800238,The One Stars,0,1,0,0,8,9
1521841754,Kota Embassy Podcasts,0,1,0,1,12,14
1521841767,The Screen Forum,0,0,0,0,3,3
1521842063,Lyrics Of Their Life,0,0,0,0,1,1
1521859106,Catching Up With Boruto,0,0,0,0,4,4
1521863834,Astronomy Minute,0,0,0,0,1,1
1521872795,Know Thyself,0,0,1,1,14,16
1521873542,Single Best Scene,0,0,0,0,2,2
1521874634,Independent Filmmaker's Guide,0,0,0,0,7,7
1521876707,The Daily Juice,8,4,3,12,473,500
1521901941,Late Era,1,0,0,0,3,4
1521906608,Running Times,0,0,0,0,11,11
1521914297,The Gift of Forgiveness,9,1,3,4,41,58
1521921220,NICU Grad Podcast,0,0,0,0,3,3
1521935535,The Perfect Drink,0,0,0,0,3,3
1521956089,Live From My Office,1,0,0,0,12,13
1521965749,Nurse Becoming,0,0,0,0,21,21
1522054150,UltraRunning Magazine Podcast,1,0,0,0,1,2
1522055902,Bravo While Black,0,0,0,1,24,25
1522056200,"Fans On The Run: A Podcast Made By, For And About Beatles Fans",0,0,0,0,4,4
1522062006,Italiano Bello,0,0,0,0,6,6
1522069734,Food Freedom and Fertility Podcast,0,0,0,2,36,38
1522072002,Full Release with Samantha Bee,9,0,0,5,36,50
1522076592,Nursing School Week by Week,0,0,0,0,15,15
1522077847,Beyond the Clubhouse,1,0,0,0,3,4
1522109023,Protecting Your NEST with Dr. Tony Hampton,1,0,0,0,8,9
1522113627,Dirty Diana,2,2,1,3,42,50
1522131146,Believing the Bizarre: Paranormal Conspiracies & Myths,0,0,0,0,30,30
1522154152,The Firsts,0,0,0,0,1,1
1522215911,The Environmental Transformation Podcast,0,0,0,0,7,7
1522222281,For Heaven's Sake,0,0,0,0,2,2
1522241906,Intergenerational Politics,0,0,0,3,47,50
1522247279,Conservation Queens,0,0,0,0,2,2
1522301181,Run O’clock Podcast,0,0,0,0,1,1
1522309870,Screenagers Podcast,0,0,0,0,23,23
1522315710,Apartment 4D: A New Girl Podcast,0,0,1,0,10,11
1522318033,Djy Jaivane,0,0,0,1,22,23
1522325262,Be Right,0,0,0,0,14,14
1522337888,California Love,7,1,2,5,152,167
1522338009,NYCFC Forever Podcast,0,0,0,0,5,5
1522355545,Empowered to Connect Podcast,0,0,0,0,10,10
1522364806,"High on Home Grown, The Cannabis Podcast",0,0,0,0,1,1
1522378503,Fade The Chalk,1,1,0,2,107,111
1522397511,The Eva Effect Podcast,0,0,0,0,1,1
1522401890,Altar Call: A Married At First Sight Podcast,0,0,3,2,49,54
1522406672,History In The Mix: The Reboot,0,0,0,0,3,3
1522407349,Build a Business Success Secrets,0,0,0,0,24,24
1522443145,Learn To French,0,0,0,0,1,1
1522498663,The Ear Responsible Podcast,0,0,0,0,1,1
1522512306,Coffey & Code,0,0,0,0,12,12
1522514872,The Delve,0,0,0,0,4,4
1522516308,Learn English Vocabulary,0,1,0,0,3,4
1522528502,Mr.Creeps,1,0,0,0,2,3
1522544673,"PET TALK TODAY with Will Bangura: Dog Trainer, Dog Training, Cat Training, Pet Health, and Wellbeing...",0,0,0,0,4,4
1522552119,The Filmumentaries Podcast,0,0,0,0,5,5
1522555280,Heart Of Witchcraft,0,0,0,1,0,1
1522555969,Rain Sounds,0,0,0,0,15,15
1522570191,The Max Lucado Encouraging Word Podcast,0,0,0,0,42,42
1522600041,Critical Role,0,0,0,1,20,21
1522702162,A Heart For All Students,0,0,0,0,5,5
1522707363,Blue's Clues & You: Story Time with Josh & Blue,6,1,0,1,42,50
1522708820,PURIJAGANNADH,2,1,1,3,87,94
1522735322,Mike Up In Your Business Podcast with Mike Michalowicz,0,0,0,0,18,18
1522740423,Pawnee Public Radio: A Parks and Rec Rewatch Podcast,1,1,2,2,72,78
1522773225,Three — A Tennis Show,0,0,0,0,4,4
1522780468,The Rugby Rant,0,0,0,0,2,2
1522781438,Keepin’ It Real,0,0,0,0,2,2
1522786657,Designer Shopping Spree,0,0,0,0,14,14
1522818735,The Off The X Podcast,0,0,0,0,1,1
1522857920,Culture Wars – with Andrew Doyle,2,0,0,0,11,13
1522882428,In The Barn,0,0,0,1,7,8
1522900151,Women & the Wilderness,0,0,0,0,3,3
1522912456,It's A Hawaii Thing,0,2,1,0,3,6
1522912600,Inside Comfort with Jerry Navarra,0,0,0,0,2,2
1522914723,GOOD OL' GRATEFUL DEADCAST,0,1,0,2,111,114
1522929437,JOSPT Insights,0,0,0,0,2,2
1522936362,The Mystery Kids Podcast,1,1,1,0,10,13
1522972519,Doc Halligan Unleashed with Joey Villani,0,0,0,0,3,3
1522977183,Flight Assist,0,0,0,0,1,1
1522985502,Miracles & Atheists,0,0,0,0,6,6
1522992251,Breaking Doctrine,0,0,0,0,4,4
1522993721,Unloose the Goose Agorist and Libertarian Solutions Podcast,2,0,0,1,23,26
1523003927,Wings of Fire Fanwingz by WOF Girlz,0,0,0,1,19,20
1523010192,Warcraft Reloaded – WoW Classic and Community,0,0,0,2,23,25
1523036469,Roll for Weird | A Monster of the Week Actual Play,0,0,0,0,7,7
1523037798,Academy Blasting,0,0,0,0,1,1
1523042499,The Poor Prole's Almanac,0,0,0,0,2,2
1523044246,hoopoecast,0,0,0,0,1,1
1523065355,Talking Dogs with Graeme Hall,0,0,0,2,57,59
1523070193,Extra Dynamic with ur mom ashley,0,0,1,1,40,42
1523071291,Serious Butt Funny,0,0,0,1,49,50
1523075095,Taxgirl,0,0,0,0,1,1
1523091091,BRING IT IN,0,0,0,0,1,1
1523101339,chats with che,0,0,0,0,2,2
1523107191,Paleo Nerds,0,0,1,0,23,24
1523111704,Fashion Crimes Podcast,0,0,0,0,3,3
1523117197,Healthy Eating For Busy Women,0,0,0,0,8,8
1523129735,Dominican Spanish 101,0,0,0,1,9,10
1523169363,The Music That Made America,0,0,0,0,5,5
1523174465,Uphill Athlete Podcast,0,0,1,2,5,8
1523174914,What Else Is Going On? With Taria S. Faison,5,0,0,0,43,48
1523179514,Hypercritical from Professional Awesome Racing,0,0,0,0,14,14
1523184474,MANEATER,0,0,0,0,4,4
1523214579,Bob & Eric Save America,0,0,1,0,7,8
1523226942,Clotheshorse,0,0,0,0,44,44
1523235384,Gundam Book Club,0,0,0,1,1,2
1523238317,The Homebrew | A DND Play Podcast,0,0,0,0,2,2
1523238342,The Elder Scrolls Podcast with FudgeMuppet,0,0,0,0,18,18
1523255162,Pennies: Going in Raw,9,5,1,2,183,200
1523307706,Scientology: Fair Game,13,15,34,41,397,500
1523309999,Travel Tales by AFAR,1,0,0,0,76,77
1523312400,Why This Universe?,0,0,0,0,7,7
1523336466,Biblical Nutrition Academy Podcast,0,0,0,0,7,7
1523336993,Inside the Cap with Joel Corry,0,0,0,0,4,4
1523340696,Dear Therapists,3,2,2,4,155,166
1523342002,Do Less God Bless,0,0,2,0,48,50
1523342671,A Smaller Life,0,0,0,0,2,2
1523350670,PlanBri Uncut,14,2,5,6,215,242
1523351030,What To Expect,6,1,4,3,8,22
1523353907,Straight Fire with Jason McIntyre,15,1,1,2,108,127
1523360049,FTN Fantasy Baseball Podcast,0,0,0,1,28,29
1523361912,Palmetto Cats LIVE,0,0,0,1,1,2
1523379011,Daily News Brief,0,0,0,0,1,1
1523382406,CrossPolitic Show,0,0,0,0,1,1
1523437538,The Mash Pit!,0,0,0,0,3,3
1523452258,The Toilets to Titles podcast,0,0,0,0,8,8
1523486568,Million Bazillion,3,0,3,2,41,49
1523497598,Wisecracker,0,0,0,0,6,6
1523507379,Don't Ask Tig,0,0,0,0,50,50
1523520991,Old Friends Catch Up,0,0,0,0,3,3
1523523334,Reptilian Ramble,0,0,0,0,3,3
1523530326,Shots to the Dome,0,0,0,0,7,7
1523543528,The Piketon Massacre,61,65,98,60,99,383
1523554719,PDX Story Project,0,0,0,0,2,2
1523566254,Kind thoughts for Meghan Markle,0,0,0,0,3,3
1523578633,"The Dumb, Found Dead",0,0,0,0,30,30
1523580389,Where It Went Podcast,1,0,1,2,29,33
1523584878,In Machines We Trust,0,0,1,2,11,14
1523586269,The Bloodybits Horror Show,0,0,0,0,9,9
1523594466,The Gimme,1,0,0,0,11,12
1523594641,Beauty & The Beast Podcast,0,0,0,0,10,10
1523597397,This is The Revolution,0,0,0,0,2,2
1523600736,The Mud Peddlers: Ceramic Art Behind the Scenes,0,0,0,0,14,14
1523612283,The Ethical Rainmaker,0,0,0,0,12,12
1523614693,Kinda Funny Xcast - An Xbox Podcast,0,4,1,1,44,50
1523664707,The Walk-In,3,0,0,0,47,50
1523671416,The TeaTok Podcast,3,0,1,0,5,9
1523677421,rodrickrules,0,0,0,1,1,2
1523682676,Seforimchatter,0,0,0,1,13,14
1523682727,WW Weight Loss & Recovery With Sheila Jane,0,1,1,0,29,31
1523684874,Ramsey Call of the Day,0,0,0,1,8,9
1523686603,Upside Down Tulips - A Garden Podcast,0,0,0,0,9,9
1523686748,Public Books 101,0,0,0,0,7,7
1523702597,A Glass For Every Palate,0,0,0,0,11,11
1523705334,Sloydcast,0,0,0,0,5,5
1523709075,Within Our Gates,0,0,0,0,3,3
1523711606,Slow Cast Lounge,1,0,0,2,28,31
1523712088,American Shadows,9,11,6,9,15,50
1523712290,My Momma Told Me with Langston Kerman,2,0,0,0,48,50
1523714843,Search Party: The Podcast,4,0,1,0,16,21
1523722173,The Ringer Fantasy Football Show,1,1,3,2,42,49
1523729084,Barron's Live,1,3,0,1,2,7
1523736197,Leo Terrell: America's Fair Minded Civil Rights Attorney,2,0,0,3,182,187
1523751919,Weird Candy,0,0,0,0,1,1
1523755658,Is We Dumb?,1,0,2,1,46,50
1523767362,Lewis Black's Rantcast,1,0,0,3,26,30
1523778228,Ask Any Buddy,1,0,0,0,3,4
1523797911,Taskmaster Talks with Kevin Sullivan,0,3,2,1,7,13
1523851182,Outliers with Daniel Scrivner,0,0,0,0,4,4
1523855480,Mentors on the Mic,0,0,0,0,78,78
1523860202,lowkey,0,0,0,0,4,4
1523874874,Witness to Love Podcast,0,0,0,0,3,3
1523876635,OSI Today,0,1,0,0,1,2
1523877524,Obsessed With the Weather,0,0,0,0,9,9
1523898793,Think Like An Economist,1,3,3,6,13,26
1523899912,"MY PODCAST PERSONAL, DONT LISTEN OOOOOOK *WINK*",0,0,0,0,4,4
1523903890,Supreme Myths,0,1,0,0,5,6
1523910866,Bitcoin Fixes This,0,0,0,0,2,2
1523911533,The OutCast Presented by Outfest,0,0,0,0,11,11
1523914926,Indie Film Academy: A Filmmaking and Screenwriting Podcast,0,0,0,0,1,1
1523916037,corporate flight attendant podcast,0,0,0,0,2,2
1523945941,Awesemo UFC DFS,0,0,0,0,2,2
1523953952,Two Guys Talking Rush,0,0,0,0,1,1
1523966714,The Make An Impact Podcast,0,0,0,0,13,13
1523978541,Extra Paint - The @Muralists Podcast,0,0,0,0,13,13
1524017625,Be Effective Podcast,0,1,0,0,5,6
1524030654,"Gym, Tan, Laundry.",0,0,0,0,4,4
1524032937,Patrice O’Neal Archive,0,0,0,0,15,15
1524039134,The 20 Million Club,0,0,0,0,1,1
1524062252,The Odds Couple,1,0,0,0,0,1
1524074284,Amazing Animal Facts,0,0,0,0,1,1
1524080195,Nice White Parents,62,12,16,16,82,188
1524083342,Real Kyper at Noon,0,1,0,2,29,32
1524083348,Wild 'Til 9,15,2,4,7,472,500
1524089550,Black in Appalachia,1,0,0,1,25,27
1524138582,Dungeons &  Dipshits,0,0,0,0,1,1
1524153417,Big Boy’s Dynasty Fantasy Football League Podcast,0,0,0,0,1,1
1524156217,"The Good, The Bad & The Rugby",3,6,6,1,32,48
1524157997,You Don't Know Jack,0,0,0,0,1,1
1524158962,The AoT Chronicles (an Attack on Titan Podcast),2,2,0,0,47,51
1524174427,Aftermath Philadelphia,0,0,0,0,4,4
1524216377,"Rossifari Podcast - Zoos, Aquariums, and Animal Conservation",0,1,0,0,9,10
1524216431,Unearthed - Mysteries from an unseen world,0,0,0,0,4,4
1524223394,The Anxiety Chicks,0,1,2,4,43,50
1524224071,Fingers Crossed,7,14,3,5,77,106
1524226421,Goodnight Sleepyhead 😴🌙🌟Bedtime Stories,1,0,0,0,3,4
1524231220,Married at First Sight Divorced in Two Months,0,1,3,1,7,12
1524241581,Future Generations Podcast with Dr. Stanton Hom,2,0,0,0,29,31
1524250628,Empty Inside,4,2,6,10,156,178
1524292915,Zack to the Future,34,22,28,37,241,362
1524313515,Niners Nation: for San Francisco 49ers fans,1,0,0,0,9,10
1524317541,Divorced Not Dead,12,7,1,2,90,112
1524321800,Swings & Studies,0,0,0,0,2,2
1524344361,THE NETCHICKS,0,0,1,2,37,40
1524354283,No Laying Up: Crash Course,0,0,0,0,13,13
1524365155,Adventures In Black Cinema With Desmond Thorne,0,0,0,0,17,17
1524368626,The George Farmer Podcast,0,0,0,0,22,22
1524370117,The Brief with Gregg Jarrett,1,0,0,0,8,9
1524397276,Sound the Foghorn,0,0,0,0,2,2
1524412048,"Breezy Babies- Mom, Parent, Pregnant, Baby, Breastfeeding, Family, Postpartum",0,0,0,0,10,10
1524436115,We’re The Weird Ones Podcast,0,0,0,0,28,28
1524477137,Dynasty Underdog,0,0,0,0,2,2
1524487980,Halftime Report,2,0,1,0,14,17
1524521616,nya talks about object shows,0,0,0,0,1,1
1524526782,Al Madrasatu Al Umariyyah,0,0,0,0,4,4
1524527122,The Max EFX Podcast:  An Insider Look at the Special Effects Industry & Sci-Fi Fandom,0,0,0,0,4,4
1524533455,Junior to Senior with David Guttman,0,0,0,0,1,1
1524537987,Reddit adult stories. Reddit erotic sex stories. Reddit gonewildstories.r/gonewildstories.,7,0,0,0,10,17
1524540025,What's Missing,3,2,4,1,11,21
1524560206,Corked Stats,0,0,0,0,22,22
1524562625,Tough as Nails Recaps on Rob Has a Podcast,3,0,0,0,5,8
1524563462,THE TAKEAWAY GOLF,0,0,0,0,1,1
1524566675,Let's Talk Yoga,0,0,0,0,48,48
1524569596,The Ma and Pa Cast.,0,0,0,0,7,7
1524574790,Toothbrush Stories,1,0,0,0,4,5
1524576360,THIS IS REVOLUTION >podcast,0,0,0,0,4,4
1524588019,Convos with Costume Designers hosted by Mandi Line,0,0,0,0,7,7
1524599320,NSW Police State Crime Command – Investigations,2,3,1,5,18,29
1524636882,10 Years of One Direction - The Podcast,0,0,0,0,2,2
1524639472,HousePod,0,0,0,0,36,36
1524657839,Tanya's Table Podcast,0,0,0,0,10,10
1524662158,Ask A Black Person,0,0,0,0,1,1
1524662884,Pleasant Good Evening,0,0,0,0,2,2
1524670753,Accessible Yoga Podcast,0,0,1,1,10,12
1524671111,The Fifth Edition by Infinite Banking Authorized Practitioners,0,0,0,0,2,2
1524674295,Talking Nonprofits with Tephanie,0,0,0,0,3,3
1524675831,Murder In Your Ear-The Murder Mystery Podcast,1,0,0,0,9,10
1524683327,Cleaning Up. Leadership in an age of climate change.,0,0,0,0,2,2
1524688425,Sleep Meditation for Women,1,2,0,0,7,10
1524690758,The Magic Sash,0,0,2,0,10,12
1524711606,Bring Back Bronco: The Untold Story,5,1,6,3,29,44
1524730109,Awesemo PGA DFS,0,0,0,0,1,1
1524730465,Awesemo NASCAR DFS,0,0,0,0,1,1
1524730788,Awesemo MLB DFS,0,0,0,0,4,4
1524738355,Hockey IQ Podcast,0,0,0,0,3,3
1524740616,"The Nursing School Simplified Podcast with Cynthia Primavera, RN CCRN",0,0,0,0,3,3
1524747517,Godzilla Roundtable,0,0,0,0,1,1
1524754215,Extra Points with Cousin Sal & Dave Dameshek,9,6,8,7,74,104
1524755786,Laugh Lines with Cousin Sal & Rachel Bonnetta,0,0,1,0,9,10
1524778767,The Bomb,13,14,8,8,7,50
1524799660,Official Man City Podcast,0,0,0,0,2,2
1524803098,Well...I Liked It!,0,0,0,0,13,13
1524804967,Crossing The Lane Lines,0,0,0,0,1,1
1524809369,The Sorority Nutritionist Podcast,1,0,0,0,14,15
1524827108,Wonder And Awe,0,0,1,0,1,2
1524835935,The Yes Theory Podcast,3,1,2,3,125,134
1524837746,The Pit Presents: LAST WORDS,0,0,0,0,4,4
1524849139,Misters of the Dark,0,0,0,0,1,1
1524850586,The Matthew West Podcast,1,0,0,3,157,161
1524852647,Lauren Lake's Paternity Court,0,0,0,1,7,8
1524856425,Big Drive Energy,0,0,0,0,8,8
1524856936,New Polity,0,0,0,1,5,6
1524865074,Big Ass Runner Trail Running Podcast,0,0,0,0,42,42
1524865133,On the Ear: An Audiology Podcast,0,0,0,0,5,5
1524865519,Sassquad Trail Runners,0,0,0,0,1,1
1524875185,Handle with CARE: Breast Cancer & Beyond,0,0,0,0,16,16
1524886990,The Success Lift Podcast,0,0,0,1,38,39
1524912495,Weird Christian Twitter - The Podcast,0,0,0,1,10,11
1524940951,Indiecast,1,1,0,1,30,33
1524945336,The Burn Bag Podcast,0,0,0,0,1,1
1524969724,Fridays at Five,2,2,0,2,19,25
1524975295,Brawl Stars,6,0,1,0,2,9
1524979782,Home Skool w/ Andrew Rivers and Cory Michaelis,0,0,0,0,6,6
1524989908,Conservation Conversations with Sean O'Brien,0,0,0,0,8,8
1524996468,Nights of Eveningstar,0,0,0,0,14,14
1525002709,Unprotected Sets,0,0,0,0,1,1
1525007742,Second Print Comics Podcast,0,0,0,0,25,25
1525013222,DARK - A Companion To The Netflix TV Series,0,0,0,0,5,5
1525019035,Dan O Says So,0,0,0,1,1,2
1525024185,Always and Forever l A One Tree Hill Podcast,0,0,0,0,10,10
1525039108,The Distraction: A Defector Podcast,6,2,1,4,108,121
1525043025,ATN - Teaching To Thrive,1,0,0,0,16,17
1525043882,Motherhood in Black & White,0,0,0,0,38,38
1525050646,Quilting Stories podcast,0,0,0,0,1,1
1525096665,Very Amusing with Carlye Wisel,7,2,2,3,486,500
1525098036,Saving Lives Podcast: Critical Care w/eddyjoemd,0,0,0,0,15,15
1525100049,P.K. Subban's Ugly Duck Podcast,0,0,0,0,20,20
1525104326,AmphibiCast,1,0,0,0,7,8
1525122027,Prepper News and Survival Tips with Duff & Dale,1,2,0,1,12,16
1525139564,The Sideline,0,0,0,0,3,3
1525139950,Relationships and Relationshits,0,0,0,0,8,8
1525146019,The Catmaste Chronicles Podcast,0,0,0,0,1,1
1525148857,Generative Energy Podcast,0,0,0,0,3,3
1525150200,Soccer Cards United,0,0,0,0,14,14
1525173181,Thompson 2 Clark - A Giants Podcast,0,0,0,0,10,10
1525212317,Legal Docket,0,0,0,0,50,50
1525220847,The Lisa Ann Experience,0,0,0,0,11,11
1525223663,Pawd Pod,0,0,0,0,6,6
1525225214,Locked On MLB Prospects,0,0,0,0,18,18
1525227803,The Aristotle Project,0,0,0,0,1,1
1525244212,TEMIPREACHES,0,0,0,0,1,1
1525246156,The Business Growth Pod with Allan Draper,0,0,0,0,29,29
1525256191,R2C2 with CC Sabathia and Ryan Ruocco,2,1,0,5,28,36
1525261018,CEO School,0,0,0,0,96,96
1525269813,The Judge Jeanine Tunnel to Towers Foundation Sunday Morning Show,1,0,0,0,6,7
1525269951,CushVlogs Audio - Matt Christman - Chapo Trap House,2,0,0,0,26,28
1525271300,The Journey On Podcast,0,0,1,0,27,28
1525273030,Scooter & The Big Man,1,0,0,0,8,9
1525273275,Snake Talk,0,0,0,0,3,3
1525281746,The Old Man and the Three with JJ Redick and Tommy Alter,8,1,1,7,341,358
1525292494,VIN Foundation: Veterinary Pulse,0,0,0,0,6,6
1525296416,Better Call Daddy,0,0,0,0,63,63
1525301754,NBA Gambling Podcast,0,0,0,0,18,18
1525311647,Best Laid Plans,0,0,0,0,50,50
1525324791,How to Waste your Time,0,0,0,0,1,1
1525340874,The Honkytonk Jukebox Show,0,0,0,0,1,1
1525348866,The Wilhelm Team,0,0,0,0,1,1
1525357417,In Deep,0,0,1,0,5,6
1525377432,The Weekly Streamer Dynasty Baseball Podcast,0,0,0,0,3,3
1525399892,Chess Knowledge With H1,0,0,0,1,3,4
1525402495,Everything Dog Training!,0,0,0,0,2,2
1525418064,"Mr. Chazz's Leadership, Parenting and Teaching Podcast",1,0,0,1,8,10
1525423507,The Hidden Djinn,0,0,0,2,48,50
1525427745,The Sesh Podcast,1,2,0,0,47,50
1525429215,The Uncomfortable Podcast,0,0,0,0,14,14
1525430395,Very Presidential with Ashley Flowers,205,41,28,18,207,499
1525432576,The Bubba Army Podcast,2,0,0,2,46,50
1525433575,Let's Get Uncomfy Podcast!,0,0,0,0,50,50
1525449420,Walking is Fitness,0,0,0,0,1,1
1525453766,Trashy Trashy,0,0,1,0,48,49
1525467255,Social Worker's Break Room,0,0,0,0,3,3
1525475762,Devy Marketplace,1,0,2,0,20,23
1525478250,Sexy Stories with Chantelle Otten Sexologist,1,0,0,0,5,6
1525493536,Soccer Gambling Podcast,1,1,0,1,95,98
1525514686,Tennis IQ Podcast,0,0,0,0,1,1
1525571502,The Desert Dirt Biker Podcast,0,0,0,0,2,2
1525585763,Just King Things,0,0,1,0,14,15
1525599112,"Midnight, On Earth",0,0,0,0,3,3
1525604734,The E-Spot With Camille,0,0,0,0,1,1
1525606955,High Action,0,0,0,0,3,3
1525608019,Against All Odds with Cousin Sal (Extra Points Edition),3,0,1,1,16,21
1525609638,Bedtime Stories - Mrs. Honeybee,1,0,1,1,6,9
1525610340,Pantry Chat,0,0,0,2,48,50
1525612171,Far From Par,0,0,1,2,11,14
1525619563,The Bunkered Golf Podcast,0,0,0,0,1,1
1525620301,Geology Bites By Oliver Strimpel,0,0,0,0,2,2
1525621247,Mars Technica,0,0,0,0,1,1
1525621876,Constructed Resources,0,0,0,0,12,12
1525638375,Biologists Being Basic,0,0,0,0,1,1
1525643497,Chewing the Gristle with Greg Koch,0,0,0,0,12,12
1525644565,mymaria777,3,1,0,0,46,50
1525652021,Malevolent,0,0,0,0,5,5
1525654825,Geeta Girl: Evolving Through the Bhagavad Geeta,0,0,0,0,14,14
1525658519,Strange New Worlds of Dimension X Minus One OTR,0,0,0,0,1,1
1525663883,Aotearoa Rugby Pod,0,0,0,0,1,1
1525666482,Rock Logic with Sean Kenny,0,0,0,0,1,1
1525669538,Awakened to Reggio,0,0,0,0,4,4
1525688720,Stories we could tell,1,0,0,0,5,6
1525689066,Ask Lisa: The Psychology of Parenting,0,1,0,0,21,22
1525700730,Talking Dirty,0,0,0,0,1,1
1525719645,Quick Spin,0,0,1,1,5,7
1525724630,Awesemo NBA DFS,0,0,1,0,41,42
1525727534,Embodied,0,0,0,0,22,22
1525735255,Mostly Superheroes,0,0,0,0,4,4
1525744587,Peanut Butter Jelly Time,0,0,0,3,37,40
1525768713,Daughters of DC,1,0,4,2,18,25
1525769448,VICE News Reports,2,0,0,0,40,42
1525769739,Bald Talk,1,0,0,1,15,17
1525787664,Suuuper Anime Podcast,0,0,0,0,1,1
1525795747,Dear Shandy,0,2,1,0,102,105
1525805825,Billionaire Boys Club,29,27,21,15,75,167
1525806038,BONSAI POPcast,1,0,0,0,7,8
1525871980,Sounds Good by Harish Shankar,0,0,0,1,5,6
1525906889,Hair Goals Podcast,1,0,1,0,2,4
1525936566,People I (Mostly) Admire,5,1,2,2,51,61
1525941053,Learn Spanish with Live Lingua,0,0,0,1,14,15
1525941137,Uforia Music,0,0,0,0,1,1
1525947224,The Bones Zone,2,0,0,0,18,20
1525951683,Baking with House of Bread,0,0,0,0,5,5
1525952293,Ideas of India,1,0,1,0,0,2
1525954028,The Stars Made Me Do It,0,0,0,0,11,11
1525955817,How to Save a Planet,6,4,4,4,173,191
1525966785,The Unfinished Print,0,0,0,0,1,1
1525971285,Leaving Eden Podcast,0,1,0,0,7,8
1525975837,Virtual Production,0,0,0,0,2,2
1525986620,The Kennedy Assassination,1,0,0,0,5,6
1525987370,Swiss and Lali Hijack HOLLYWOOD!,0,0,0,0,5,5
1525992325,Up and Away,0,0,0,0,1,1
1525997434,A brush with...,0,0,0,0,4,4
1526009427,Jesus  Freaks: Vinyl to Digital,0,0,0,0,1,1
1526013871,Awesemo NHL DFS,0,0,0,0,1,1
1526015775,The Queer Quadrant,0,0,0,0,9,9
1526016434,Farthouse,0,0,0,0,18,18
1526018039,Designing Hollywood Podcast,0,0,0,0,6,6
1526021730,The Power of Now - A Guide to Spiritual Enlightenment with Linda and Barbara,0,0,0,0,3,3
1526026703,The Broken Record Player Podcast,0,0,0,0,1,1
1526028174,Literary Joe's Inner Child Podcast,0,0,0,0,2,2
1526030779,White on Rice,0,0,0,0,7,7
1526034101,The Side Track,1,0,0,0,16,17
1526037200,Dreamy,1,0,2,4,43,50
1526052972,Sexual Heroes with Robert Black,0,0,0,0,4,4
1526064988,Post-Credit Podcast,1,1,1,1,27,31
1526066401,Vixen: Black Beauty and Pop Culture,0,0,0,0,10,10
1526066728,Lovecraft Country Radio,30,13,16,27,409,495
1526087153,Locked On Blue Jackets - Daily Podcast On The Columbus Blue Jackets,0,0,0,0,2,2
1526087977,Bacon Bets Podcast,0,0,0,1,16,17
1526102708,Just Been Revoked,1,0,0,1,8,10
1526131586,Chain Clankers Disc Golf,0,0,0,1,15,16
1526137629,The Steady Stater,0,0,0,0,1,1
1526144316,Remember Me,0,0,0,0,8,8
1526166945,Comes A Time,1,1,2,2,35,41
1526168719,Diamond & Silk: The Podcast,4,0,0,1,156,161
1526171163,Dave's 5 Hot Takes,0,0,0,0,57,57
1526181315,NW Fish Passage,0,0,0,0,7,7
1526186618,"Savannah, Georgia: Anything But Ordinary",0,0,0,0,4,4
1526206712,In VOGUE: The 1990s,1,1,3,2,19,26
1526208231,The High Performance Zone,0,0,0,0,7,7
1526239058,Going Plus Ultra With Zach Stroes,0,0,0,0,1,1
1526243082,Always Be Birdin',0,0,0,0,10,10
1526245986,90 Day Fiance RHAP-ups,1,0,0,0,19,20
1526253158,Better Than I Found It,0,0,0,0,16,16
1526261797,Kev Hick Talks Everything,0,0,0,0,5,5
1526304852,Chilling True Tales - True Ghost and Paranormal Stories,0,0,0,1,0,1
1526317915,No Suga On Dee Rim,0,0,0,0,6,6
1526325043,D&D: Optimized,0,0,1,0,3,4
1526329377,Modern Classrooms Project Podcast,0,0,0,0,3,3
1526334812,White Sox Nation Podcast,0,0,0,0,1,1
1526345730,She Rates Dogs: The Podcast,12,0,0,1,234,247
1526351736,SpaceX,0,0,0,0,2,2
1526356031,Garden Parties FC,0,0,0,0,1,1
1526361068,on the floor,0,0,0,1,20,21
1526377582,Old Crazy Runners - the Podcast,1,0,0,0,8,9
1526378942,Pass-Through Frequencies,0,0,0,0,19,19
1526393902,The Department:  a podcast about trends.,0,0,0,0,18,18
1526406609,Sounds Like Hate,2,0,1,0,37,40
1526421181,The Dime Store Cowgirls,0,0,0,0,45,45
1526452361,Heirs of The Pandavas,0,0,2,1,10,13
1526467894,Smash Accept Dynasty Trades,0,0,0,0,31,31
1526477480,The Bulwark Goes to Hollywood,0,0,0,0,36,36
1526477866,Sew Mindful Podcast,0,0,0,0,1,1
1526481041,Wake N Jake,0,0,0,0,50,50
1526483896,Life and Books and Everything,0,0,1,0,40,41
1526490428,The World Wars,1,0,1,0,2,4
1526507264,Relatos de la Noche,0,0,0,0,15,15
1526508622,Pendulum Land Podcast,0,0,0,0,11,11
1526572439,Witch and Goddess,0,0,0,1,5,6
1526579004,"Love, Sex, and Applied Behavior Analysis",0,0,0,0,6,6
1526579247,One Strange Thing,4,0,3,3,27,37
1526581627,Relative Unknown,3,7,18,18,382,428
1526592604,Lean Leadership for Ops Managers,0,0,0,0,7,7
1526611407,It's Solid Food,0,0,0,0,6,6
1526628969,Why Satan,0,0,0,0,1,1
1526669763,TLDR Daily Briefing,0,0,0,1,1,2
1526678597,Halfway Cray Podcast,0,0,0,0,1,1
1526682330,Paper Ghosts,42,44,55,38,202,381
1526683075,What's Going On With AABE?,0,0,0,0,1,1
1526685583,Homeschool Together Podcast,0,0,0,0,8,8
1526687124,Trish Intel Podcast,2,0,0,1,47,50
1526698004,Enjoy the Podcast,0,0,0,0,42,42
1526702728,Stitch Talk,0,0,0,0,1,1
1526703087,"TLC Barrels, Barrel Racing Coach",0,0,0,0,1,1
1526711465,Let’s Talk CP,0,0,0,0,1,1
1526717452,Talent Stacker,0,0,0,0,11,11
1526720430,Everyone is Terrible,0,0,0,0,58,58
1526729282,SpyHards Podcast,0,0,0,0,24,24
1526731368,Random Number Generator Horror Podcast No. 9,0,0,1,1,9,11
1526747332,Bunga Bunga,69,57,56,32,237,451
1526751534,Justice Matters with Glenn Kirschner,0,0,0,0,50,50
1526765602,What Will She Do Next?,0,0,0,0,12,12
1526771222,Hot Tea Hot Takes,0,0,0,0,7,7
1526787177,The Vampire Diaries,0,1,0,0,1,2
1526826039,Tom and Jerry Show,0,0,0,0,1,1
1526840424,Sleepover Cinema,0,0,0,0,21,21
1526882382,SUBTEXT Literature and Film Podcast,0,0,0,1,30,31
1526885135,Blurry Creatures,3,0,2,1,55,61
1526888280,Killed by Desk,0,0,0,0,8,8
1526892024,Missin Curfew,3,0,8,3,46,60
1526898794,The World Is Wrong,0,0,0,0,1,1
1526907722,A Special Take with Sid and Tyler,0,0,0,0,1,1
1526910040,Where the Bodies Are Buried,32,19,17,9,127,204
1526912253,ScrapHappier,0,0,0,1,20,21
1526914053,Guided Audio Runs - Get Fit Done,0,0,0,0,4,4
1526915967,BardsFM,1,1,1,1,63,67
1526916850,Kentucky Daily,0,0,0,0,20,20
1526947030,Habitual Routine,0,0,0,0,3,3
1526957047,To See Each Other,1,0,0,0,12,13
1526997710,The Ravens - a One Tree Hill Podcast,0,0,0,0,14,14
1527006091,Brown Petri Dish,0,0,0,0,1,1
1527007748,Nba_youngboy,4,0,0,0,3,7
1527008181,UNmuted,0,0,0,0,5,5
1527015895,Homies of Horror,0,0,0,0,9,9
1527018692,Risk of Ruin,0,0,0,0,5,5
1527024935,Debt Free Degree,0,0,0,0,15,15
1527028887,Think On Your Faith,0,0,0,0,3,3
1527031191,YOU ARE WORTHY with LilMookieB,0,0,1,1,39,41
1527034211,The Opinionated Sixth Man Podcast,0,0,0,0,8,8
1527035565,Beck Did It Better,0,0,0,0,5,5
1527041332,Starcastic Remarks-The Only Dallas Stars Fan-Led Podcast,0,0,0,0,2,2
1527059276,Andy Raymond #UNFILTERED,0,0,0,0,2,2
1527064197,MMWR Weekly COVID-19 Briefing,2,1,0,0,3,6
1527094379,The Deal,0,0,0,1,15,16
1527098974,Truth Doctor Podcast,1,0,0,1,48,50
1527112668,Sparkle Stories Podcast,1,0,0,0,1,2
1527123481,The Best Soccer Show,0,0,0,2,99,101
1527139771,2HotWives - A Girl's Guide to Unconventional Sex,0,0,0,0,16,16
1527141577,Medical Murders,16,15,17,10,79,137
1527152221,Pelo Buddy TV,2,2,0,0,2,6
1527153312,Go Deep in the Shallow,0,0,0,1,15,16
1527159764,StoryLearning Spanish,0,0,0,0,50,50
1527172504,Natural Health for People and Pets Podcast,0,0,0,0,1,1
1527196035,NN/g UX Podcast,0,0,0,0,3,3
1527204577,Battle of the Bands,0,0,0,0,2,2
1527249338,Dingles & Dangles: A Dungles & Dongles Podcast,0,0,0,0,3,3
1527266745,Lightning Insider,1,0,0,0,35,36
1527277365,Wrestling History 101,0,0,0,0,6,6
1527280716,It Was Said,10,4,0,3,33,50
1527289974,Breaking Conservatarian,0,0,0,0,1,1
1527290424,Hillbilly  HazBenz,0,0,0,0,9,9
1527291038,Verzuz,0,0,0,0,1,1
1527302094,Off Grid Pros,0,0,0,0,3,3
1527309309,No Turning Back,1,0,0,0,10,11
1527310686,Cancelled for Maintenance,0,0,0,0,10,10
1527315101,Conserving Torah with Rabbi Mark Gottlieb,0,0,0,0,2,2
1527321744,Human Powered,0,0,0,0,1,1
1527323627,We Are For Good Podcast - The Podcast for Nonprofits,0,0,0,1,28,29
1527325830,“Use your inside voice”,0,0,0,0,4,4
1527335630,CNN Political Briefing,2,1,2,0,8,13
1527362747,Composed,0,0,0,0,24,24
1527393169,Passions for Life,0,0,0,0,29,29
1527397803,Let's Be Cleere,0,0,0,0,79,79
1527410112,The Queen Podcast,0,0,0,0,20,20
1527434899,The Marketing Millennials,0,0,0,0,10,10
1527436159,Sippin' On Sweet Tea,0,0,0,0,1,1
1527442592,Matis Zelman Nach shiur,0,0,0,0,2,2
1527444818,The Evolving Angler,0,0,0,0,3,3
1527463667,The American Compass Podcast,1,0,0,0,2,3
1527466417,Carl Jung's Red Book + Astrology,0,0,0,0,16,16
1527477975,Rules of the Game: The Bolder Advocacy Podcast,0,0,0,0,2,2
1527478719,Cyber Security Headlines,0,0,0,0,4,4
1527479270,The Narcissistic Abuse Recovery Podcast,0,0,0,0,28,28
1527481539,Tendy Talk,0,0,0,0,1,1
1527482552,A Year of Zen,0,0,0,0,4,4
1527486300,Business on the Bright Side,0,0,0,1,49,50
1527487660,The SI Fantasy & Gambling Podcast,0,0,0,1,5,6
1527495372,Bonsai Wire,0,0,0,0,7,7
1527504836,Polar Conversations,0,0,0,0,1,1
1527510577,Bent,30,11,11,5,123,180
1527523374,The Keks Podcast,0,0,0,0,5,5
1527536282,Plant School,1,0,0,0,2,3
1527545442,The Mid•Point with Gabby Logan,0,2,0,2,40,44
1527568824,Speed and Power Podcast,0,0,0,0,2,2
1527581760,The Boone Podcast,0,0,0,0,7,7
1527588804,Women Of Project Management,0,0,0,0,18,18
1527590100,Flip Your Lid with Kim Honeycutt,0,0,0,0,4,4
1527591762,Dimes and Dozens,1,0,0,0,15,16
1527603706,The Nani Network,0,0,0,0,11,11
1527609031,Greeny,50,11,2,2,33,98
1527609854,The Dr. John Delony Show,5,1,3,2,39,50
1527611799,Peacock and Williamson NFL Show - Daily Podcast Powered by Locked On,2,0,2,2,48,54
1527615779,The Pearl Jam Stories,0,0,0,0,1,1
1527633181,The Crafty Gemini Podcast,0,0,0,0,6,6
1527649477,The Hangar Z Podcast,0,0,0,0,8,8
1527658738,The Shared Shutter,0,0,0,0,27,27
1527740349,All Indians Matter,3,1,0,0,1,5
1527772333,Escaping NXIVM,4,2,1,6,17,30
1527775276,Stories from China's History for Kids,0,0,0,1,0,1
1527777183,Spencer & Vogue,9,3,0,3,63,78
1527777879,Unjust & Unsolved,12,0,7,8,375,402
1527817161,RiverSpeak: stories that ripple,0,0,0,0,1,1
1527827740,"Grow it, Minnesota",0,0,0,0,1,1
1527832549,The Interview,2,0,0,0,13,15
1527835620,The BrewDeck Podcast,0,0,0,0,1,1
1527837623,MIND your hormones,0,0,0,0,18,18
1527840344,The Strology Show,0,0,0,0,24,24
1527843633,Life with Fire,0,1,0,0,4,5
1527848875,Redspin Sports,0,0,0,0,3,3
1527889790,Friends to Lovers,1,0,0,0,56,57
1527891739,Bigfoot’s Wilderness Podcast,0,0,1,0,6,7
1527895588,Hye Jams Radio,0,0,0,0,8,8
1527896223,This Ends at Prom,0,0,0,0,21,21
1527929846,The Girly Girl Podcast,0,0,0,1,30,31
1527933067,The Folk Podcast,0,0,0,0,4,4
1527938147,Paws & Reward Podcast,0,0,0,0,9,9
1527940173,Orange Pill Podcast,2,0,1,0,47,50
1527940333,Romancing the Pod,0,0,0,0,78,78
1527944137,FTN NBA Podcast,0,0,0,0,11,11
1527946812,Beekeeping For Newbees,0,0,0,0,7,7
1527948382,Why Are Dads?,1,0,1,1,47,50
1527959093,Intimate Covenant Podcast,0,0,0,0,10,10
1527968577,The Jeremy White Podcast,0,0,0,0,1,1
1527982509,Jewish History Uncensored,0,0,0,0,4,4
1527984094,Lux Radio Theatre,0,0,0,0,1,1
1528014928,Grandstand Golf,0,0,0,0,2,2
1528016907,Ketogenic Bodybuilding Podcast,0,0,0,0,12,12
1528025331,After Mash,0,0,0,0,11,11
1528028046,Rob Goldstone is an Englishman in ...,0,0,0,0,46,46
1528031655,Super Scary Stories Pod,0,0,0,0,2,2
1528037344,Name 3 Songs,0,0,0,0,34,34
1528039939,Establish the Edge,1,0,0,0,10,11
1528040083,The Danger Room: A Marvel Crisis Protocol Podcast,0,0,0,0,1,1
1528040283,Tom Brown's Body,17,11,26,24,318,396
1528042513,Aquadocs,0,0,0,0,7,7
1528050811,Slappin' Glass Podcast,0,0,0,0,4,4
1528060427,Timber Wars,1,2,3,1,74,81
1528061955,A Cottagecore Life,0,0,0,1,0,1
1528068689,Be Createfull,0,0,0,0,15,15
1528075107,The Air Up There,0,0,0,1,4,5
1528116832,Pawareness Podcast,0,0,0,0,12,12
1528122776,Simms Getz It,0,0,0,0,4,4
1528148759,Papal Aspirations,0,0,0,0,4,4
1528168044,The Hollow,0,0,0,4,46,50
1528179983,American Coyote,33,5,9,6,78,131
1528202364,Ruined with Alison Leiby and Halle Kiefer,0,0,0,0,81,81
1528209332,The Artscroll Studios' Podcast,0,0,0,0,3,3
1528209872,Geology On The Rocks,0,0,0,0,2,2
1528220101,Twin Beds,0,0,0,0,5,5
1528233207,EWN - Engineering With Nature,0,0,0,0,1,1
1528236322,GMS Thundercast,0,0,0,0,2,2
1528236676,Sunny 16 Presents,0,0,0,0,2,2
1528242019,La latina con baja autoestima con Rosie Mercado,0,0,0,0,1,1
1528248071,Gate 7 International Podcast,0,0,0,0,6,6
1528267426,The GreatBase Tennis Podcast,0,0,0,0,23,23
1528340492,New Real Estate Agent Mindset,0,0,0,0,3,3
1528342358,Fnaf And Undertale Songs,2,0,0,0,0,2
1528364708,Laugh Tracks Legends of Comedy with Randy and Steve,0,0,0,0,1,1
1528386150,The Bloody Disgusting Podcast,0,0,0,0,15,15
1528411992,Locals Know Best,0,0,0,0,12,12
1528419883,Horse Training in Harmony,0,0,0,0,54,54
1528422144,Dad Strides,0,0,0,0,4,4
1528435132,Tay To Z: A Taylor Swift Podcast,1,0,0,0,28,29
1528458673,Fantasy Football Confidential,0,0,0,0,25,25
1528462105,Dodgers Nation: Dodgers Dougout,0,0,0,0,5,5
1528481399,Chulbuli Tales Podcast,0,0,0,1,3,4
1528486384,SIKE WARD,0,0,0,0,25,25
1528488290,Bottle Ship Adventures,0,0,0,0,48,48
1528529944,Awesemo NFL DFS & Fantasy Football,0,1,0,0,3,4
1528535502,Market Mondays,1,0,1,0,198,200
1528547910,21st & Prime,3,2,3,0,45,53
1528559615,Market Meditations,0,0,0,0,3,3
1528568221,Oxventure - A Dungeons & Dragons Podcast,0,1,0,0,49,50
1528594034,Sway,38,8,26,16,110,198
1528594654,Funny Stories w/ Ocean Glapion,0,0,0,0,4,4
1528612213,The Village,0,0,0,0,2,2
1528612370,The Let’s Talk About It Show,0,0,0,0,2,2
1528622068,The Athletic Football Show: A show about the NFL,7,0,4,2,214,227
1528634304,Fantasy Football Today in 5,0,1,0,0,55,56
1528655613,It's a Material World,0,0,0,0,1,1
1528657498,FutMexNation,0,0,0,0,2,2
1528667640,Generation Green New Deal,8,0,1,1,40,50
1528726846,Today with Claire Byrne,0,0,0,0,1,1
1528757906,Bad Counsel,0,0,0,0,50,50
1528759509,Toy Anxiety,0,0,0,0,13,13
1528772226,Ringtones,0,0,0,0,1,1
1528789502,Rob Smith is Problematic,0,1,2,1,46,50
1528794038,NTD News Today,0,0,0,0,4,4
1528796448,The Business of Data Podcast,0,0,0,0,1,1
1528797207,Praia dos Ossos,0,0,0,0,4,4
1528800850,Spanish in 5 minutes - Beginner,0,0,0,0,1,1
1528803511,The Great American Urban Legend,0,0,0,0,9,9
1528833197,Who's That Girl? A New Girl Podcast,1,2,0,1,3,7
1528834160,The Webtoon Room Podcast,0,0,0,0,1,1
1528858998,Your Cardano Update,0,0,0,0,2,2
1528859625,WKRP-Cast,0,1,0,1,13,15
1528860764,Sly Flourish's Lazy DM Prep,0,0,0,0,1,1
1528861092,PlanetGeo,0,0,0,0,15,15
1528861745,Comptia Network+ --- Computer Networking for Cybersecurity,1,0,0,0,1,2
1528864292,Dude! Nature,0,1,0,0,21,22
1528868897,Runner Moms,0,0,0,1,3,4
1528872737,Film at Fifty,0,0,0,0,5,5
1528872739,The Study,1,0,0,0,30,31
1528873843,Stories for Wonderful Children,0,0,0,0,6,6
1528874993,Temptation Island RHAPup Podcast,2,1,0,0,34,37
1528899226,TrainBrave Podcast,0,0,0,0,1,1
1528899704,Build a Career in Data Science,0,0,0,0,3,3
1528900769,Department of Homelander Security,0,0,1,1,1,3
1528907211,Anesthesia Guidebook,0,0,0,0,6,6
1528917264,Goofin' with Luke Gaston,0,0,0,0,4,4
1528917542,I Don't Know With Jojo & KevOnStage,0,0,0,1,31,32
1528918177,You Can Do It with JEFF GALLOWAY,0,0,0,1,5,6
1528921370,Seminole Wrap: A Florida State Football Podcast,1,0,2,1,16,20
1528922538,The Town Whispers,5,2,2,0,6,15
1528971473,The Powers of Math,0,0,0,0,1,1
1528975995,In Play with Craig Mattick,0,0,0,0,2,2
1528990170,"Have Kids, They Said…",0,0,1,0,22,23
1528998697,The Severin Films Podcast,0,0,0,0,16,16
1529001269,Time Warp Radio: The Rocky Horror Picture Show Movie-by-Minute Podcast,1,0,0,0,10,11
1529003965,The Co-op Show,0,0,0,0,11,11
1529006138,Carcerem,0,1,0,0,32,33
1529008803,Realfoodology,0,0,1,0,14,15
1529009628,Oprah’s Book Club,18,1,2,4,76,101
1529010237,All The Asians On Star Trek,0,0,0,0,7,7
1529010597,Recall: How to Start a Revolution,0,0,0,0,4,4
1529011007,Life On Purpose with Erica Layne,0,0,0,0,27,27
1529014757,Blindspot: The Road to 9/11,0,0,0,7,43,50
1529018913,Girl F You,0,0,2,1,34,37
1529041458,The Yoga Nidra Podcast,0,0,0,0,3,3
1529045232,Windowsill Chats,0,0,0,0,42,42
1529046702,Metro Detroit Golfers Podcast,3,1,0,0,60,64
1529054291,Behind The Rose,6,1,0,4,54,65
1529055902,Horror In Session,0,0,0,0,5,5
1529056472,T.Rex Talk,0,0,0,1,22,23
1529056523,Journey With Me Through ADHD: A Podcast for Kids,0,0,0,0,15,15
1529082748,Potted Together,0,2,1,1,25,29
1529103764,Podcast Intermediate French,0,0,0,0,2,2
1529112023,The Dairy Download,0,0,0,0,2,2
1529138392,"Mindful Dog Talk | Dog Training, Dog Behavior, and Dog Psychology",0,0,0,0,1,1
1529149626,Lets Grow Pulling,0,0,0,0,1,1
1529169990,Talks from the Hoover Institution,0,0,0,0,1,1
1529174742,Hank the Cowdog,0,1,3,1,45,50
1529183274,The Ba-Dum-Ching! with Carl,0,0,0,0,6,6
1529185995,JEW-ISH,0,0,0,0,2,2
1529215797,Sparkleside Chats with Magical Girl Ayu,0,0,0,0,2,2
1529217923,That's So Mets Podcast,1,0,0,0,75,76
1529257352,Le French Rugby Podcast,0,0,0,0,3,3
1529278762,Taylored Talks,0,0,0,0,5,5
1529285303,Our Gifted Kids Podcast,0,0,0,0,1,1
1529290295,Green with Envy,0,0,0,0,3,3
1529294400,City on a Hill: Kansas City,0,0,0,0,5,5
1529295569,No Mans Land,0,0,0,0,11,11
1529318900,Bio Eats World,3,0,0,0,8,11
1529322197,The Investopedia Express with Caleb Silver,1,0,0,1,12,14
1529323964,Story time with Philip and Mommy!,0,0,0,0,4,4
1529330212,Shooting For Grand,0,0,0,0,3,3
1529339795,New England Hockey Journal’s The Rink Shrinks,0,0,1,0,22,23
1529341108,Divine Living,0,0,0,2,245,247
1529341876,Unpacking Israeli History,0,1,0,1,18,20
1529343755,One By Willie,0,0,0,2,48,50
1529343876,Let's Be Single Together with Big Al,0,0,0,2,33,35
1529346075,Hell & High Water with John Heilemann,2,3,1,6,188,200
1529346857,Not Your Papa's Podcast,1,0,0,0,3,4
1529347550,Melanie martinez,0,0,0,1,5,6
1529348933,What's Her Story With Sam & Amy,1,0,0,0,18,19
1529351932,Greg Bedard Patriots Podcast with Nick Cattles,2,1,1,0,36,40
1529355597,Kevin Kietzman Has Issues,12,3,0,3,32,50
1529359232,The Plant a Trillion Trees Podcast,0,0,0,0,3,3
1529370760,The Underworld Podcast,2,0,0,0,28,30
1529374107,Confident Collective,0,0,1,0,33,34
1529381375,Dog or Pass Podcast,0,0,0,0,96,96
1529406290,D100 Talk,0,0,0,1,8,9
1529419354,Our Love Journey With Mpoomy & Brenden,0,0,1,2,46,49
1529476065,Dread and Breakfast,0,0,0,0,5,5
1529476936,A Pinball Podcast,0,0,1,0,2,3
1529478357,Lean Six Sigma Bursts,0,0,0,0,1,1
1529478855,The Bushwick Bears Petty Crime Review,0,0,0,0,6,6
1529482149,TRAFFICKED,0,0,0,1,12,13
1529487340,The Daily Sun-Up,0,0,0,1,12,13
1529489359,B2B Marketing Leaders,1,0,0,0,29,30
1529497223,Castzilla VS The Pod Monster's podcast,0,0,0,0,4,4
1529497969,Naturalist Kids Podcast,0,0,0,0,9,9
1529509063,We're Going There with Bianca Juarez Olthoff,0,0,0,2,225,227
1529515305,Run For Something,1,1,0,0,9,11
1529523686,The Phenomenon Report,0,0,0,0,1,1
1529524084,EmPowered Radio,0,0,0,0,50,50
1529545371,Push The Envelope: Unfiltered Conversations With And About Hollywood,0,0,0,0,7,7
1529552931,Cricket Nagaram - A Telugu Podcast,0,0,0,0,2,2
1529570521,Another Podcast Tonight!,0,0,0,0,24,24
1529588291,Politely Rude With Abby Johnson,5,0,0,2,40,47
1529604634,Ghost Notes,0,0,0,0,3,3
1529612543,The Super 6 Podcast,0,0,0,0,1,1
1529617900,CEREBRO,0,1,0,2,17,20
1529628558,The Wadeoutthere Fly Fishing Podcast,0,0,0,0,13,13
1529632122,No Compromise,39,7,8,11,90,155
1529653651,"THE BETTER BELLY PODCAST - Gut Health Transformation Strategies for a Better Belly, Brain, and Body",0,0,0,0,12,12
1529656785,Pediatric Meltdown,0,0,0,1,3,4
1529667681,Who We Are: A Chronicle of Racism in America,8,2,2,0,26,38
1529669346,The Recovery Atheist,0,0,0,0,1,1
1529670534,The Safety Struggle,0,0,0,0,7,7
1529675211,Who's There? A Podcast About Horror Fans,0,0,0,0,6,6
1529689442,Eden Grove: An Improvised Podcast,0,0,0,0,2,2
1529711040,Obsessed With The Best w/ Alex & Tina,0,0,0,0,12,12
1529746012,Ice Cold Takes: A New York Rangers Hockey Podcast,0,0,1,0,20,21
1529752991,The Leangains Podcast,0,0,0,0,3,3
1529756178,FREAKY TALEZ PODCAST,0,0,0,0,4,4
1529791365,Four Corners Fantasy Podcast,0,0,0,0,10,10
1529800263,The Thyroid Fix,0,0,0,0,29,29
1529814254,Double Barrel Gaming,0,0,0,0,7,7
1529830517,Film Crew 101,0,0,0,2,80,82
1529833492,Krystine's FLR Podcast,0,0,0,1,4,5
1529834010,Aging Otakus: A Retro Anime Podcast,0,0,0,0,5,5
1529847258,Is This Anything?,0,0,0,0,5,5
1529847511,Missing the Point with Myles David,0,0,0,0,4,4
1529867726,The Spiritual Academy,0,0,0,0,4,4
1529878332,Sex Outside,0,0,0,0,7,7
1529890287,TechPresso,0,0,0,0,5,5
1529893516,Recovering Gleek: A Glee Podcast,0,0,2,6,188,196
1529896611,Battleground with David Plouffe & Steve Schmidt,3,0,0,1,46,50
1529899231,Suplexes and Cervezas with Chavo Guerrero Jr.,0,0,0,0,10,10
1529908506,The Cashflow Contractor,0,0,0,0,3,3
1529930254,Baby Steps,2,0,0,2,46,50
1529931681,This Is Important,0,0,0,1,49,50
1529951307,Nutrition with Judy,0,0,0,0,2,2
1529978129,Good Mourning,0,1,0,0,5,6
1529979418,Turn Down for Walt,0,0,0,0,4,4
1529980714,WUSSY Movie Club,0,0,0,0,3,3
1529983261,Design Lab with Bon Ku,0,0,0,0,12,12
1529983509,The Verywell Mind Podcast with Amy Morin,1,0,0,2,47,50
1529985625,El Santo Rosario,0,0,0,0,2,2
1529988959,Russell Wilson's DangerTalk Podcast,8,2,4,7,54,75
1529989396,Seven & Seven Is Radio,0,0,0,0,3,3
1529994959,Geek No Evil featuring The DOPE NERDS,0,0,0,0,4,4
1530051155,We Are Not the Virus,0,0,0,0,2,2
1530073611,The Pet Healer,0,0,0,0,1,1
1530080864,Exploded View,0,0,0,0,1,1
1530081561,Back Again with Troopz,6,0,1,2,80,89
1530087415,Reel Abstractions,0,0,0,1,4,5
1530091193,Classical Kids Corner,0,0,0,0,1,1
1530093214,Improv is Dead,0,0,0,0,50,50
1530096159,Real Estate by Relationship™,0,0,0,0,12,12
1530100372,Tig and Cheryl: True Story,0,0,0,2,48,50
1530120086,Lone Star Keto,0,0,0,0,1,1
1530122075,Devilfruit,0,0,0,0,3,3
1530133296,Closing Crawl,0,0,0,0,6,6
1530137517,Unexpected Points,0,0,0,0,2,2
1530139030,What's Your Secret,0,0,0,0,18,18
1530142517,The Limitless Canine Podcast,0,0,0,0,4,4
1530171074,The Not So Simple Life,0,0,1,0,41,42
1530198903,Poke the Bear,0,0,0,0,6,6
1530216796,Celebrity Salute,0,0,0,0,1,1
1530217486,Unconditional Healing with Jeff Rubin,0,0,0,0,5,5
1530227762,Tangible Remnants,0,0,0,0,1,1
1530250126,The Shit No One Tells You About Writing,0,0,0,0,6,6
1530261634,Brainwashed,2,0,1,1,7,11
1530262072,The Super Secret Hive,1,0,1,1,30,33
1530289584,The Fire You Carry,0,0,0,0,18,18
1530308822,Ranting Rangers: A NY Rangers Podcast,0,0,0,0,1,1
1530309011,Hablemos de Mascotas con Dr.B Vet,0,0,0,0,25,25
1530315517,This Is Hardcore Podcast,0,0,0,0,18,18
1530316865,The A Team - A Pretty Little Liars Podcast,0,0,0,0,5,5
1530332681,Bronco Talk,0,0,0,1,15,16
1530376032,Shit 90s Shows Taught Me | Boy Meets World / Dawson's Creek/90s TV,0,0,0,0,7,7
1530400722,Haptic & Hue,0,1,0,0,8,9
1530416662,The Walk Around,0,0,0,0,2,2
1530427467,Service Business Mastery - Business Tips and Strategies for the Service Industry,0,0,0,0,6,6
1530432657,Real Gamer Hour,0,0,0,1,9,10
1530437967,NY Denim Hangs Podcast,0,0,0,0,5,5
1530440308,The SB Nation NFL Show,1,0,0,1,62,64
1530440503,Beyond Measure with Christina Whitlock,0,0,0,0,9,9
1530442177,Paint The Medical Picture Podcast,0,0,0,0,4,4
1530452735,GoodMusicThursdays Podcast,0,0,1,0,3,4
1530454245,Rediscovering the Indies,0,0,0,0,1,1
1530458196,Mesivta of Waterbury,0,0,0,0,2,2
1530504411,Colourful,0,0,0,0,1,1
1530581809,Weather Wise Guy Podcast,0,0,0,0,1,1
1530589673,Weather with Cliff Mass,0,0,1,1,21,23
1530636981,Kids Opinion Sport Talk,1,0,0,1,5,7
1530639447,Mea Culpa with Michael Cohen,4,2,4,2,38,50
1530648964,Rotten Tomatoes is Wrong (A Podcast from Rotten Tomatoes),3,2,0,0,13,18
1530677708,The Checkpoint,0,0,0,0,3,3
1530691206,Inside Java,0,0,0,0,3,3
1530696003,Shonen Tapes,0,0,0,0,7,7
1530700134,The Millennium Microphone - A Yu-Gi-Oh! Podcast,0,0,0,0,4,4
1530701242,Rockonteurs with Gary Kemp and Guy Pratt,0,0,0,0,15,15
1530706730,Know That: A Real Housewives Podcast,0,0,0,0,24,24
1530710233,Rudimental Mindset Podcast,0,0,0,0,3,3
1530711663,The Sip with Ryland Adams and Lizze Gordon,25,6,2,2,15,50
1530729605,The U.N.A.S.S. Midwatch,0,0,0,1,3,4
1530732716,interMISSION @ the CSO,0,0,0,0,7,7
1530746733,Sarde After Dinner Podcast,0,0,0,0,12,12
1530757200,A Simple Podcast,0,0,0,0,8,8
1530763001,Lady Justice: Women of the Court,0,0,1,0,2,3
1530826902,TinyHalls,1,0,0,0,1,2
1530831187,Speaking Torah,0,0,0,0,1,1
1530835989,The Kevin Malone podcast,0,0,0,1,1,2
1530847697,The FPL Wire,1,0,0,0,3,4
1530848037,Higher Battle,0,0,0,0,4,4
1530857297,Back Points,0,0,0,0,6,6
1530865329,Smell Ya Later,0,0,0,1,14,15
1530868357,Ska Boom - An American Ska & Reggae Podcast,0,0,0,0,3,3
1530869251,W.C.A.B. Podcast: a podcast about tech,0,0,0,0,2,2
1530883311,The Greatest Stories Never Told,0,0,0,0,3,3
1530916324,Same Old Spurs,0,0,0,0,1,1
1530941383,The Sith Council with Kristian Harloff,0,1,0,0,187,188
1530942087,All My Movies with Dan Murrell,1,0,0,1,187,189
1530946882,The New Englandah,0,0,0,0,16,16
1530949028,Mother Daughter Earth: an Environmental Sustainability Podcast,0,0,0,0,8,8
1530951020,BAIR Podcast,0,0,0,0,1,1
1530956662,The Genius Recipe Tapes,0,1,1,0,6,8
1530958741,Giving Done Right,0,0,0,0,14,14
1530961615,Tales by the Fireside - Bedtime stories and sleep meditation,2,0,0,1,1,4
1530965244,Ten Eight Podcast,0,0,0,0,16,16
1530969287,Weeb x Weeb,0,0,0,0,4,4
1530979002,Golden Age of Cardboard | A vintage sports card podcast,0,0,0,0,10,10
1530980027,Brad & Steve Do Pods,0,0,0,0,5,5
1530989219,The Pin Pod,0,0,0,0,15,15
1530994896,Shop Talk with the Sheriff,0,0,0,0,2,2
1530995881,The Crew Review,0,0,0,0,3,3
1530996749,The Drop,0,0,0,0,7,7
1531000011,Just B with Bethenny Frankel,2,0,0,4,49,55
1531001315,Upstream International,0,0,0,0,2,2
1531018667,Psychosocial Distancing,0,0,0,0,1,1
1531020539,ABCD:TOS,0,0,0,0,6,6
1531023690,Club Shay Shay,3,0,1,6,237,247
1531030448,Wellness Your Way with Megan Lyons,0,0,0,1,26,27
1531039155,Podcasts,0,0,0,0,2,2
1531072765,Mooch FM,2,0,0,1,10,13
1531087527,Salt Cast: The stories behind Rocket League Esports,0,0,0,0,5,5
1531120581,Tiny Urban Homesteading,0,0,0,0,1,1
1531129542,Wheelman Podcast,0,0,0,0,1,1
1531129546,The Dime Package,9,3,5,2,112,131
1531181386,The Millionacres Podcast,0,0,1,0,7,8
1531192509,Bad Faith,40,6,6,10,285,347
1531221910,CHARLI AND DIXIE: 2 CHIX,8,0,0,0,42,50
1531238413,The Dragon Ball Virgin,0,0,0,2,7,9
1531251458,The Third Person with Darrell Hammond and Chris Millhouse,1,0,0,0,16,17
1531273684,TCAP It Off: The To Catch a Predator Podcast,2,1,0,0,1,4
1531288520,Film Vs Film,0,0,0,0,2,2
1531305889,Ranger Bill,0,0,0,0,3,3
1531323790,PaintTalks's podcast,0,0,0,0,13,13
1531328827,Retail Reborn from The Business of Fashion,0,0,0,0,2,2
1531353807,Thoughts From Cami,0,0,0,0,2,2
1531354937,SOLD OUT: Rethinking Housing in America,1,2,1,1,36,41
1531355232,First Date Follow Up - The Jubal Show,1,0,0,0,8,9
1531355300,Idiots in the News - The Jubal Show,0,0,0,0,1,1
1531364770,Cherokee Tribune-Ledger Podcast,0,0,0,0,2,2
1531367495,Friends & Fiction,0,0,0,0,3,3
1531368072,So This Is What Happened...,0,0,0,0,2,2
1531373063,Too Hot For Hockey,1,0,0,0,0,1
1531380479,Appearances,0,2,1,0,69,72
1531380522,Everything Fab Four,0,2,0,1,2,5
1531383689,Adopt Me Podcast (Roblox),0,1,2,4,29,36
1531388216,Drag Us To Hell,0,0,0,0,4,4
1531388694,Your Bird Story,0,0,0,0,1,1
1531405176,How to Play Siri Audio Briefs,1,0,0,0,0,1
1531408688,Pause/Play,0,0,0,0,4,4
1531410525,The Directors Series with Cameron Beyl: A Film History Podcast,0,0,0,0,1,1
1531431977,XS - The Science & Supernatural Podcast,0,0,0,0,31,31
1531481126,Press 4 to Defuse | Your Weekly Valorant Competitive News,0,0,0,1,0,1
1531485565,Art Bound,0,0,0,0,5,5
1531497950,The Plain Truth !,2,0,0,0,0,2
1531498635,F-14 Tomcat ATG Radio show/Podcast,0,0,0,0,5,5
1531499335,Love Nature: The Biophilia Podcast,0,0,0,0,2,2
1531501584,Between The Lines with Melissa Reddy,2,0,0,0,2,4
1531503734,The Fatty Joe Show,0,0,0,0,6,6
1531521793,No Grey Zone Podcast,0,0,0,0,1,1
1531526110,American Consequences With Trish Regan,5,0,0,0,5,10
1531526782,Unbiased Science,0,0,0,2,19,21
1531527105,"Witches, Magic, Murder, & Mystery",0,1,0,2,20,23
1531533683,OCS Field Guide: A PT Podcast,0,0,0,0,17,17
1531534417,China In Focus,0,0,0,0,1,1
1531535720,Allure: The Science of Beauty,1,2,4,3,18,28
1531538073,Sports Cards Nonsense,13,9,6,4,36,68
1531547477,With Gourley And Rust,0,1,3,2,67,73
1531548700,Dipped In Tone,0,0,0,0,14,14
1531553118,Mr Gratitude Presents the living with Gratitude podcast,0,0,0,0,13,13
1531575249,Birdie Dads: A Golf Podcast For Dads,1,0,0,0,13,14
1531577958,The Anna Bey Podcast,6,1,2,7,475,491
1531578946,SlashU,0,0,0,0,10,10
1531584398,All Things Covered with Patrick Peterson and Bryant McFadden,1,0,0,0,54,55
1531585350,The Private Medical Practice Academy,0,0,0,0,7,7
1531586056,Today’s Lucky Winner,0,0,0,0,7,7
1531587395,The Simple Low Carb Lifestyle Podcast,0,0,0,0,1,1
1531588276,The APsolute RecAP: Physics 1 Edition,0,0,0,0,1,1
1531589966,Cup of Three,0,1,0,0,3,4
1531590247,Wrestling With My Partner Podcast,0,0,0,0,1,1
1531591984,Moms and Baseball,0,0,0,0,3,3
1531593864,Therapy Gecko,0,0,0,0,13,13
1531630039,Open World,1,0,0,0,12,13
1531636231,Cinedicate,0,0,0,0,1,1
1531639947,Best Whatever Ever! Stories for Kids,0,0,0,0,13,13
1531644965,BewilderBeasts,0,0,0,0,3,3
1531668796,The Glitch In The Code Show,0,1,0,0,7,8
1531685290,Gameplay,1,0,0,1,23,25
1531690420,How Didn't This Get Made?,0,0,0,0,1,1
1531695180,life i design: The Podcast,0,0,0,0,2,2
1531718384,The STOL Collective,0,0,0,0,2,2
1531721960,Y Nada Mas | A Real Madrid Podcast,0,0,0,0,3,3
1531738848,From Negative to Positive with Pitbull,0,1,1,0,30,32
1531746181,Development Hell,0,0,0,0,2,2
1531761241,Goodbye Crop Top,1,3,0,0,15,19
1531768983,You and Me Both with Hillary Clinton,107,3,1,9,380,500
1531771698,Safiq’s Corner,0,0,0,0,2,2
1531771739,Andy In The Morning - Majic 95.1,0,0,0,0,1,1
1531773213,Fairy Tale Fix,0,0,0,0,20,20
1531775772,The Dershow,35,2,4,2,103,146
1531785540,The Root Presents: It's Lit!,0,0,1,0,7,8
1531787104,SABACC TALK,0,0,0,0,18,18
1531790080,Living & Learning with Reba McEntire,0,0,0,2,73,75
1531791088,History of Africa,0,0,0,1,9,10
1531792996,Competition Diaries,0,0,0,0,3,3
1531811213,Sweetbitter | A Sappho Podcast,0,0,0,0,26,26
1531812209,"The Fault Line: Bush, Blair and Iraq",1,0,0,0,8,9
1531898121,Brave New Planet,2,4,3,0,27,36
1531900057,Fly Cool Shit - An Aviation Podcast About Flying Cool Shit,0,0,0,0,2,2
1531903378,Getting My Act Together,0,0,0,0,3,3
1531910081,Zoology Ramblings,0,0,0,0,1,1
1531910541,The Outcasters,0,0,0,0,1,1
1531910652,The Blachelorettes,0,0,0,0,4,4
1531918384,Suspicious Activity: Inside the FinCEN Files,26,5,4,1,14,50
1531919876,Relationship Theory,0,0,0,0,2,2
1531928661,Ask This Old House,0,2,0,2,4,8
1531931391,City of Town: An Improvised DnD Adventure!,0,0,0,0,18,18
1531949869,If You Can't Handle The Heat,0,0,0,0,7,7
1531960729,Transnatural Perspectives Podcast,0,0,0,0,1,1
1531965670,That Halloween Podcast,1,0,0,0,15,16
1531981810,Super Creative,0,0,0,0,14,14
1532025021,Locked On Boston College - Daily Podcast On Boston College Eagles Football & Basketball,0,0,0,0,26,26
1532032398,Abby talks about anime!,0,0,0,0,3,3
1532037860,Real Time with Prince Blue,3,0,0,0,6,9
1532057296,The Murders at White House Farm: The Podcast,10,4,3,0,14,31
1532058471,Humans Growing Stuff,4,0,1,2,21,28
1532060379,The ETCs with Kevin Durant,3,2,0,4,97,106
1532062623,ScaryCrit,0,0,0,0,2,2
1532064076,PMP Industry Insiders,0,0,0,0,14,14
1532070416,Oklahoma Appeals - The Podcast,0,0,0,0,4,4
1532072873,FTN FAABcast,0,0,0,0,24,24
1532078879,Hemmings Hot Rod BBQ Podcast,1,0,1,1,1,4
1532093071,Louder Than A Riot,17,5,4,5,182,213
1532102239,Baby Mamas No Drama with Kail Lowry & Vee Rivera,15,6,11,26,442,500
1532104531,Creator Chat,0,0,0,2,3,5
1532109008,Dear Liisphyra,0,0,0,0,41,41
1532110113,Click Bait with Bachelor Nation,105,31,40,28,265,469
1532110146,The World As You'll Know It,0,0,0,0,4,4
1532113853,Vision of a Champion with Anson Dorrance,0,0,0,0,7,7
1532116920,Theme Time Radio Hour with your host Bob Dylan,0,0,0,2,10,12
1532120809,The Lonely Pipette : helping scientists do better science,0,0,0,0,1,1
1532121594,Unlocking Greatness Podcast with Zenja Glass,0,0,0,0,28,28
1532125728,Gagging With Jason Lee,0,0,1,0,6,7
1532129830,Newbie Star Trek,0,0,1,0,3,4
1532134434,Grouse,2,0,0,2,3,7
1532135125,NowThis Brief,1,0,0,1,1,3
1532153109,Honeydew Me,0,0,0,0,19,19
1532154557,Success Hotline With Dr. Rob Gilbert,1,0,0,0,2,3
1532155091,The American Craftsman Podcast,0,0,0,0,5,5
1532163720,The Hockey House,0,0,0,0,3,3
1532172261,Growing with Letty & Lucy,0,0,0,0,1,1
1532182145,The Scoop Cricket Podcast,0,0,0,0,1,1
1532182761,Applesauce Penguin,0,0,0,0,1,1
1532219705,Canary: The Washington Post Investigates,9,3,2,2,196,212
1532225667,Chameleon: Hollywood Con Queen,19,19,26,18,351,433
1532241719,Kings of Con: The Podcast,0,0,1,2,21,24
1532255711,Believe It! A Naruto Podcast,0,0,0,0,2,2
1532262306,Dirt - An Audio Drama,0,0,0,0,11,11
1532270716,Haunted Places: Ghost Stories,4,3,1,4,30,42
1532282882,Classic Car Corner,0,0,0,1,12,13
1532284669,The Dave Portnoy Show with Eddie & Co,11,2,2,4,180,199
1532287003,The News with Shepard Smith,7,1,1,1,25,35
1532287154,The Builder Nuggets Podcast,0,0,0,0,6,6
1532287158,51 Strokes,0,0,2,4,240,246
1532301119,NP Pulse: The Voice of the Nurse Practitioner (AANP),0,0,0,0,2,2
1532303372,Morning Meeting,0,0,1,1,18,20
1532328889,Fast To Heal Stories,0,0,0,0,12,12
1532337565,The Midlife Sex Coach for Women Podcast,0,0,1,0,18,19
1532346888,Resilient Farming,0,0,0,0,4,4
1532347474,The Art of Asking Everything,1,0,1,0,26,28
1532390438,The PokeTower Podcast,0,0,0,0,21,21
1532398472,Amazing War Stories,0,0,0,0,10,10
1532415298,Run It BAC%,0,0,0,0,8,8
1532419028,AppleInsider Daily,2,0,0,0,0,2
1532420773,The Emotion Motion Podcast,0,0,0,1,42,43
1532437983,The Ship-it Show,0,0,0,0,7,7
1532460901,Uniquely Human: The Podcast,0,0,0,0,12,12
1532464827,Spilling the Paint Water with Chloe Rose,1,0,1,1,103,106
1532483728,And THAT'S That!,1,0,0,0,6,7
1532492683,Baby Animals,0,0,1,0,0,1
1532493020,The Birding Tools Podcast,0,0,0,0,5,5
1532493678,4OURPLAY - A Swinger Podcast,1,0,0,0,5,6
1532496557,Kamala: Next in Line,42,0,1,0,7,50
1532510182,Superstitions,14,8,4,1,21,48
1532543511,The Late Night Flight,0,0,0,0,2,2
1532573147,Parkdale Haunt,1,6,3,6,34,50
1532600628,The Way Forward,1,0,0,0,11,12
1532601028,Disney Stories For Kids,2,1,1,0,0,4
1532606850,The Science of Birds,1,0,0,0,16,17
1532610595,Wayward Guide For The Untrained Eye,0,2,1,0,47,50
1532628164,Hearties Hotline,0,0,0,0,7,7
1532628787,Check Your Aesthetic Podcast,0,0,0,0,26,26
1532632625,Garthology - A Study of Garth Brooks,0,0,0,0,4,4
1532672950,Scream!,12,11,4,11,104,142
1532674642,The Hifi Podcast with Darren and Duncan,0,0,0,0,6,6
1532679701,Unrestricted with Ben Leber,1,0,0,0,35,36
1532684973,Moms and Margs,2,0,0,0,20,22
1532685433,"Learning How to See with Brian McLaren, Jacqui Lewis and Richard Rohr",0,2,0,1,18,21
1532687073,New Jack's Safe Space,0,0,0,0,6,6
1532732798,Fully Vetted from the National Corvette Museum,0,0,0,0,3,3
1532752388,Marketing & Influence Podcast,0,0,0,0,50,50
1532755016,The GOAT: Tom Brady,3,5,5,2,19,34
1532758517,There She Rose,0,0,0,0,2,2
1532770300,CoinDesk Reports,0,0,0,0,1,1
1532780109,Track World News,0,0,0,0,3,3
1532784623,U.S. National Privacy Legislation Podcast,0,0,0,0,1,1
1532789990,The Photographer's Eye with Omar Gonzalez,0,0,0,0,1,1
1532813994,The 90th Percentile: An Unconventional Leadership Podcast,0,0,0,0,56,56
1532814558,CLE Rocks,0,0,0,0,2,2
1532816291,The Bald and the Beautiful with Trixie Mattel and Katya Zamo,2,0,2,3,43,50
1532823144,The Josh Potter Show,2,0,0,1,47,50
1532825728,"It's Sedimentary, My Dear: A Geology Podcast",0,0,0,0,1,1
1532830225,Split Zone Duo,2,1,2,3,198,206
1532830228,Modern Musician,0,0,0,1,49,50
1532836345,Equivalent Exchange: A Fullmetal Alchemist Podcast,0,0,0,0,1,1
1532838268,Sacred Text Messages,0,0,1,0,23,24
1532839151,For The Reef Podcast,0,0,0,0,2,2
1532875925,No Time To Die: The Official James Bond Podcast,1,1,0,0,5,7
1532894981,Anatomy of Murder,22,0,10,16,132,180
1532898519,Water Flying,0,0,0,0,1,1
1532901566,Finshots Daily,0,0,0,1,27,28
1532902456,The ProPhysique Code,0,0,0,0,2,2
1532910864,Let's Jaws For a Minute,0,0,0,0,8,8
1532914761,Hard Candy & Fruit Snacks,0,0,0,0,39,39
1532927260,Mean Streets with Chris Meaney,0,0,0,0,8,8
1532931622,Coordinated,0,0,0,0,16,16
1532932720,Leadership Lessons from the Fast Lane with Gary Heil,0,0,0,0,2,2
1532933019,Apple Talk,3,1,1,0,54,59
1532944046,La Cuenterapeuta: la terapeuta que cuenta cuentos.,0,0,0,0,1,1
1532951390,Kelly Corrigan Wonders,1,0,0,4,224,229
1532953008,Must Watch: Netflix Edition,0,0,0,0,9,9
1532956108,The Michelle Obama Podcast,116,0,4,4,256,380
1532959579,Animal Wise,0,0,0,0,5,5
1532960070,Haunting Season,0,0,0,0,9,9
1532976305,The Megyn Kelly Show,20,6,24,10,938,998
1532987390,Ever After with Jaleel White,0,0,0,0,27,27
1532990434,Two Designers & A Builder Walk Into A Bar,0,0,0,0,3,3
1532994551,Van Life with Tom Green,0,0,0,0,48,48
1532999340,Street TV,0,0,1,0,27,28
1533017720,Film Feast,0,0,0,0,2,2
1533017843,Who Can Relate?,0,0,0,0,50,50
1533022759,The Quest with Justin Kan,0,0,0,0,22,22
1533023915,The Real Sisters of Sobriety,0,0,0,0,6,6
1533039865,Stories from Flying the Nest,0,1,1,1,57,60
1533044352,Contrary To Popular Wrestling with Carmine DeSpirito and James Southard,0,0,0,0,1,1
1533059584,The WandaVision Podcast by Phantastic Geek,1,0,2,3,35,41
1533072212,Super Great Kids' Stories,1,1,0,0,23,25
1533084162,Raven Careers Aviation Podcast,0,0,0,0,7,7
1533107514,Central Division,0,0,0,0,1,1
1533129901,Resistance,2,0,0,0,68,70
1533130572,The Sarah Silverman Podcast,21,2,6,13,451,493
1533135144,PartnerUp The Partnerships Podcast,0,0,0,0,2,2
1533145165,Hollywood-ography,0,0,0,0,6,6
1533152856,Human Seeking Human,0,1,0,4,83,88
1533154010,"The 4 Ms with Molly--Macros, Mindfulness, Movement, & Meditation",0,0,0,0,2,2
1533155441,Criterion CULT Film Podcast,0,0,0,0,2,2
1533175935,The John Clay Podcast,0,0,0,0,2,2
1533192188,BRAVE COMMERCE,0,0,0,0,9,9
1533202080,The Bathroom Wall,0,0,0,0,2,2
1533203739,Getting It Done with Kai Greene,0,0,0,0,14,14
1533208070,Enthusiast!,0,0,0,0,7,7
1533219191,The BiGGz Show,0,0,0,0,5,5
1533252948,Do The Work,2,0,0,1,28,31
1533262590,The UX Kitchen Podcast,0,0,0,0,5,5
1533288544,CREEPYPASTA - True scary horror stories & paranormal podcast,0,0,0,0,4,4
1533294454,Abide Bible Sleep Meditation for Kids,0,0,0,0,3,3
1533314376,After Hours With Amanda,0,0,0,0,50,50
1533319890,Scratch Stories: A Scratch Golf Tips Podcast,0,0,0,0,5,5
1533331287,Olivia Rodrigo Brasil,0,0,0,0,7,7
1533356123,The Shadow Diaries,1,1,2,7,39,50
1533365390,RugbyPass Offload,0,0,0,0,1,1
1533367645,My 90s Playlist,2,2,0,2,42,48
1533405131,Altitudes by Etihad,0,0,0,0,1,1
1533413621,Kawaii Desuppointment,0,0,0,0,4,4
1533440758,The Industry of UX,0,0,0,1,4,5
1533444664,FreedHearts,0,0,0,0,8,8
1533447022,The Deduction,0,1,0,0,3,4
1533457120,PROOF: A Pre-Election Special,1,0,0,0,11,12
1533462141,Who Smarted?,1,0,1,3,44,49
1533464390,La advertencia,0,0,0,0,5,5
1533468348,Fish Bytes,0,0,0,0,1,1
1533477511,The Hopeful,0,0,0,0,11,11
1533480955,The Not Before Podcast,0,0,0,0,12,12
1533482411,Texas Devil Running Talk Show,0,0,0,0,1,1
1533501851,Jalen Rose: Renaissance Man,1,0,1,0,38,40
1533503593,Speaking for the Trees,0,0,0,0,1,1
1533504260,The Heart of Jacks Podcast,0,0,0,0,12,12
1533511422,Survive and Advance,0,0,0,0,4,4
1533522022,Anime Junkies: Three Weebs and a Podcast,0,0,0,0,2,2
1533526944,Podpah,0,0,0,0,1,1
1533534558,Food by Design: an IDEO Podcast,0,0,0,0,59,59
1533543802,Guitar Villains,0,0,0,0,50,50
1533552520,Guys That Golf,0,0,0,0,4,4
1533558695,The Cris Collinsworth Podcast featuring Richard Sherman,2,2,0,1,30,35
1533561573,The Artist Business Plan,0,0,0,0,5,5
1533595497,Let Me Back Up,0,0,0,0,5,5
1533597116,Winter of Discontent - A Beatles Podcast,0,0,0,0,1,1
1533597473,The Film Scorer,0,0,0,0,5,5
1533606702,The TARN Conspiracy,0,0,0,0,1,1
1533609555,Jar of Rebuke,0,0,0,0,15,15
1533612473,Brett Finch Uncensored,0,0,2,2,54,58
1533621122,"Girl and The Gov, The Podcast",0,0,0,0,29,29
1533629268,The Nurse,26,10,14,18,88,156
1533652997,That Gaby Roslin Podcast,0,0,0,3,59,62
1533664070,The Lost Mountain Saga,0,0,0,0,37,37
1533665227,Heart at Home with Farm Life Outfitters,0,0,0,0,3,3
1533675150,The Other Side of Midnight with Frank Morano,0,0,1,0,11,12
1533684705,Misfits and Mysteries,0,0,0,0,17,17
1533685993,War of the Roses - The Jubal Show,0,0,0,0,8,8
1533694307,Agents: Declassified,0,0,0,1,10,11
1533695558,Dishin' Dirt with Gary Pickren,0,0,0,0,2,2
1533699247,Game Theory Today with Eric Garland,1,0,0,0,28,29
1533699586,The Doctor’s Crossing Carpe Diem Podcast,0,0,0,0,35,35
1533700329,True Crime & Cocktails,0,0,1,0,196,197
1533704092,First Team Second String,0,0,0,0,4,4
1533706197,Because Mom Said So,5,1,2,9,137,154
1533722524,Celebrity Book Club with Chelsea Devantez,2,2,0,3,97,104
1533723862,Total Car Score,0,0,0,0,2,2
1533726552,Hipsterocracy,0,0,0,0,9,9
1533736348,Tower 4,2,4,5,4,25,40
1533742845,The Talegate Podcast,0,0,0,0,4,4
1533752067,The Dark Parts,0,1,4,0,45,50
1533753274,Let's Go To War,0,0,0,0,2,2
1533765365,Leah's Fieldnotes,0,0,0,0,12,12
1533781456,Rolling on 3,0,0,0,0,3,3
1533783270,Capital University,6,0,0,1,193,200
1533795851,We Got You,0,0,0,0,8,8
1533821475,The Promised Land,0,0,0,0,10,10
1533822662,Sofia with an F,13,1,0,1,35,50
1533835759,Reiter Than You,0,0,0,0,1,1
1533844290,Cryptography FM,0,0,0,0,1,1
1533848567,On The Forecheck: for Nashville Predators fans,0,0,0,0,1,1
1533854578,Why is Everyone Yelling?,0,1,0,0,37,38
1533859805,The Carl Nelson Show,0,0,0,0,3,3
1533863752,The Fly Angle: The Official RDU Airport Podcast,0,0,0,0,1,1
1533865227,Real Science Exchange,0,0,0,0,2,2
1533871875,The Weak-Side Podcast,0,0,2,1,16,19
1533872508,New Ice City: A Podcast About The New York Rangers,0,0,0,0,12,12
1533881966,Live With Lil: Marvel's Agents of Shield Rewatch,0,0,0,0,109,109
1533910179,Mythoholics,0,0,0,0,12,12
1533920338,Mid-Am Crisis: A Golf Discussion,0,0,0,0,4,4
1533920722,Bed Wed or Behead,0,0,0,0,4,4
1533920972,Good Neighbors,0,0,0,0,2,2
1533961755,DEM TIMES,0,0,0,0,1,1
1533975843,Children of the Stones,1,0,0,1,1,3
1533985693,The Confused Breakfast,0,0,0,0,17,17
1534002429,"The Deep Dish - The ""Julie and the Phantoms"" Podcast",0,0,0,0,8,8
1534019458,The Drone Pro Podcast,0,0,0,0,2,2
1534026316,The Adventures of Power Dog in Dogland!,0,0,0,0,9,9
1534027012,Q Clearance: The Hunt for QAnon,21,9,6,6,57,99
1534027861,13 Days of Halloween,5,4,3,5,33,50
1534030366,Tentpole Trauma,0,0,0,0,3,3
1534043439,The c4 podcast,0,0,0,1,0,1
1534043673,Grueter Golf Presents: Low Expectations,0,0,1,0,9,10
1534059745,A Spoonful of Podcast,0,0,0,0,1,1
1534070267,"The Joy Filled Mama - Christian Motherhood, Self Care, and Faith Based Encouragement for Moms",0,0,0,0,48,48
1534074397,Holtecast - An Aston Villa Podcast,0,0,0,1,3,4
1534079057,Native Film Talk,0,0,0,0,8,8
1534079498,Pregnancy Pearls Podcast,0,0,0,0,3,3
1534082388,Connecting with Dr. Kim Swales,0,0,0,0,34,34
1534085902,The Real Moms Podcast,0,0,0,0,13,13
1534096260,"""See, The Thing Is...""",19,8,15,12,158,212
1534098122,Creator Economics,0,0,0,0,6,6
1534119285,My Modern Met Top Artist Podcast,0,0,0,0,3,3
1534130327,Myprotein's The Scoop,2,1,0,0,41,44
1534135190,Bearded Bettors - Sports Betting Podcast,0,0,1,0,65,66
1534142827,90210MG,19,11,19,19,335,403
1534154453,the GUSSIE,0,1,0,0,27,28
1534157035,We Should Talk,0,0,0,0,9,9
1534157812,Adkins Undisputed: The Most Complete Scott Adkins Podcast in the World,0,0,0,0,5,5
1534163990,IF YOU DON'T LIKE THAT WITH GRANT NAPEAR,14,2,0,7,185,208
1534167097,Blooddice,0,0,0,0,2,2
1534172673,Goat Gab,0,0,0,1,2,3
1534181086,Jewish Ancestral Healing Podcast,0,0,0,0,4,4
1534186539,Digital Health Unfiltered,0,0,0,0,2,2
1534191467,Fantasy Best Ball Exclusive,0,0,0,0,22,22
1534217005,Out & About,1,1,0,0,27,29
1534217240,Digging a Hole: The Legal Theory Podcast,0,0,0,0,2,2
1534226791,Moonbeaming,0,1,1,1,302,305
1534229815,Colubrid Corner,0,0,0,0,1,1
1534234976,How Soccer Explains Leadership Podcast,0,0,0,0,3,3
1534240136,"Shotgun Sports USA Podcast | Sporting Clays, Trap and Skeet Shooting",1,0,1,0,6,8
1534241935,The New 52 and You!,0,1,1,0,9,11
1534242111,UNTOLD RADIO AM,0,0,0,0,3,3
1534252348,Hamish & Andy’s Remembering Project,0,4,5,6,66,81
1534254345,The Lupe and Royce Show,2,2,3,4,128,139
1534254369,The Monsters That Made Us,0,0,0,0,1,1
1534257860,The Official Trial of the Chicago 7 Podcast,1,0,0,0,6,7
1534261406,The Light Diet,0,0,0,0,3,3
1534324153,BFFs featuring Josh Richards and Dave Portnoy,21,1,2,5,121,150
1534338804,Sales School with Jordan Belfort,0,0,0,0,6,6
1534342400,Only You: A One and Done Podcast,1,1,0,1,4,7
1534354466,Beau Knows,0,0,0,0,9,9
1534355704,Biohacking Superhuman Performance,1,0,0,0,22,23
1534359227,Right on Radio,1,1,0,0,2,4
1534404977,Chuck Rewind,0,0,0,0,1,1
1534405989,Polyganometry,1,0,0,0,1,2
1534406623,The Better Days Podcast,0,0,0,0,2,2
1534437383,Surgeons In 3D Printing,0,0,0,0,4,4
1534443115,Diet Culture Rebel Podcast,0,1,0,0,5,6
1534448038,Grant Writing Simplified,0,0,0,0,1,1
1534448429,FML Talk,0,0,0,0,48,48
1534450783,Church News,0,0,0,0,15,15
1534458326,Nicky And Moose The Podcast,0,0,0,1,88,89
1534460955,The Direct Podcast,0,1,0,1,11,13
1534461892,THE FEDPOST,1,0,1,0,6,8
1534469141,All Consuming,1,1,0,0,18,20
1534497021,ART'S COOL with Ken Goshen,0,0,0,0,8,8
1534497498,The City in the City in the City,0,0,0,0,32,32
1534504545,What if it's True Podcast,0,0,0,1,41,42
1534504699,Lit Century,0,0,0,0,2,2
1534509472,The Missing Chapter: History's Forgotten Stories,0,0,0,0,5,5
1534511100,Chili Dip Pod,0,0,0,0,11,11
1534512753,Never Too Old For Agoodspankin,0,0,0,0,4,4
1534513675,Russell Gets Revenge,0,0,0,0,9,9
1534521703,Experiences Unexplained,1,0,0,0,3,4
1534524621,Billy Bob the Podcast,0,0,0,0,10,10
1534532094,Wednesday Wake-Up with Gregory Maloof,0,0,0,0,6,6
1534576003,The Official MS5 Podcast,0,0,1,0,10,11
1534576642,"Two Guys, A Girl and a Podcast",0,1,0,1,25,27
1534591370,UNDISTRACTED with Brittany Packnett Cunningham,0,0,0,0,50,50
1534594079,Climate Curious,0,0,0,0,1,1
1534595798,Out of the Woods,0,0,0,0,3,3
1534614879,The Future of Fashion by Vogue Business,1,0,0,0,0,1
1534615811,Bobbo Supreme,1,0,0,1,10,12
1534623399,Bringing Chemistry to Life,0,0,0,0,1,1
1534624846,Web DM Talks,0,1,0,0,12,13
1534625962,That's Totally Normal!,0,0,0,0,15,15
1534626425,Pinkalicious & Peterrific,2,1,3,1,21,28
1534628327,Transmissions: The Definitive Story of Joy Division & New Order,0,1,0,1,7,9
1534629717,More Than A Muse,0,0,0,0,3,3
1534644813,Playing The Odds NASCAR Style,0,0,0,0,1,1
1534647360,Into the Mother Lands,0,0,0,0,3,3
1534654560,Talking Feds: Women at the Table,0,0,0,0,5,5
1534657559,The Exotic Pet Collective,0,0,0,0,1,1
1534668519,Growing With The Flow,0,0,0,1,34,35
1534672561,Days Like These,0,0,1,3,49,53
1534676155,Broken By Concept,0,0,0,0,3,3
1534693287,Steeevin’s Sentiments,0,0,0,0,11,11
1534705563,TEEN GIRL TALK,1,0,0,0,0,1
1534727047,Lost Trade,0,0,0,1,34,35
1534730771,Bioethics for the People,0,0,0,0,9,9
1534756547,Talking to the opening,0,0,0,1,0,1
1534759841,Thryfty: Unchained,0,0,0,0,1,1
1534760039,BiggerPockets Daily,1,0,0,0,25,26
1534764208,Hey Spirit! With Theresa Caputo,2,1,1,1,126,131
1534767916,Writer's Block,0,0,0,0,9,9
1534771206,Ensign College Devotionals,0,0,0,0,1,1
1534777775,Fuel For Thought,0,1,1,1,1,4
1534780078,Fiasco: Bush v. Gore,0,1,1,0,13,15
1534789242,Dauster and Da'Sean,2,0,0,0,10,12
1534793823,Chairside Live Dental Insights,0,0,0,0,1,1
1534795455,Orange Slices,0,0,0,0,19,19
1534796777,SVG Business Boss Podcast,0,0,0,0,2,2
1534797925,The Greg Kelly Podcast,1,0,0,0,50,51
1534799121,Dead and Gone,24,26,36,18,396,500
1534806584,Margaret's Garden,1,1,1,0,5,8
1534808112,Out of Place,0,0,0,0,3,3
1534809735,Resonate: 10 Years of Brooke Fraser's Flags,0,0,0,0,4,4
1534812453,Stock Market Investing with Giovanni Rigters,0,0,0,1,1,2
1534828303,Standig Room Only: A show about the Washington Football Team and D.C. sports,0,0,0,0,40,40
1534829787,A Matter of Degrees,1,0,1,0,43,45
1534850203,NYC VIDEO PODCAST,0,0,0,0,2,2
1534887549,Design Nerds Anonymous,0,0,0,0,1,1
1534890733,The Friendship Rewind–A 10 Year Retrospective of My Little Pony: Friendship is Magic,0,0,0,0,4,4
1534902421,Bougie Adjacent,0,0,0,0,4,4
1534905147,Golden Ducks Cricket Podcast,0,0,0,0,2,2
1534908279,Football 24/7 with John McMullen,0,0,0,0,1,1
1534908488,The Steve Mags Muscle Car Show,0,0,0,0,9,9
1534916292,Modulus,0,0,0,1,9,10
1534929318,The World to Come,0,0,0,0,18,18
1534934131,The Miami Chronicles,0,1,1,0,24,26
1534934940,Specimens,0,0,0,0,10,10
1534944224,Ripstop on the Record,0,0,0,0,2,2
1534945773,OUT HERE,0,0,0,0,6,6
1534949847,Getcha Rocks Off with Mick Wall,0,0,0,1,5,6
1534953144,Al-Anon Reading,0,0,0,0,1,1
1534964872,American Prodigy: Freddy Adu,1,2,2,5,300,310
1534972612,Breaking Down: Collapse,0,0,0,0,9,9
1534974597,Flirting With Failure,0,0,0,0,3,3
1534977633,Dr.Sky / Episode #1,0,0,0,0,1,1
1534986656,The Marvel Guys,0,0,0,0,2,2
1535001986,Bedtime Stories For Kids Hindi|English,0,0,0,0,3,3
1535004263,The Plant KiKi,0,0,0,0,11,11
1535040312,Taskmaster The Podcast,3,4,4,5,41,57
1535048610,100 000 ans,0,0,0,0,1,1
1535053970,Ship-Talking | Podcast,0,0,0,0,3,3
1535076757,The Big Foodies,0,0,0,0,9,9
1535076826,Theory of DFS - Daily Fantasy Sports Strategy,1,0,0,0,20,21
1535134753,Elvis Right Now,0,0,0,0,1,1
1535140842,Behind the Dish with John Buck,0,0,0,0,5,5
1535142763,Ghoul,1,1,2,1,70,75
1535145251,Creating Consciousness: A Spiritual & Intuitive Tarot Podcast For Self-Growth,0,0,0,0,34,34
1535149847,Jews Control The Media,0,0,0,0,3,3
1535153188,The Pro's List,0,0,0,0,2,2
1535169393,Bush's Board Game Thing,0,0,0,0,1,1
1535173061,The Fat Joe Show,0,0,0,0,5,5
1535227249,The Golden Age of Baseball with Eddie Robinson,0,0,0,0,10,10
1535243744,"OTHERtone with Pharrell, Scott, and Fam-Lay",0,0,1,0,22,23
1535248499,Walk You Out with Johnno and Richelle,0,1,2,1,42,46
1535249499,Morning Invest,0,0,0,0,20,20
1535250787,The Goddess Pod,1,0,0,0,4,5
1535251140,FANtastic Tennis,0,0,0,0,19,19
1535255041,Unf*cking The Republic,0,0,0,0,16,16
1535255566,The Capital Building Podcast With Rob Carlin,0,0,0,1,37,38
1535265016,Anything For Selena,3,4,3,6,105,121
1535283618,The Sisyphus 55 Podcast,0,0,0,0,5,5
1535285404,In Search of Soil,0,0,0,1,12,13
1535343619,The Resistible Rise of J. R. Brinkley,0,0,0,0,2,2
1535343630,Reality Unfiltered with Meghan and Harry,6,0,0,1,20,27
1535350255,Stream of Blood,0,0,0,0,10,10
1535358183,The Remedial Film Class Podcast,0,0,0,0,1,1
1535358465,Unshaken Saints,0,0,0,1,63,64
1535358924,Art of Homeschooling Podcast,0,0,0,0,6,6
1535359773,Another Podcast,0,2,1,1,4,8
1535361344,Kontent Queens,0,0,0,1,27,28
1535384390,Ruthless,16,3,1,1,29,50
1535395371,Reactivaders,0,0,0,0,21,21
1535397836,Light The Way,0,0,0,0,5,5
1535401054,Lost Terminal,0,0,0,0,1,1
1535403320,Dark Downeast,1,0,1,2,186,190
1535403710,A Century in Cinema,0,0,0,0,9,9
1535406429,Clearer Thinking with Spencer Greenberg,0,0,1,0,3,4
1535408667,Maintenance Phase,8,3,4,4,333,352
1535414282,StaleMates,0,0,0,0,1,1
1535426383,The Disney Beat,1,0,0,0,15,16
1535428690,The Eldritch Review,0,1,0,0,4,5
1535495844,Drunk Black History,0,0,0,0,2,2
1535499508,Dead Ideas in Teaching and Learning,0,0,0,0,1,1
1535509629,The WAR RAW Podcast hosted by Wayne Allyn Root,0,0,0,0,3,3
1535516122,The Truthiest Life,0,1,2,3,44,50
1535523207,ALTER Weekly,0,0,0,0,18,18
1535527581,Why or Why Not with the Watsons,0,0,0,0,48,48
1535544603,PODCAST ON A POLE,0,2,0,0,33,35
1535546566,Scrambling with Dylan Otto,0,0,0,0,1,1
1535548328,The Rundown,11,2,8,3,474,498
1535569915,Dumpster Fyre,14,4,3,0,16,37
1535570018,WWE Setting The Stage,0,0,0,0,2,2
1535570203,Beer Mile Podcast,0,0,0,0,21,21
1535572126,"TV, I Say w/ Ashley Ray",0,0,0,0,6,6
1535587321,The Anime Movie Podcast,0,0,0,0,1,1
1535598244,EMT Course Review,0,0,0,1,0,1
1535602888,Chronic Table with the Portland Cannabis Tasting Society,0,0,0,0,2,2
1535633469,Run Matters,0,0,0,0,5,5
1535645906,Fossil Bonanza,0,0,0,0,2,2
1535661441,SIMPLE ITALIAN PODCAST | LEARN ITALIAN WITH PODCASTS | IL PODCAST IN ITALIANO COMPRENSIBILE,0,0,0,0,2,2
1535662125,Power of X-Men,0,0,0,0,14,14
1535674071,The Alan Watts Audio Experience,0,1,1,1,24,27
1535699897,ORB,0,0,0,0,30,30
1535715834,Unbothered Blondes,1,1,1,10,95,108
1535721042,On The Number,0,0,0,0,4,4
1535722733,The Big Uglies Podcast,0,0,0,0,4,4
1535736001,Engineering and Physics Theories in our World,0,0,0,0,2,2
1535737683,Best Camp of My Life with Fernanda Prates,0,0,0,0,2,2
1535742646,The Bones Booth: A Bones Podcast,0,0,0,0,9,9
1535749969,The Blue Todd Cast,0,0,0,0,2,2
1535803457,Crimes of the Centuries,4,4,5,9,174,196
1535809341,The Joe Budden Podcast with Rory & Mal,9,2,1,4,311,327
1535821792,From The Bachelor To The Burbs,0,0,0,0,7,7
1535833833,Cocktails at Table 7- Inside New York’s Joe Allen,0,0,0,0,4,4
1535839326,MindFrame Podcast,0,0,0,0,50,50
1535840075,Inside The Mind Of Miles,0,0,0,0,8,8
1535845072,Out for Blood: The Story of Carrie the Musical,0,0,0,2,24,26
1535855038,Fresh Invest,2,0,1,0,3,6
1535855327,Platinum Performance® Podcast,0,0,0,0,1,1
1535862454,Growing Cut Flowers,0,0,0,0,16,16
1535879222,The Stuff Dreams Are Made Of,0,0,0,0,25,25
1535879416,Jacked,2,3,2,7,171,185
1535882542,The Doodler,1,3,7,2,6,19
1535886300,In Depth,0,0,0,0,3,3
1535886945,ART-SOMETHING  TATTOO PODCAST,0,0,0,0,2,2
1535887101,One Drink In,0,0,0,0,32,32
1535892753,The Teacher Career Coach Podcast,0,0,0,1,49,50
1535922009,Halfback Dynasty Football,1,0,0,0,0,1
1535935930,What Women* Want,0,0,0,0,2,2
1535952188,Secondary Lead,0,0,0,0,13,13
1535984668,Tropicana Yams,0,0,0,0,2,2
1536001500,Drink About It,0,0,0,0,2,2
1536006516,Ooh You're In Trouble,2,0,0,0,11,13
1536040878,Kellofaplan- Planning a Life I Love,0,0,0,0,10,10
1536041849,Tiny Victories,1,1,0,0,30,32
1536043190,The Marianne Williamson Podcast: Conversations That Matter,3,1,1,0,45,50
1536055234,Ghost Tape,16,7,11,1,15,50
1536063789,Knowledge Is Your Superpower,0,0,0,0,1,1
1536080030,Thorn's Jungle,0,0,0,0,1,1
1536117102,Reading Time with the Wise Owl - Children's Stories,1,0,0,0,1,2
1536163226,Good Faith Effort,0,0,0,0,18,18
1536165971,Creatives Are The Worst,0,0,0,0,4,4
1536169608,Strength Changes Everything,0,0,0,0,6,6
1536188252,The Mobile Notary Business Expert Secret Show,0,0,0,0,4,4
1536199648,I Saw What You Did,1,3,0,2,451,457
1536206642,Akashavani Hindi News,0,0,0,1,5,6
1536206996,Akashavani English News,0,0,1,4,7,12
1536207719,"Oh, I Like That",0,0,0,0,25,25
1536227843,The Rant Live - Chicago Cubs Podcast,0,0,0,0,2,2
1536229442,AdamCast,0,0,0,0,6,6
1536243282,Unpopular with Jacques Peterson,2,0,0,1,46,49
1536256870,10 for Tweens,0,0,0,0,4,4
1536303727,As The Curtain Rises - Broadway’s First Digital Soap Opera,0,0,0,0,3,3
1536309467,We Don't Wanna Grow Up,0,0,0,0,17,17
1536323457,Your Fave’s Faves,1,2,0,0,6,9
1536338060,American Party Podcast,6,1,0,0,264,271
1536341605,"""The Bigger Picture"" By Lil Baby",0,0,0,1,1,2
1536343148,Unseen,0,0,0,4,46,50
1536352412,Giggly Squad,57,10,8,9,414,498
1536352949,The Rematch with Etan Thomas,0,0,0,0,2,2
1536364604,Everything Sports Cards,0,0,0,0,1,1
1536367924,Neutral Cider Hotel,1,0,0,0,3,4
1536372254,Tea At No. 5,0,0,0,0,8,8
1536393630,Video Game History Hour,0,0,0,0,4,4
1536439241,Elevating Their Impact,0,0,0,0,4,4
1536462139,NITE DRIFT with Jim Perry,0,0,0,0,8,8
1536464619,The Ketogenic Nutritionist,0,0,0,0,1,1
1536469021,Outweigh,0,0,0,1,16,17
1536475103,The Age Old Question,0,0,0,0,6,6
1536476915,305 Takes,0,0,0,0,1,1
1536477478,The Challenge: Redditors React,0,0,0,0,1,1
1536482295,Running is Cheaper Than Therapy,0,0,0,0,19,19
1536487794,When Life Gives You Layovers,0,0,0,0,1,1
1536496864,The Pure Drive Golf Podcast,0,0,1,0,7,8
1536510445,Smuggler's Galaxy,0,0,0,0,2,2
1536519717,Hoe And Tell Podcast,0,0,2,0,3,5
1536523615,House Of Hoosier with A.J. Guyton,0,0,0,1,73,74
1536524717,Primordial Deep,0,0,3,1,9,13
1536529196,The Jasmine Dragon Tea Hour,0,0,0,0,1,1
1536535198,DancEscape,0,0,0,0,2,2
1536562946,Among Us 200IQ,4,0,0,3,10,17
1536567808,Sentimental Men,0,0,0,0,6,6
1536568420,The Court Jesters,0,0,0,0,3,3
1536587957,The Decision Education Podcast,0,0,0,0,6,6
1536590018,Talk to Chuck with Chuck Wicks,1,2,6,7,271,287
1536601676,68 Shining Moments: Reliving the greatest moments in NCAA tournament history,0,0,0,0,5,5
1536602557,Wandering with the Dead,0,0,0,1,6,7
1536611118,Criticism Is Dead,0,0,0,0,6,6
1536628319,Don't Break the Rules,0,0,0,0,2,2
1536628636,Kyle's Wild World,0,0,0,0,2,2
1536632665,Next Level Running,0,0,0,0,1,1
1536650843,The CXM Experience,0,0,0,0,1,1
1536657092,Rough Magic,0,0,0,0,2,2
1536673057,More Than Athletes Podcast,0,0,0,0,4,4
1536697840,Encuentros Explosivos,0,0,0,0,1,1
1536700147,Enough,11,0,0,1,432,444
1536768473,Go For Set Dec,0,0,0,0,4,4
1536771923,Kennedy Saves the World,3,1,1,1,33,39
1536776428,Vital Signs,0,0,0,0,3,3
1536794342,The Fleet,0,0,0,0,8,8
1536797531,OutSpoken,0,0,0,0,101,101
1536797955,Positively Gam,0,0,0,3,90,93
1536805217,WULFF DEN Podcast,0,0,0,0,2,2
1536821119,Behind the Greens: Serving with Purpose,1,0,0,0,1,2
1536828231,Muckville Radio Podcast,0,0,0,0,3,3
1536828751,My Dream Log Cabin- Log Cabin Construction Discussion and Stories of How Others Achieved The Log Cab...,0,0,0,0,2,2
1536830138,System Check with Melissa Harris-Perry and Dorian Warren,0,0,1,1,26,28
1536831436,The Payton Years,0,0,0,0,9,9
1536839859,Lolita Podcast,1,0,3,6,168,178
1536846146,Data Driven Strength Podcast,0,0,0,0,9,9
1536861162,Cast Party: A Dungeons & Dragons Podcast,0,0,0,0,50,50
1536870782,DeathShifter,0,0,0,0,2,2
1536872867,Are You Green? Business & Stock Market News with Swing Trading Insights,2,0,0,0,1,3
1536874356,Getting Magnetic with Sandy & Wade,0,0,0,0,100,100
1536966919,Anthony P. Richards,0,0,0,0,3,3
1536972785,The Pet Care Podcast,0,0,0,0,1,1
1536974631,Direct to VHS,0,0,0,0,4,4
1536984072,The Dishcast with Andrew Sullivan,6,2,4,4,25,41
1536986232,The Socially Distant Craft Club Podcast,0,0,0,0,1,1
1537004307,Actors in Conversation: Slice of Life with Margie Haber,0,0,0,0,28,28
1537004816,Tribe of Two - A podcast for The Mandalorian,0,0,2,1,4,7
1537010583,The Genius Generation,1,0,1,0,0,2
1537010645,Cocky and Lucky Vegas Golf Show,0,0,0,0,2,2
1537044056,"The Carolina Conversation, with Shammond Williams",0,0,0,0,9,9
1537046809,Lead Now,0,0,0,0,4,4
1537053860,Penny Royal,0,1,0,2,10,13
1537128959,The 401 Podcast with Kevin McNamara,0,0,0,0,2,2
1537129801,Source Material,1,0,1,0,6,8
1537133934,Runnin' With the Dweezil,0,0,0,1,4,5
1537139582,The Cane Corso Experience,0,0,0,0,8,8
1537181366,Bad Chaperones,0,0,0,0,1,1
1537231542,SWAY WAY,2,0,0,0,54,56
1537256159,Fear Noir,1,0,0,1,17,19
1537257291,Maybe I’m Manic,0,0,0,0,1,1
1537265387,Drinking and Drashing: Torah with a Twist,0,0,0,0,6,6
1537283296,Live from Pawnee: A Parks and Recreation Fan Rewatch Podcast,1,1,1,0,2,5
1537283659,Killer Casting,0,0,0,0,14,14
1537295197,Dr. Creepen's Dungeon,0,0,0,0,14,14
1537297256,"Work Life Glue - Creating Balance that Sticks for Busy Working Moms || Time Management, Productivity...",0,0,0,0,11,11
1537300271,Monday Night Beers,0,0,0,0,13,13
1537309917,Geological Expeditions of Yore,0,0,0,0,4,4
1537310054,Geology Podcast Network,0,0,0,1,24,25
1537332019,The Low Level Hell Podcast,0,0,0,0,13,13
1537339108,Cinenauts,0,0,0,0,8,8
1537341991,Lasting Looks,0,0,0,0,8,8
1537379922,The Piper,1,0,0,1,3,5
1537390470,Paranormal Playboy,0,0,0,0,3,3
1537404238,POOG with Kate Berlant and Jacqueline Novak,0,0,0,3,47,50
1537427222,Swipe Fat,0,0,0,1,19,20
1537435643,Crux Media presents Pass The Remote,0,0,0,0,2,2
1537445257,Play Me a Recipe,0,0,0,0,7,7
1537452357,The Do Good Project,0,0,0,0,4,4
1537453301,Rock & Roll Hall of Fame Induction Vault,0,0,1,0,1,2
1537463766,Divorce Sucks with Laura Wasser,0,0,0,0,3,3
1537471085,"Teaching, Reading, and Learning: The Reading League Podcast",0,0,0,0,2,2
1537511934,Les Be Gay,0,0,0,0,2,2
1537513113,The METRO Podcast,0,0,0,0,2,2
1537513919,Arcane,0,0,0,2,6,8
1537524795,The Unexplainable Disappearance of Mars Patel - Owens Podcast Reviews,0,0,0,1,0,1
1537568996,The Stand,1,0,1,0,7,9
1537575625,Bed of Lies,1,0,0,0,23,24
1537579483,The Twelfth House,0,0,0,0,68,68
1537585024,Books N' Betches,0,0,0,0,3,3
1537590027,Coin Bureau,0,0,0,1,4,5
1537600726,SPEAK! A Dogcast,0,0,0,0,4,4
1537611249,Locked On NBA Draft - Daily Podcast On The NBA Draft And College Basketball,0,0,0,0,4,4
1537624153,NASM Master Instructor Roundtable: A Show for Personal Trainers,0,0,1,0,0,1
1537627240,BetUS UNFILTERED,0,0,0,0,1,1
1537631446,DollyWould,0,0,0,0,1,1
1537631525,Coffee Talks Wellness with Ryann Nicole,0,0,0,0,3,3
1537642847,Stories Are Soul Food,0,0,0,0,35,35
1537651837,The Punch Out with Eugene Puryear - Your Daily Socialist News Hit,1,0,0,0,5,6
1537653218,Midnight Burger,0,0,0,0,3,3
1537656482,Ladies First with Laura Brown,0,0,0,0,7,7
1537664513,Red Flags,6,3,1,0,18,28
1537676973,Backyard Ecology,0,0,0,0,2,2
1537678761,Golf Gambling Podcast,0,0,0,0,20,20
1537679517,Illusion Pod,2,0,0,0,11,13
1537691055,Lift Me Up,0,0,0,0,1,1
1537698009,Maine Oyster Aquaculture - Stories of Resilience and Innovation,0,0,0,0,1,1
1537708332,The Fellas,1,2,0,0,71,74
1537734012,Disology Podcast,0,0,0,0,8,8
1537742030,"Cricket, Et Cetera",0,0,0,0,2,2
1537771697,Fair Shake Football,0,0,0,1,9,10
1537788786,The Rest Is History,2,0,3,2,38,45
1537791756,Steve & Captain Evil: The Podcast,0,0,0,1,11,12
1537817017,That Sex Chick,1,0,0,0,49,50
1537836233,I AM Athlete Podcast,2,0,0,2,60,64
1537849551,Left Bitches (who are right),0,1,2,0,8,11
1537865727,Do No Harm,14,14,12,6,140,186
1537867270,Sweet Boys,2,0,0,0,48,50
1537875452,PR Yourself with Leah Frazier,0,0,0,0,5,5
1537889926,Bringing the Human back to Human Resources,0,0,0,0,8,8
1537894112,Jersey Swap,0,0,0,0,7,7
1537919408,The unexplainable disappearance of Mars Patel,0,1,0,0,0,1
1537926150,The Clone Cast,0,0,0,0,3,3
1537929223,Pardon My American,2,0,0,0,22,24
1537934359,Behind the Wheels,0,0,0,0,2,2
1537935725,Sunday Golds: A Florida State Baseball Podcast,0,0,0,0,11,11
1537938041,Golf Rx,0,0,0,0,7,7
1537949848,The Shattered Window,5,3,4,1,32,45
1537994032,The Burg Boys,0,0,0,0,6,6
1538012809,"The Forward Thinking Podcast, Powered by FCCS",0,0,0,0,2,2
1538013249,Having A Blast,0,0,0,0,1,1
1538041351,The Vault By Access Hollywood,1,0,0,0,2,3
1538052368,Join The Ranks,0,0,0,0,10,10
1538055084,Le Grand Fromage,0,0,0,0,1,1
1538074230,The Uncensored Anime Podcast,0,0,0,0,2,2
1538081232,Life After Hockey with Brad Leeb,0,0,0,0,1,1
1538088642,Anime Noise,0,0,0,0,1,1
1538096009,Behind The Maker Podcast,0,0,0,0,2,2
1538146180,Millennial Esthetician,0,0,0,0,1,1
1538159197,The Weekly Kvetch,0,0,0,0,3,3
1538204210,Tenfold More Wicked,8,10,6,11,380,415
1538223546,The Job Interview Podcast,0,0,0,0,10,10
1538224217,The Oyster,6,8,10,4,22,50
1538242507,Life with Marianna,4,1,2,2,191,200
1538243298,Fiber Coven Podcast,0,0,0,0,1,1
1538248051,Hello From The Hallowoods,0,0,0,0,2,2
1538249198,Areeka Podcast,0,0,0,0,11,11
1538283780,Self Care and Chill With Maui,1,2,0,0,264,267
1538288230,UPIKE Baseball,0,0,0,0,2,2
1538288513,FAILUROLOGY,0,0,0,0,1,1
1538291856,I’m Not As Think As You Drunk I Am,0,0,0,0,21,21
1538292391,THE GRAIL with Dean Delray,1,0,0,0,57,58
1538307470,Make It Simple,1,0,0,0,49,50
1538316608,Get into the Groove,0,0,0,0,2,2
1538348623,Parenting Decolonized,0,0,0,0,6,6
1538356340,Bourbon Birds & Brews Podcast,0,0,0,0,3,3
1538365278,The Mindful Podcast,0,0,0,0,2,2
1538365635,Women that talk Back,0,0,0,0,1,1
1538365818,Going Dark: A Netflix's Dark Podcast,0,0,0,0,2,2
1538365966,EDDY OUT with Natali Zollinger,0,0,0,0,2,2
1538371865,OMfG podcast: jewish wisdom for unprecedented times,0,0,0,0,2,2
1538372749,House Cats,0,0,0,0,28,28
1538377906,Devy Debate,0,0,0,0,29,29
1538378650,Add to Cart with Kulap Vilaysack & SuChin Pak,1,1,1,1,75,79
1538393186,Chasing Hope with Katherine Abraham,0,0,0,0,1,1
1538396976,The DIIV Podcast,0,0,0,1,19,20
1538397654,The Valley of the Dolls Podcast,0,0,0,0,1,1
1538432958,The Woman of Wellness Podcast,0,0,0,0,16,16
1538443362,Bedtime With Bunny,0,0,0,0,50,50
1538450839,Barstool Bench Mob,142,15,7,7,327,498
1538450955,A New Untold Story,0,0,0,1,49,50
1538459445,Sellout Talks,0,0,0,0,2,2
1538474515,Street Cop Podcast,1,0,0,2,29,32
1538493672,Spanish for Beginners Easy,0,0,0,0,2,2
1538498597,First Person Plural: EI & Beyond,0,0,0,1,1,2
1538504137,Dog Training with Leah of Dog Gone Good,0,0,0,0,9,9
1538513554,Converging Dialogues,0,0,0,0,4,4
1538517724,Electrify This!,0,0,0,0,2,2
1538519042,Porsha4Real with Porsha Williams,2,0,0,1,123,126
1538525776,The Weekly Forecast,0,0,0,0,1,1
1538535328,The Only Nets Fans You Know: A Brooklyn Nets Podcast,0,0,0,0,8,8
1538539282,Guerra de chistes,1,0,0,0,0,1
1538586543,The SciManDan Podcast,0,0,1,0,21,22
1538600147,Life Lessons,0,0,0,1,39,40
1538600161,The Arts of Murder,0,0,0,0,4,4
1538637284,Filmmaking Confidential,0,0,0,0,2,2
1538639191,SuperFlex City,0,0,0,0,1,1
1538641292,Daddy Issues with Jon and Bron,3,0,0,1,51,55
1538652099,The Athlinks Podcast,0,0,0,0,7,7
1538657842,The Sales Management. Simplified. Podcast with Mike Weinberg,0,0,0,0,50,50
1538668164,crushing doubt,0,0,0,0,3,3
1538671056,The Applied Dungeoneering Podcast,0,0,0,0,1,1
1538672251,The Unstoppable Podcast,0,0,0,1,51,52
1538674606,The Untitled GenX Podcast,0,0,0,0,11,11
1538679353,Get Your Marriage On! with Dan Purcell,0,0,0,0,2,2
1538696542,HELL HAS AN EXIT Podcast with Bryan Alzate,0,0,0,0,43,43
1538714133,Suite Run,0,0,0,0,30,30
1538770797,Inside The Album with Don & Tommy,0,0,0,0,4,4
1538791630,Tech Refresh from Komando.com,0,0,0,0,1,1
1538803663,Hudi The Foodie,0,0,0,0,10,10
1538821139,Say Yas to the Guest,1,0,1,0,31,33
1538830668,Socially Modern with Stephanie Mainville & Jessie Lockhart | A Show for Real Estate Agents and Small...,0,0,0,0,7,7
1538841498,Random Fit Powered by NASM,0,0,0,0,1,1
1538858162,Finding Soul Rest,0,0,0,0,1,1
1538858196,AfroNoodles w/ Willie Macc & Danny Plom,0,0,0,0,3,3
1538882002,Good Game Nice Try,0,1,2,0,32,35
1539012594,It's All Clutter,0,0,0,0,5,5
1539013370,Quest for Healing,0,0,0,0,14,14
1539025599,Carl Landry Record Club,0,0,0,0,50,50
1539038293,Below Average Gentlemen's Fantasy Football Podcast,0,0,0,0,6,6
1539075283,Escaping 1980,0,0,0,0,7,7
1539104433,Anthony Plog on Music,0,0,0,0,2,2
1539111014,The Ladylorians Show,0,0,0,0,6,6
1539116709,PODCAST 20.21,0,0,0,1,0,1
1539120387,The Vampire Diaries After Show Podcast,0,0,0,0,2,2
1539120517,Pastafarian Truths,0,0,0,0,2,2
1539126065,Whatahockey Podcast,0,0,0,0,2,2
1539129528,The Old Fashioned Car Audio Pod,0,0,0,0,9,9
1539153617,Race at Work with Porter Braswell,0,0,0,0,4,4
1539170529,Topics Under The Stairs,0,0,0,0,2,2
1539183805,Volume Up by The Tease,0,0,0,0,1,1
1539195929,The Unwritten Playbook,0,0,0,0,2,2
1539208195,LD AND THE MC,0,0,0,1,7,8
1539209759,American Contingency,2,0,0,0,44,46
1539214532,The Socialist Program with Brian Becker,0,0,0,0,14,14
1539220513,House of Broken Dreams: The Jennifer Kesse Story,103,11,13,7,90,224
1539277642,Tea and Conversations,0,0,0,0,2,2
1539293058,Backyard Geology,0,0,0,0,1,1
1539296304,Carrots 'N' Cake Podcast,4,0,1,3,34,42
1539317046,Cobbler's Gulch,0,0,0,0,50,50
1539320050,Fresh&Fit Podcast,13,0,0,0,10,23
1539343980,To My Sisters,1,0,0,0,7,8
1539346298,Secure the Gag,0,0,0,0,9,9
1539353315,Guerrilla History,0,0,0,0,5,5
1539370508,Who Needs Sleep?,0,0,0,0,1,1
1539409051,The Anthony Iannarino Show,0,0,0,0,5,5
1539412873,Nonprofit Investment Stewards,0,0,0,0,3,3
1539415630,MinistrySmart Talks,0,0,0,0,1,1
1539421690,Como yo lo Veo con Claudia Valdes,0,0,0,0,50,50
1539431210,SOUNDFOOD,0,0,1,1,10,12
1539433618,Jill Scott Presents: J.ill the Podcast,1,0,0,1,109,111
1539454561,The Priesthood Restored,1,0,0,0,12,13
1539502216,Administrative Static Podcast,0,0,0,0,1,1
1539515510,Opera Bluffs The Podcast,0,0,0,0,1,1
1539535732,the Podcast Without a Cool Acronym,0,0,0,0,2,2
1539546360,True Crime Arizona,0,0,0,2,15,17
1539563143,Motivational Quotes for true Happiness words of love to Empower you with positive Vibe for Day &Week,0,0,0,0,1,1
1539568321,The Bible in a Year (with Fr. Mike Schmitz),8,4,0,4,344,360
1539614457,The Big Intermission,0,0,0,0,12,12
1539656772,PillaTalk Podcast,0,0,0,0,10,10
1539660237,Lifestyle by Real Estate Podcast,0,0,0,0,32,32
1539709257,Carefully Reckless,0,0,1,1,48,50
1539709262,Checking In with Michelle Williams,0,0,0,1,25,26
1539709266,Dawkins On Duke,0,0,0,0,5,5
1539719940,Patients at Risk,4,0,0,1,9,14
1539736044,The Prototype,0,0,0,0,1,1
1539758181,High Handicappers Club,0,0,0,0,1,1
1539764240,Voice of America,1,0,0,0,0,1
1539770216,Criminally Listed Presents: Into the Killing,15,6,6,1,35,63
1539771018,The Daily 10 with Matt Chernoff,0,0,0,0,8,8
1539773975,The Bouquet Toss - A Wedding Planning Podcast,0,0,0,1,7,8
1539781383,Official Unofficial Reddit Podcast,0,0,0,0,2,2
1539785761,Two Guys From Hollywood,0,0,0,1,16,17
1539790170,Comedian v Economist,0,0,0,0,15,15
1539808555,Bow Ties & Sweatshirts,0,0,0,0,7,7
1539835559,Explorations,0,0,0,0,3,3
1539849009,Special Grade Snax,0,0,0,0,1,1
1539913919,The Wild Fly Podcast,0,0,0,0,11,11
1539916955,The Authentic Hotwife Podcast,0,0,0,0,2,2
1539949999,Hunting Ghislaine with John Sweeney,14,12,16,6,73,121
1539955572,Reveal Presents: American Rehab,0,0,0,0,12,12
1539968323,Over and In: The Ultimate Volleyball Podcast,0,0,0,0,1,1
1539999669,My Side Of The Bag podcast,0,0,0,0,5,5
1540003023,Recipe Club,2,4,2,6,186,200
1540006729,Classy Trashy,0,0,0,0,8,8
1540012837,Zuri Hall's Hot Happy Mess,0,0,0,0,87,87
1540015480,The World According To Ben Stein,0,1,0,2,34,37
1540031893,NCLEX High Yield,1,0,1,0,8,10
1540067205,Infusing Beauty,0,0,0,0,2,2
1540076549,The Research Evangelist,0,0,0,0,1,1
1540085721,Mini Magic : A Witchcraft Podcast for Kids,0,0,0,0,13,13
1540086368,The Debate Ya Maw Podcast,0,0,0,0,8,8
1540119032,English Kids Story with Katrina,0,0,0,0,2,2
1540120748,The Golf & Fitness Show,0,0,0,0,3,3
1540131474,The Clown and the Candyman,17,4,5,4,40,70
1540133762,MINDBOX,0,0,0,0,1,1
1540160436,Doubles Only Tennis Podcast,0,0,0,0,10,10
1540163040,Satanic Panic,0,0,0,1,0,1
1540164566,Greetings from Somewhere,3,1,0,2,23,29
1540169441,Goodwind Podcast w/ Niko LaPelusa,0,0,0,0,7,7
1540189907,Jean Jacques Machado : No Gi Required,0,0,0,0,4,4
1540196914,Real Conversations with Jacob Young,0,0,0,0,1,1
1540208209,Champaign On Ice: Illinois basketball with Deon Thomas,0,0,0,0,4,4
1540228676,Montessori Babies,0,0,0,0,1,1
1540301491,Live at the Roxy,0,0,0,1,29,30
1540303621,"The First In, Last Out Lifestyle Podcast",0,0,0,0,3,3
1540334562,InForum Minute,0,0,0,0,2,2
1540346656,"Truth, Lies and Puppy Mills",0,0,0,0,15,15
1540354740,Etched In Stone,0,0,0,0,3,3
1540359738,Fast Radio Burst!,0,0,0,0,6,6
1540370040,That's Messed Up: An SVU Podcast,71,23,17,20,369,500
1540373581,The SeedPod for Kids,0,0,0,0,5,5
1540373604,Shaking Out the Numb,0,0,0,0,11,11
1540388539,Now That I'm Not Your Teacher,0,0,0,0,7,7
1540401887,Coming Down The Aisle,0,0,0,0,7,7
1540425024,The Flight Attendant Podcast,0,0,0,0,1,1
1540439511,Making Media Now,0,0,0,0,2,2
1540446330,The blu3collaroffroad's Podcast,0,0,0,0,1,1
1540460631,Running with Coach Jay,0,0,0,0,3,3
1540461709,Night Sky Tourist,0,0,0,0,7,7
1540499099,The SeedPod for Beginners,0,0,0,0,5,5
1540500007,The Alexei Sayle Podcast,0,1,1,1,24,27
1540506130,Bad Advice with Chris Cubas,0,0,0,0,16,16
1540512307,Tales From the Band Room Podcast,0,0,0,0,1,1
1540518611,The Anxious Filmmaker with Chris Brodhead,0,0,0,0,19,19
1540520910,Andrew Scheps Talks to Awesome People,0,0,0,0,1,1
1540526695,The Psychedelic Leadership Podcast,0,0,0,0,10,10
1540529469,My Family Thinks I'm Crazy,0,0,0,0,6,6
1540531792,SmackTalk Presents: The People’s Podcast,0,0,0,0,1,1
1540532283,Lizard Brain Radio,0,0,0,0,2,2
1540534618,The Spring Legion Podcast,0,0,0,0,7,7
1540543705,VT Podcast,0,0,3,1,12,16
1540573682,BBC Gardeners’ World Magazine Podcast,1,0,2,1,15,19
1540606481,The Integral Principles of the Structural Dynamics of Flow,0,0,0,0,8,8
1540614076,EveryBodhi Podcast,0,0,0,0,7,7
1540616436,Warbirds - Tales From Above,0,0,0,0,8,8
1540618100,Coaches on the Run,0,0,0,0,4,4
1540620351,Third Act with Liz Tinkham,0,0,0,0,9,9
1540620512,Bright Wings: Children’s Books to Make the Heart Soar,0,0,0,0,4,4
1540621732,Crime Weekly,12,10,20,14,270,326
1540626323,Ransom Experience,0,0,0,0,3,3
1540626647,Spectre 001,0,0,0,0,5,5
1540628867,Field Of 68 Best Bets,1,1,1,0,9,12
1540631348,The Watershed,1,0,0,0,0,1
1540637903,"Mama Trauma- Christian Trauma Recovery, Healing, & Empowerment After Narcissistic Abuse For Daughter...",0,0,0,1,38,39
1540638499,She's a Woman with Miz Cracker,1,1,0,0,24,26
1540647495,Little Stories Everywhere,9,0,3,1,17,30
1540647502,The Luxury Weekly,0,0,0,0,11,11
1540649075,I/O,0,0,0,0,5,5
1540653151,make good: a knitting podcast,0,0,0,0,13,13
1540658272,The Story of Jesus,0,0,0,0,1,1
1540706214,Small Medium at Large,0,0,0,0,9,9
1540712849,Get Reworked,0,0,0,0,1,1
1540807356,The Ultra Running Guys,0,0,0,0,1,1
1540826523,Wolf and Owl,1,0,1,3,112,117
1540834178,Star Wars: A Long Time To Go,0,0,0,0,2,2
1540834801,Coupla Goofs,0,0,0,0,13,13
1540836655,Rasslin' with Brandon F. Walker,36,1,3,0,457,497
1540837420,Prodigy,2,0,2,1,29,34
1540844881,Mind Over Body with Hypnosis,0,0,0,0,4,4
1540847053,The Business Brew,0,0,0,0,23,23
1540849480,Mommy Doomsday,120,72,42,60,426,720
1540850185,Ic2us: The Evolving Conductor,0,0,0,0,3,3
1540853767,"It's Not Me, It's You",0,0,0,0,26,26
1540856979,@lexie,4,2,0,1,43,50
1540865545,VUHSPEAKS,0,0,0,1,16,17
1540866913,Planet 2000's,0,0,0,0,3,3
1540877085,Coffee with the Chicken Ladies,0,0,0,0,24,24
1540884922,Bogey Society Golf,0,0,0,0,2,2
1540893660,Lost River Legends,0,0,0,0,4,4
1540893664,KooperKast,0,0,0,0,1,1
1540897847,The Brides Of Long Island Podcast,0,0,0,0,19,19
1540909567,Real estate exam prep,0,0,0,0,4,4
1541000965,Odd Squadcast,1,0,0,0,17,18
1541001202,Kids Learn Careers,0,0,0,0,8,8
1541002865,Not Another Nutrition Podcast,1,0,1,0,18,20
1541015275,Greenhouse,0,0,0,0,8,8
1541026486,Death of a Starlet,3,6,8,5,79,101
1541034575,MTV's Official Challenge Podcast,16,6,16,11,140,189
1541056395,The BoardRoom,1,0,0,0,5,6
1541056398,Play Piano By Ear,0,0,0,0,2,2
1541058174,The Football Podcast,0,0,0,0,1,1
1541070210,TV. Watch. Repeat.,0,0,0,0,9,9
1541070670,Commissioner's Office,0,0,0,0,6,6
1541091732,Get Wellthy,0,0,0,1,49,50
1541091902,Journey into polymers,0,0,0,0,1,1
1541124847,COMPETITION PLUS POWER HOUR,0,0,0,0,1,1
1541131029,The Sound of Change,0,0,0,0,20,20
1541155036,SOFcast,0,0,0,0,9,9
1541169185,Trafficked with Mariana van Zeller,0,0,0,2,29,31
1541169586,Salute the Songbird with Maggie Rose,0,0,0,0,7,7
1541183511,Drinks After Work,0,0,0,0,15,15
1541193026,Phil Vassar's Songs from the Cellar,0,0,0,0,3,3
1541215568,Major World Order,0,0,0,0,12,12
1541231051,The Chess Underground,0,0,0,0,1,1
1541254104,Jacksepticeye's Undertale Play-through,0,0,0,0,3,3
1541256187,TraegerMethod Podcast,0,0,0,0,4,4
1541259176,Sales Velocity,0,0,0,0,1,1
1541273111,A Hopeless Endeavor: The Joanna Newsom Podcast,0,0,0,0,2,2
1541274039,More Muse Podcast,0,0,0,1,1,2
1541274724,Duck Call Room,0,0,0,2,48,50
1541315224,Siempre Positivo: A Barcelona podcast,0,0,0,1,1,2
1541330058,Red Collar,50,50,80,65,350,595
1541357616,NewEarth Project,0,0,0,0,1,1
1541368142,Talk About It Outdoors Podcast,0,0,0,0,5,5
1541382349,Getting Pretentious,0,0,0,0,6,6
1541388067,The Endurance House,0,0,0,0,1,1
1541404399,Smarter Markets,4,1,0,0,28,33
1541404400,"The ""What is Money?"" Show",0,0,0,0,8,8
1541466512,Pursuit of the Paranormal,0,0,0,0,1,1
1541483912,Reggaeology - The Reggae History Experience,0,0,0,0,2,2
1541495645,Left Behind: An Experience in Sound and Drama,0,0,0,0,1,1
1541527814,The Fateful Tale of Chesapeake Bay,0,0,0,0,1,1
1541546180,Sacred Steps Podcast,0,0,0,0,2,2
1541550906,Compassion In Action,0,0,0,0,1,1
1541566903,Brooklyn Magazine: The Podcast,0,0,0,0,4,4
1541567246,Gumdrop Readers,0,0,0,0,5,5
1541644073,Design Mind frogcast,0,0,0,0,1,1
1541659647,The Historic Present,0,0,0,0,3,3
1541663781,Public Health Out Loud,0,0,0,0,1,1
1541682405,AMONGus,1,0,0,1,1,3
1541688838,The Pictures Got Small,1,1,0,0,2,4
1541695487,"Real, Smart People",0,0,0,0,1,1
1541721621,The Intro with MDV,0,0,0,0,50,50
1541750537,Nutrition Made Simple,0,0,0,0,4,4
1541761268,Baby Mouth,0,0,0,0,21,21
1541769856,Trey Wingo Presents: Half-Forgotten History,1,2,1,0,21,25
1541771019,Sunday Service,0,0,0,0,2,2
1541774875,McTako,0,0,0,0,1,1
1541775922,Champs App Podcast,0,0,0,0,1,1
1541800715,DARK LIGHT DUGAN,0,1,0,0,2,3
1541809918,Jesse Nyberg Podcast,0,0,0,0,9,9
1541841070,Ramsay's Recaps,0,0,0,0,1,1
1541855523,Anime Ultra,0,0,0,0,6,6
1541856876,Little Talk in Slow French : Learn French through conversations,0,0,0,0,2,2
1541888940,Wilderness Wonders Podcast,0,0,0,0,1,1
1541897857,"Bands, Beers & Buzzwords",0,0,0,0,1,1
1541907492,Dream a Little Deeper,0,0,1,0,3,4
1541924407,The Jay Jay French Connection: Beyond the Music,5,2,1,3,6,17
1541925399,Da Bear Essentials™ - A Chicago Bears Podcast,0,0,0,0,6,6
1541933953,SassCast with Sarah and Amber Podcast,0,0,0,0,3,3
1541945163,Ball Breaking with Mike and Steve,0,0,0,0,1,1
1541971068,To Whom Shall We Go? Podcast,0,0,0,0,2,2
1541975313,Dinosaur George Kids - A Show for Kids Who Love Dinosaurs,0,0,0,0,5,5
1541980201,Tall Tails,0,0,0,0,11,11
1541996013,Slices of Wenatchee,0,0,0,0,2,2
1542010806,How to Fall in Love the Hard Way,0,0,0,0,2,2
1542050255,Drained,0,0,0,0,1,1
1542058976,TOP 5 with JOEY CASSATA,0,0,0,0,2,2
1542083085,Catfish: The Podcast,3,2,4,2,4,15
1542099308,TRACK THE VAX,0,1,0,0,8,9
1542105348,Conspiracy Randy,0,0,0,0,10,10
1542121815,Hot Cakes Fresh Takes — Fantasy Football Podcast,0,0,0,0,2,2
1542136715,Razib Khan's Unsupervised Learning,0,0,0,0,3,3
1542136964,RyR Endurance Team podcast,0,0,0,0,3,3
1542148005,After Bark,1,0,0,1,14,16
1542166642,LEGO® Bits N’ Bricks,1,0,0,1,13,15
1542218158,"Life Untapped - Helping women in midlife rediscover themselves. Support to level up, and get a clear...",0,0,0,0,27,27
1542218700,Triplicates,0,0,0,0,2,2
1542235867,Wildlife Health Connections,0,0,0,0,1,1
1542254289,The Hitchhiker's Guide to the Galaxy,0,0,0,1,3,4
1542290237,What the F*ck is Sea Moss? Debunking the Wild World of Wellness,0,0,2,1,45,48
1542312503,TLDR,0,0,0,0,6,6
1542312567,"Middle Please, Umpire - a Cricket Podcast",0,0,0,0,1,1
1542369697,Desperately Seeking Paul : The Paul Weller Fan Podcast,0,0,0,0,3,3
1542385521,Discovering Forestry,0,0,0,0,1,1
1542390140,Vanlis Presents,0,0,0,1,13,14
1542402383,The Kleio Files,0,0,0,0,3,3
1542404961,The Tommy Tiernan Podcast,0,0,0,1,3,4
1542416465,Adeptus Ridiculous,0,0,0,0,14,14
1542420574,The Council Men,0,0,0,0,2,2
1542461871,Trosky Tuesday,0,0,0,0,2,2
1542462793,Running It with Nate Sexton,0,0,0,1,28,29
1542468135,NFP,0,0,0,0,1,1
1542475843,Sal and Chris Present: Hey Babe!,12,2,4,6,160,184
1542476301,Sal Vulcano & Joe DeRosa are Taste Buds,1,1,1,5,42,50
1542512778,911 Lone Star Round-Up,0,0,0,0,1,1
1542524922,Rave to the Grave,0,0,0,0,5,5
1542532605,Non-Technical,0,0,0,0,14,14
1542534516,FIREFIGHTER SUCCESS PODCAST,0,0,0,0,7,7
1542534548,In Strange Woods,2,2,0,2,44,50
1542537869,Blueprint Athletes Basketball Podcast,0,0,0,0,6,6
1542556024,Teens Talk Tech,0,0,0,0,1,1
1542560229,Doggy Dojo,0,0,0,0,8,8
1542561964,Dog Training Is My Passion,0,0,0,0,4,4
1542566449,Companions of the Message,0,0,0,0,12,12
1542621251,The Class Podcast,0,0,0,0,6,6
1542643454,Pepp Talk Podcast,2,0,0,2,37,41
1542652485,Up On Game,1,1,0,1,14,17
1542659784,Time To Kill,0,0,0,0,2,2
1542659968,Heartbreak to Happiness,0,0,0,0,12,12
1542661316,Break Fast,0,0,0,0,23,23
1542664721,The Great Indian Marketing Show,0,0,0,0,7,7
1542664862,Breaking Glass,0,0,0,0,29,29
1542669779,Headwaters,0,1,0,0,22,23
1542696365,Moms of Tweens and Teens,0,0,0,1,8,9
1542708102,Adventures: Bible Truths in Action,0,0,0,0,4,4
1542725828,DogLogical: Making Sense of Your Dog's Behavior,0,0,0,0,4,4
1542792309,WOE.BEGONE,0,0,0,0,5,5
1542793569,She Runs Ultras,0,0,0,0,4,4
1542794465,BuckTown Beauties,0,0,0,0,3,3
1542810047,OpTic Podcast,0,0,0,0,5,5
1542816604,Habitat University,0,0,0,0,3,3
1542823398,My Dark Path,0,0,0,0,18,18
1542839351,3 GIRLS 1 KITCHEN,4,4,2,2,106,118
1542840652,"You Know It’s Fake, Right?",0,0,0,0,6,6
1542843873,The ClownCast with Niles Abston & Harper-Rose,1,1,0,0,11,13
1542863521,Gimme Danger Radio,0,0,0,0,2,2
1542888792,Awakening OD,0,0,1,0,57,58
1542890986,America's Past Time,0,0,0,0,9,9
1542891074,The Cellar Letters,0,0,1,0,10,11
1542925569,Non-Rev Lounge,0,0,0,0,11,11
1542941141,WorldAroundEwe's podcast,0,0,0,0,2,2
1542985245,Sparrows Point: An American Steel Story Podcast,0,0,1,1,3,5
1543039142,The Charles Mizrahi Show,0,0,0,1,34,35
1543052982,HOT WIDOWED MESS,0,0,0,0,2,2
1543060650,Magic Locker,0,0,0,0,4,4
1543089355,One Shot Dungeons,0,0,0,0,3,3
1543090622,NFL Total Access: The Locker Room,0,0,0,2,2,4
1543098312,The Early Edge: A Daily SportsLine Betting Podcast,10,2,2,1,388,403
1543110518,The Andrew Price Podcast,0,0,0,0,2,2
1543111150,Taking Alex,0,1,2,0,14,17
1543227602,Norco 80,51,21,17,10,57,156
1543230162,Understanding Congress,0,0,0,0,1,1
1543252280,Predators I've Caught With Chris Hansen,0,0,0,1,50,51
1543253943,Abundant Living and Gardening,0,0,0,0,2,2
1543274942,The Catfish on Ice Podcast,0,0,0,0,1,1
1543277615,The Costume Plot,0,0,0,0,4,4
1543279736,Because We Got High,5,0,2,7,36,50
1543330611,Human & Holy,0,0,0,0,19,19
1543333521,Behind The U,0,0,0,0,5,5
1543363295,HACK IT OUT GOLF,4,2,1,0,31,38
1543392645,The Union of the Unwanted,3,1,1,0,15,20
1543404398,Meeting Tom Cruise,4,0,0,2,36,42
1543422719,Off The Hook with Jimmy Bullard,0,0,0,2,52,54
1543433086,King Kirby,0,0,0,0,3,3
1543453225,The William Hall Show,0,0,0,0,7,7
1543456877,Tom Talks,0,0,2,0,68,70
1543458790,The Table with Anthony ONeal,1,0,0,1,48,50
1543470501,Another Dooley Noted Podcast,0,0,0,0,14,14
1543476170,Unraveled: Long Island Serial Killer,56,26,42,52,824,1000
1543483272,Geek Giant Podcast,0,0,0,0,6,6
1543485536,Invoking Witchcraft,0,0,0,0,16,16
1543487661,The Houston Running Zone,0,0,0,0,1,1
1543499152,Parental Advisory Podcast,1,1,1,0,101,104
1543502852,Queer Movie Review,0,0,0,0,1,1
1543535062,Parenting After Trauma with Robyn Gobbel,0,0,0,0,1,1
1543559152,IDC - Future Enterprise,1,0,0,0,0,1
1543563360,A Second Helping of Hannibal,0,0,0,0,1,1
1543565180,Tempo Talks Podcast,0,0,0,0,11,11
1543588981,A History Of Sonic The Hedgehog,0,0,0,0,3,3
1543604629,Tabletop Time,0,0,0,0,11,11
1543615866,Women & ADHD,0,0,0,0,7,7
1543620573,Pro Wrestling History Nerds,0,1,1,0,2,4
1543641174,Friends With A Twist: A Swinger Podcast,0,0,0,1,1,2
1543643203,Worldwide Exchange,1,0,0,0,0,1
1543643637,All Things Physical Therapy Podcast,0,0,0,0,5,5
1543648065,Bettors Delight,0,0,0,1,16,17
1543649192,Not Your Father's Autobot: A Transformers: Generation Two Comic Book Podcast,0,0,0,0,1,1
1543654440,Muslims Doing Things,0,0,0,0,49,49
1543658063,Kindred Conversations,0,0,0,0,37,37
1543664595,Brand New Dad Podcast,0,0,0,0,5,5
1543666987,Paranormal Radius,0,0,0,0,2,2
1543714199,A New Life in Italy,0,0,0,0,1,1
1543722709,Lil Flip & DJ Hard Hitta Presents The Truth Shall Set You Free Podcast,0,0,0,0,2,2
1543730794,Heading For Home,0,0,0,0,9,9
1543732392,Today I Am Grateful,0,0,0,0,9,9
1543742499,Build Your Copywriting Business,0,0,1,1,188,190
1543788045,Blood Origins,0,0,0,0,11,11
1543790060,The Definitely Not Simple Life,0,0,1,0,35,36
1543796100,Rugby Revealed,0,0,0,0,2,2
1543807730,Humans Are Divine,0,0,0,0,1,1
1543808741,Pay to Play,0,0,0,0,2,2
1543819212,We Were Christian Kids with Justin Randall and Calvin Arsenia,0,0,0,1,20,21
1543824122,Rolling with the Punches with Rabbi Eli Portal,0,0,0,0,10,10
1543827555,Pandemic Puppy Podcast,0,0,0,0,3,3
1543831460,Slouch Theory by Andre D. Thompson,0,0,0,0,2,2
1543832302,Pooch & Rabold,0,0,0,0,2,2
1543832585,SongTown on Songwriting,0,0,0,0,3,3
1543837572,Tales From Yaya's: The Your Honor Podcast,0,0,0,0,3,3
1543842041,That's Loaded,2,0,0,0,74,76
1543842894,Are You My Podcast?,0,0,0,0,50,50
1543844344,90 Day The Melanated Way with Linda Antwi,0,0,4,0,1,5
1543866567,The Chavrusa,0,0,0,0,1,1
1543887425,The Cipher,0,0,0,1,6,7
1543925509,Cultural Competence,0,0,0,0,2,2
1543938819,The CBB Grind Podcast with Cutri and Stills,0,0,0,0,1,1
1543940348,The Tabletop Tales,0,0,0,0,6,6
1543943971,The Positivity Xperience,0,0,0,0,3,3
1543958462,The Smallmouth Crush Podcast,0,0,0,0,16,16
1543962902,CONSPIR-A-THEORIA,0,0,0,0,1,1
1543971709,Treehouse- Alex G,0,0,0,0,8,8
1543972203,Big Time Golf Guys - A Golf Equipment Podcast,0,0,0,0,1,1
1543979469,Fantasy Magazine - Fantasy Story Podcast (Audiobook | Short Stories),0,0,0,0,1,1
1543981748,PFF NFL Daily,1,0,0,2,22,25
1543989732,The Gestalt Education Show,0,0,0,0,4,4
1543992427,Moore to the Story,0,0,0,0,6,6
1544011433,Modern Direct Seller Podcast,0,0,0,0,2,2
1544023617,Paige's Pod,0,0,0,0,20,20
1544023855,The Bass Report,0,0,0,1,4,5
1544031215,The How To Podcast,0,0,0,0,1,1
1544053785,A Court of Fandoms and Exploration - A Podcast.,0,0,0,0,4,4
1544153998,Understanding Human Design Podcast,0,0,0,0,2,2
1544156952,Jobsolete,9,5,8,4,14,40
1544169500,PEOPLE Every Day,0,0,0,1,7,8
1544171101,Under the Influence with Jo Piazza,3,0,1,1,32,37
1544172680,Stacey King's Gimme the Hot Sauce Podcast with Mark Schanowski & Friends,0,0,0,0,3,3
1544173982,The Gathering Pod,0,0,0,0,8,8
1544179759,PORQUE YES!,0,0,0,0,2,2
1544188719,Juan Ep Is Dead,0,0,0,0,50,50
1544191383,Come To Find Out,0,0,0,0,2,2
1544196195,In Loco Parent(i)s,0,0,0,0,6,6
1544239486,From Now,2,3,3,2,40,50
1544276107,The Baseline Podcast,0,0,0,0,6,6
1544280973,Pain-Free Performance Podcast,0,0,0,0,14,14
1544293818,ShoOT the Breeze,0,0,0,0,1,1
1544306555,The Ouachita Chronicles,0,0,0,0,1,1
1544308764,The Buffet,0,0,0,0,2,2
1544342156,HGTV Obsessed,0,0,0,0,24,24
1544388170,The Living Soil Podcast,0,0,0,0,3,3
1544474222,A-Z of Phil Collins,0,0,0,0,18,18
1544475151,The Tayler Yarish Show,0,0,0,0,8,8
1544487624,What's Left of Philosophy,0,0,0,0,3,3
1544492743,Health Freedom for Humanity Podcast,1,0,0,0,20,21
1544556086,Chillin' With Kofie,0,0,0,0,10,10
1544558746,Godcast,7,2,0,0,41,50
1544564772,DX Daily,1,0,0,0,10,11
1544564920,Runner's University,0,0,0,0,2,2
1544619644,Ty & That Guy,1,0,0,0,31,32
1544624403,Elbows And Jumpers,0,0,0,0,1,1
1544625081,Dolly Parton Fan TV - The Podcast with Andy Crust,0,0,0,0,2,2
1544626580,Febrile,0,0,0,0,1,1
1544632700,SHOW ME THE MONEY HOCKEY PODCAST,0,0,0,0,5,5
1544638693,Hell Gate City Companion,0,0,0,0,4,4
1544648923,The Grass is Greener with Paul Greene,0,0,1,1,48,50
1544649666,The Trust Me When I Tell You Podcast,0,0,0,0,2,2
1544672735,Forever on the Fly,0,0,0,0,9,9
1544678028,Warzone Amateur Hour Podcast,0,0,0,0,3,3
1544688724,"The Dad, Dilly, & Link Show",0,0,0,0,7,7
1544689725,League of Scumbags,0,0,0,0,2,2
1544694964,CHATS WITH SWEETIE,1,0,0,0,3,4
1544812283,Our Thing with Sammy The Bull,2,0,0,0,48,50
1544820949,Plantaholics Podcast,0,0,0,0,1,1
1544829611,Zedcast - The Tyler Zed Podcast,1,0,1,0,57,59
1544833260,The Goldmine,0,0,0,0,7,7
1544836852,For a Better World,0,0,0,0,13,13
1544843472,THESPINUP,0,0,0,0,50,50
1544844406,The3Muslims,0,0,0,0,3,3
1544851089,Unearthed Gems,0,0,0,0,2,2
1544862951,Gaining Ground: The New Georgia,12,1,0,0,37,50
1544875746,I Learned About Flying From That,0,0,0,0,1,1
1544878893,The Terrific Teacherpreneur,0,0,0,0,6,6
1544899369,NASTY KNUCKLES PODCAST,0,1,0,0,23,24
1544910944,Improv On Tape,0,0,0,0,17,17
1544916343,Keeping Records,1,0,0,0,32,33
1544951886,Mella Moment,0,0,0,0,11,11
1544957883,Let’s Shag,0,1,1,0,26,28
1544967641,First Down with Dave,0,0,0,0,2,2
1544975063,Cold Weather Bats,0,0,0,0,7,7
1544980241,The Way I Taught It,0,0,0,0,2,2
1544981469,Film Maker Podcast,0,0,0,0,1,1
1544982433,Every Plant Story | Gabriella Plants,0,0,0,0,2,2
1544988104,Wrestling With The Week,1,0,0,0,24,25
1544990227,The Official Leeds Utd Podcast,0,0,0,0,2,2
1545013308,Call Your Grandmother,0,0,0,0,50,50
1545028267,AMA COVID-19 Update,0,0,0,0,1,1
1545036465,The Story of Heidelberg,0,0,0,0,30,30
1545037598,Best Bets with Kate & Betsy,0,0,0,0,4,4
1545052064,The Right View with Lara Trump,1,0,0,0,12,13
1545057353,Animal of the Day Podcast,0,0,0,0,3,3
1545077798,Creepypasta,1,0,0,0,1,2
1545085078,Mack's World,0,0,0,0,14,14
1545090575,The Modern Extractor,0,0,0,0,8,8
1545096641,FIFA Dads,0,0,0,0,2,2
1545167139,RedCard Radio with Austin Robillard,0,0,0,0,2,2
1545174922,Through The Cracks,5,6,4,5,58,78
1545181632,Modern Creator,0,0,0,0,3,3
1545188897,Kai's Korner,0,0,0,0,2,2
1545198843,Defining Duke: An Xbox Podcast,2,2,0,2,44,50
1545205930,On The Tape,0,0,1,1,14,16
1545211302,Attack on Attack on Titan,0,1,0,0,1,2
1545216685,Hubris: A 24-Hour Podcast Project,0,0,0,0,1,1
1545221046,To Etsy and Beyond,0,0,0,0,3,3
1545222867,DVMT: Doctors of Veterinary Medical Television,0,0,0,0,2,2
1545233696,The Apology Line,118,132,138,60,546,994
1545240757,One-Over presented by THE Breakfast Ball Media Network,0,1,0,0,2,3
1545252076,Self Taught Artist,0,0,0,0,8,8
1545276557,Wildlife Stories,0,0,0,0,1,1
1545295618,Planner Talk Podcast,0,0,0,0,7,7
1545309492,Crosscut Escapes,0,0,0,0,3,3
1545370804,Big Daddy Graham’s Countdown,0,0,0,0,4,4
1545419596,Pathogen Perspectives,0,0,0,0,3,3
1545433056,"Follow Him: A Come, Follow Me Podcast with Hank Smith & John Bytheway",0,0,1,0,167,168
1545437343,That's So Much Brian Mcknight!,0,0,0,0,1,1
1545449150,College Hoops Mania,3,0,0,0,13,16
1545472057,The Bianca Del Rio Podcast,4,0,0,4,554,562
1545516666,Gusgri Podcast,0,0,0,0,2,2
1545522989,Fisher Family Ghosts: A Six Feet Under Companion Podcast,0,0,0,0,3,3
1545576173,Probably a Podcast,6,1,3,4,36,50
1545586439,Food Network Obsessed,1,0,0,1,38,40
1545627943,Hazards of the Roll,0,0,0,0,1,1
1545628110,The Truth About Recording & Mixing,0,0,0,0,3,3
1545644131,How to Tell Stories to Children,0,0,0,0,1,1
1545646307,Beat the Shift,0,0,0,0,12,12
1545647129,Stellar Teacher Podcast,0,0,0,0,10,10
1545657828,Eat Train Prosper,0,0,0,0,2,2
1545659686,Evil By Design,3,2,0,1,32,38
1545664367,Talking Body with Amy Porterfield,0,1,0,0,34,35
1545676832,Mad Women,0,0,0,0,2,2
1545719793,A More Civilized Age: A Clone Wars Podcast,1,0,1,0,102,104
1545725721,Checkers or Wreckers,0,0,0,0,4,4
1545743230,The FANgals Podcast,0,0,0,0,21,21
1545748121,Dark Horse Live!,0,0,0,0,1,1
1545768897,God Help the Troubadour: The Eternal Voice of Phil Ochs,0,0,0,0,4,4
1545775544,Drafting Archetypes,1,0,0,0,12,13
1545814130,Amira & Tree After Dark,0,0,0,1,8,9
1545830333,Crime Analyst,1,0,0,2,120,123
1545830343,Dishing Drama with Dana Wilkey UNCENSORED,5,2,2,0,24,33
1545841764,The Messy Masterpiece with Tori & Chad,0,0,0,0,6,6
1545856269,Brotaku Block,0,0,0,0,2,2
1545873992,Tales From The Dark,0,0,0,0,10,10
1545876069,Divorce Matters,0,0,0,0,10,10
1545876734,Baby Got Bach,5,6,5,4,78,98
1545885152,RBaseball Weekly,0,0,0,0,2,2
1545953110,Huberman Lab,0,0,0,0,875,875
1545968370,The Stormchaser Improv Podcast Show,0,0,0,0,17,17
1545988835,Tea with Publyssity,2,0,0,1,154,157
1545988886,THIS LEAGUE,168,3,0,1,37,209
1545989160,Friday Night Pints,0,0,0,0,50,50
1545989901,Let's Sleep On It: Reclaiming Parenthood,0,0,0,0,14,14
1545998787,"Sex, Lies & Parenthood",0,0,0,0,7,7
1546000046,The Nosleep Radio,0,0,0,0,12,12
1546005041,Red Pill Tamales,0,0,0,1,8,9
1546010041,Funny Running Stories,0,0,0,0,1,1
1546027998,Business Movers,2,1,0,2,27,32
1546061812,High Turnout Wide Margins,0,0,0,0,2,2
1546092478,Life After Sugar,0,0,0,0,3,3
1546102876,Just the News A.M. with Carrie Sheffield,0,0,0,0,3,3
1546104578,No F*cks Given Podcast,15,2,3,2,40,62
1546132415,RELAX! with Colleen Ballinger & Erik Stocklin,0,0,0,0,50,50
1546136126,GM Files,0,0,0,2,2,4
1546149881,Beatles vs. Stones,0,0,0,0,4,4
1546154506,Ben and Glenn's After Hours,0,0,1,3,14,18
1546160820,The Mindset Mile,0,0,0,0,18,18
1546164818,Dog Edition,0,0,0,0,2,2
1546168224,Difference Makers,0,0,0,0,1,1
1546170271,Third Fleet Podcast,0,0,0,0,10,10
1546171048,An Open Water Swimmer's Podcast,0,0,0,0,2,2
1546172849,why are we still talking,0,0,0,0,3,3
1546177056,Ketchup With The Freys,0,0,0,0,40,40
1546181627,Lasso Cast,0,0,1,0,6,7
1546226385,Mi Puck Drop,0,0,0,0,1,1
1546267644,Morning Announcements,5,2,3,4,137,151
1546268667,Conversations with Elizabeth Johnston,18,0,0,1,23,42
1546280287,The CoVax Files,0,0,0,0,6,6
1546281199,Matthias J Barker Podcast,0,0,0,1,49,50
1546281391,Curse of Civilization,0,0,0,0,5,5
1546282193,Million Dollar Esthetician,0,0,0,0,1,1
1546282862,The Athletic Hockey Show: A show about the NHL,6,2,3,1,8,20
1546288185,Squawk 5353 - The Private Pilot Podcast,0,0,0,0,2,2
1546290282,Livin' The Dream,0,0,0,0,12,12
1546295087,ModelGeek's Podcast,0,0,0,0,5,5
1546324192,Linda Marigliano's Tough Love,1,0,0,0,26,27
1546356595,Prank Calls with Leon Haberdashery,0,0,0,0,2,2
1546383966,Chicano Squad,11,4,2,4,103,124
1546393799,The Elmwood Strain,2,0,1,0,16,19
1546394941,Balls Deep,0,0,1,1,48,50
1546441322,Inside The Hits,0,0,0,0,3,3
1546454450,The Cutting Room Floor,0,0,0,0,3,3
1546456269,Mayim Bialik's Breakdown,1,1,0,0,18,20
1546471194,Bear with Us Grrl,0,0,0,1,5,6
1546507907,"The Women of Regenerative Ag: Transforming the Health of the Soil, Land & People",0,0,0,0,4,4
1546509744,Only Fans Secrets,0,0,0,0,2,2
1546510734,Anatomy of an Artist,0,0,1,0,33,34
1546510815,The Best Minutes Podcast,0,0,0,0,2,2
1546516674,Friends with Dogs Podcast,0,0,0,0,2,2
1546521148,Cram The Pance,0,0,0,0,9,9
1546521768,The Fly Good Podcast,0,0,0,0,2,2
1546552380,Hardcore HonesTEA,8,0,0,0,20,28
1546554850,Kraig Adams,0,0,0,0,2,2
1546571992,Morning Meditation for Women,0,0,1,0,1,2
1546578041,The Last Storm - OKC Thunder Podcast NBA,15,0,0,0,17,32
1546621418,STOURIES: An All Access Podcast,0,0,0,0,7,7
1546630597,Boss Better Now with Joe Mull,0,0,0,0,33,33
1546652394,The Patriotically Correct Radio Show with Stew Peters | #PCRadio,0,0,0,0,3,3
1546656308,Reflections,1,0,0,1,224,226
1546656729,The Jesus Show (not that one),0,0,0,0,3,3
1546661283,A Change of Brand,0,0,0,0,22,22
1546664164,A Fools Errand,0,0,0,1,9,10
1546669847,below the influence(R),0,0,0,0,50,50
1546685351,The CopDoc Podcast: Aiming for Excellence in Leadership,0,0,0,0,1,1
1546693935,Meddling with Monsters,0,0,0,0,6,6
1546735571,The Our Strange Skies Podcast Archive,1,0,0,0,8,9
1546737500,CrochetingWorlds,0,0,0,0,2,2
1546742987,Slapshot Sweethearts,0,0,0,0,4,4
1546761026,Race to 270,1,0,0,1,48,50
1546762772,Bridgerton Fancast,1,0,0,1,22,24
1546764793,The Diversity Gap Academy,0,0,0,0,1,1
1546792967,Hoe With A Bro,0,0,0,0,1,1
1546807450,Normal Frum Women,0,0,0,0,8,8
1546812743,Breaking Down Patriarchy,1,1,0,0,25,27
1546815819,Ernestly Speaking! with Ernest Owens,1,0,0,0,15,16
1546873523,Looking For The Todt Family,2,3,4,4,32,45
1546889021,Thirty Minutes of Hell with Pat Bradley,0,0,0,0,3,3
1546892635,Tomorrow's Monsters,2,3,1,1,34,41
1546895069,Bouncing Forward with Amy Purdy,0,0,0,0,40,40
1546913017,Householders: American Life as Zen Practice,0,0,0,0,5,5
1546915402,Why Am I Telling You This? with Bill Clinton,10,1,0,0,23,34
1546928381,Foreward Podcast,0,0,0,0,42,42
1546953501,State Of The Marauders,0,0,0,0,1,1
1546972743,Excellently Executed: Bret Hart Matches,0,0,0,0,1,1
1546973825,You're Still Here?!?,0,0,0,0,12,12
1547009215,The Swimmer Strength Podcast,0,0,0,0,3,3
1547041290,Undressing Bridgerton,0,2,0,5,160,167
1547042244,The Canine Condition,0,0,0,0,2,2
1547042439,Gotta Get It Podcast!,0,0,0,1,14,15
1547048108,No Focks Given,1,0,0,2,47,50
1547054438,Just Add Dogs Podcast,0,0,0,0,4,4
1547059330,Tales from the Crawlspace,0,0,0,0,2,2
1547078080,All It Takes Is A Goal,0,0,0,2,48,50
1547080455,K-Drama School,0,0,0,0,5,5
1547081195,Anything Better?,0,1,1,0,48,50
1547082360,The Man Card Podcast,0,0,0,0,5,5
1547083499,Prop History Podcast,0,0,0,0,2,2
1547086264,"Hey, Stranger!",0,0,0,0,6,6
1547094917,The D&D Fitness and Nutrition podcast,0,0,0,0,10,10
1547098165,Krystal Kyle & Friends,1,0,3,3,68,75
1547098253,White Sox Weekly,0,0,0,0,2,2
1547098550,Root2Seed,0,0,0,0,2,2
1547099740,Grimerica Outlawed,0,0,0,0,14,14
1547103308,Dogish Podcast,0,0,0,0,2,2
1547119564,3 Minutes of Leadership,0,0,0,0,3,3
1547123816,Newly Erupted,0,0,0,0,1,1
1547142968,MI Take,0,0,0,1,4,5
1547148098,Real WW Talk,0,0,0,0,9,9
1547150408,One More Drink,0,0,0,0,15,15
1547152221,The Glow Show,0,0,0,0,11,11
1547154926,Behind The Weather Forecast,0,0,0,0,2,2
1547170121,She Talks Birdie,0,0,0,0,2,2
1547179580,"Fuel Her Awesome: Food Freedom, Body Love, Intuitive Eating & Nutrition Coaching",0,0,0,0,50,50
1547181820,Sturdy For 30,0,0,0,0,3,3
1547182100,Drew and Sam Talk Training,0,0,0,0,1,1
1547195599,Case Craze,0,0,0,0,17,17
1547197567,The NeverEnding Movie Marathon,0,0,0,0,8,8
1547205002,Stall Stories,0,0,0,0,2,2
1547207241,Ask Carson James,0,0,0,0,8,8
1547210697,Come Follow Me for Young Families,0,0,0,0,7,7
1547220183,Hooked on Looming,0,0,0,0,2,2
1547220628,Inquisikids Daily,0,0,0,1,3,4
1547222295,The Silt Verses,0,0,0,1,12,13
1547225334,Into The Grey Zone,4,2,4,4,13,27
1547229368,The Graham Norton Podcast,0,1,1,0,8,10
1547235591,Africa Daily,1,0,1,0,0,2
1547246790,Bangalore In Stories,0,0,0,0,4,4
1547257194,UNQUALIFIED,0,0,1,0,23,24
1547257457,Subie & YOU!,0,0,0,0,15,15
1547257700,P. T. S. D - Pressure Talks with Single Dads,5,1,2,1,12,21
1547257763,ARCHITECTING Podcast - Career + Lifestyle Mentoring for Architects looking to move beyond overwhelm ...,0,0,0,0,2,2
1547265474,Power: The Maxwells,19,12,9,9,32,81
1547269345,MAFS Mamas,0,0,1,0,7,8
1547278397,The Daily Crime,12,2,8,3,34,59
1547279915,Millionaire Girls Club Podcast,0,0,0,0,11,11
1547285654,College Admissions Real Talk with Dr. Aviva Legatt,0,0,0,0,2,2
1547293027,Behind the Page: The Eli Marks Podcast,0,0,0,0,2,2
1547297451,Get Knit Done,0,0,0,0,2,2
1547303502,The Home Birth After Cesarean Podcast,0,0,0,0,3,3
1547303899,Rookie Big Board Fantasy Football Podcast,0,0,0,0,10,10
1547312048,Sweep the Floor,0,0,0,0,3,3
1547322420,Acoustic Voices: A Guitar Podcast,0,0,0,0,1,1
1547331397,The Think Stupid-Simple Podcast,0,0,0,0,9,9
1547334927,The Hango Show,0,0,0,0,2,2
1547338945,From the Cheap Seats,0,0,0,0,3,3
1547340963,The Aesthetic Report,0,0,0,0,14,14
1547349520,MorWrestling,0,0,0,0,5,5
1547358999,Talking It Out,2,1,3,4,80,90
1547363866,The WorkSmart Podcast With Morgan DeBaun,0,0,0,0,22,22
1547367594,LongDays with Yannis Pappas,0,0,0,1,49,50
1547368543,Unapologetic Parenting,0,0,0,0,4,4
1547368627,Talking Time With Tim,0,0,0,0,2,2
1547434626,FEICES,0,0,0,0,1,1
1547444481,The Resource Room,0,0,0,0,1,1
1547450364,FIFA PlayOn,0,0,0,1,8,9
1547457937,Higher Sex,0,0,0,0,3,3
1547460885,Alternate Shot,0,0,0,0,4,4
1547488339,Preschool All Stars,0,0,0,0,50,50
1547494801,Seek Learning,0,0,0,0,3,3
1547499876,Longshot: Return Man,2,3,3,1,15,24
1547502821,Attention to Detail: The Podcast,0,0,0,0,4,4
1547522442,It Still Slaps,0,0,0,0,3,3
1547540166,Ask Deer Abby,0,0,0,0,3,3
1547542700,The Ace Metaphor Audio Experience,0,0,0,0,2,2
1547617029,Inside the Breakthrough - How Science Comes to Life,0,2,0,1,1,4
1547638307,Zen of Dog Ownership,0,0,0,0,1,1
1547645093,Double Date with Marlo Thomas & Phil Donahue,0,0,0,0,12,12
1547652943,The Porrada Podcast,0,0,0,0,11,11
1547658204,The Secret Life Of Cookies,1,0,0,0,10,11
1547669099,Live from Mount Olympus,0,0,0,0,25,25
1547670966,Lightweights Podcast,1,0,1,1,47,50
1547672733,Talking Trees with Davey Tree,0,0,0,0,1,1
1547694581,AJ and Sara,1,0,0,0,46,47
1547694701,The Tipping Point with Jimmy Evans,0,0,0,0,10,10
1547729711,Tea with Ms. McGill Show,0,0,0,0,1,1
1547735437,The Fanco Wrestling Show,0,0,0,0,13,13
1547736140,Twinning at Life,2,0,0,1,86,89
1547752940,The Spiritually Sassy Show,0,0,0,0,28,28
1547759747,JOSH MAT SEVAN,0,0,1,1,30,32
1547826633,The Robbie Fowler Podcast,1,0,0,5,27,33
1547827376,The Dinesh D'Souza Podcast,37,1,2,6,445,491
1547832809,Honest UX Talks,0,0,0,0,2,2
1547839958,Tornado Trackers,0,0,0,0,9,9
1547845293,Doing Justice,0,0,1,0,76,77
1547851765,H2OME,1,1,1,0,6,9
1547852755,The First Mint :: NBA Top Shot Podcast,2,0,0,0,22,24
1547855593,Missing Maura Murray,4,2,1,0,3,10
1547859552,Intermittent Fasting by Cabral Concept,0,0,0,0,2,2
1547859748,The WTF California Podcast,0,0,0,0,1,1
1547861287,Here First,0,0,0,0,4,4
1547862135,A Lifetime in NASCAR,0,0,0,0,1,1
1547866250,Disney Movie Insiders Presents,0,0,0,1,7,8
1547867017,The Damsel Dialogues,0,0,0,0,3,3
1547871383,The Long Shot with Duncan Robinson and Davis Reid,1,0,1,1,69,72
1547874983,World Reimagined,0,0,0,0,29,29
1547876266,That Scene with Dan Patrick,2,0,0,0,5,7
1547877852,The Profitable Audience Podcast,0,0,0,0,50,50
1547887484,Flight Suit Friday,0,0,0,0,3,3
1547902921,Dr. Jackie's Point of V,0,0,0,1,12,13
1547906034,All About Capital Campaigns,0,0,0,0,1,1
1547914652,Podding the Red Sox,0,0,0,0,3,3
1547914653,Fantasy Hockey Picks & Bets,1,0,0,0,139,140
1547920492,Mostly wrestling stories,0,0,0,0,1,1
1547920768,Entre Hermanas con Alejandra Espinoza y Damaris Jimenez,0,1,0,1,48,50
1547921110,The Crossover,0,0,0,0,4,4
1547922859,Indian Startup Stories,0,0,0,0,6,6
1547923514,Make Your Damn Bed,0,0,0,0,5,5
1547925961,PenteTalks 2021,0,0,0,0,4,4
1547936618,Do I Look Like I Know? (DILLIK),0,0,0,0,1,1
1547941821,Midnight Memories: The Podcast,0,0,0,0,1,1
1547990105,Win(e)d Down,0,0,0,0,1,1
1547995680,The Real Canon,2,1,0,2,8,13
1547996961,The 18th Airborne Corps Podcast,1,2,1,0,7,11
1548001320,Space F*****s,0,0,0,1,2,3
1548010438,Trosky Ranch Complete Player Development,0,0,0,0,1,1
1548012278,A Gutsy Girl,0,0,0,0,22,22
1548013961,Reparations: The Big Payback,12,2,2,2,32,50
1548020362,Franny Tings,0,0,0,0,8,8
1548020763,Pooch Parenting,0,0,0,0,6,6
1548029032,That's So Sabotage,1,0,0,0,20,21
1548033706,The Intuitive Eating Podcast,0,0,0,0,5,5
1548034799,Puppy Talk,0,0,0,0,7,7
1548049834,Top 9 Podcast,0,0,0,0,6,6
1548085638,MCU Pod: A Marvel Cinematic Universe Podcast,0,0,0,0,3,3
1548094069,The Wrestling Matt Podcast,0,0,0,0,10,10
1548104396,Ben and the Baby,0,0,0,0,1,1
1548152176,The Salmonville Letter Writer,0,0,0,0,1,1
1548154443,The Cinecal Moviecast,0,0,0,0,1,1
1548165464,Side Quest Side Sesh,0,0,0,0,50,50
1548167444,Open Mic Comedy Show,0,0,0,1,3,4
1548173826,Be The Right Club Today Podcast,0,0,0,0,2,2
1548187636,Practically Gita,0,0,0,0,3,3
1548193932,Teen Summit Podcast,0,0,0,0,1,1
1548195448,Cannons & Tomahawks Podcast,0,0,0,0,1,1
1548199934,It Holds Up,0,0,0,0,6,6
1548204936,Mom Friends,0,0,1,1,48,50
1548205763,Marty Smith - The Road You Leave Behind,0,0,0,0,15,15
1548207149,Miami Sports Vibes with Nando Diaz - A Miami Heat & Miami Dolphins Podcast,0,0,0,0,29,29
1548209868,Pimples and boners,0,0,0,0,1,1
1548211862,Rolltergeist,1,0,0,1,2,4
1548212425,Off The Record: David Bowie,1,0,1,1,22,25
1548213083,Honey Bee Obscura Podcast,0,0,0,0,5,5
1548213393,The Animal Rescue Podcast: what you always wanted to know but didn’t know who to ask,0,0,0,0,1,1
1548215793,The Book of Life: Weekly Wisdom with Ruchi Koval,0,0,0,0,1,1
1548227555,Rise of the Classics Podcast,0,0,0,0,2,2
1548232181,Borgo Pass Horror Podcast,0,0,0,1,4,5
1548234869,Abide,1,0,5,1,97,104
1548235017,BOY TALK,1,0,0,0,27,28
1548244887,Unofficial Sources,0,1,0,0,2,3
1548245305,Goodbye Glam Squad - the Erika Jayne Girardi Scandal,1,1,0,0,2,4
1548251094,We Might Be Drunk,0,1,0,0,43,44
1548256471,Alberto del Arco,0,0,0,0,1,1
1548279685,At Home with Benalivi,0,0,0,0,14,14
1548294013,COURTSIDE with Neal Katyal,0,0,0,0,11,11
1548300676,Living Electric,0,0,1,0,1,2
1548302503,OFX Podcast,0,0,0,0,1,1
1548303646,"Boiler Up, with Rapheal Davis",0,0,0,1,11,12
1548323038,EOD Drinks,0,0,0,0,1,1
1548333733,The Striker MLS Podcast,0,0,0,0,1,1
1548351312,Uncultured Bias with Camara Williams,0,0,0,0,10,10
1548355339,Afro Saiyan Podcast,0,0,0,0,2,2
1548369301,Cleared for Takeoff,0,0,0,0,1,1
1548376235,15 Point Plan,0,0,0,0,19,19
1548390421,The Link Up Listening Party,0,0,0,0,7,7
1548395260,"Faith, Philosophy & Politics",0,0,0,0,5,5
1548406600,The Powerstroke Tech Talk w/ARod Podcast,0,0,0,0,3,3
1548409228,The NeoJurassic Podcast : The Wild Possibilities of a Jurassic World,0,0,0,0,1,1
1548411300,Who Knows? We Don't!,0,0,0,0,1,1
1548416919,"Easier Movement, Happier Horses",0,0,0,0,1,1
1548443455,Real Reality Fantasy Football,0,0,0,0,17,17
1548498564,FWF: Figure Wrestling Federation,0,0,0,0,30,30
1548501165,The Water Tales,0,0,0,0,1,1
1548518688,The Whimsy + Wellness Podcast,0,0,0,1,49,50
1548524431,Video Express,0,0,0,0,3,3
1548524996,Knowable,0,0,0,0,1,1
1548526481,DFL Running Podcast,0,0,0,0,3,3
1548527210,Calm Down with Erin and Charissa,1,0,1,1,80,83
1548529935,Dear Jenna,0,0,0,0,50,50
1548530614,Clubs & Corks Golf Podcast,0,0,0,0,12,12
1548535257,Yu Dive Deep,0,0,0,0,10,10
1548542874,Off-Grid Essential Podcast,0,0,0,0,1,1
1548544607,Phase Zero,2,0,4,1,45,52
1548544921,Suave,0,0,2,0,102,104
1548550769,The Parker Edison Project,1,0,0,0,5,6
1548558519,Best Beast,0,0,0,0,3,3
1548560507,NASCAR Weekly Podcast,0,0,0,0,4,4
1548568910,Bleav in Wake Forest Basketball,0,0,0,0,3,3
1548584941,Moments That Rock with Tony Michaelides,0,0,0,0,1,1
1548596327,Object Of Sound,0,0,0,0,13,13
1548604447,The Ezra Klein Show,10,4,6,12,164,196
1548607845,Discussing Marvel : A WandaVision Aftershow,1,0,0,0,4,5
1548610889,Hey! It's a Disc Golf News Podcast,0,0,0,0,1,1
1548621904,Non Prophets Podcast,0,0,0,0,2,2
1548681924,The Soil Health Hub Podcast,0,0,0,0,1,1
1548716991,How Can I Help? – with Dr. Gail Saltz,1,0,0,0,10,11
1548725552,Facing Forward,0,0,1,1,10,12
1548766435,Tougie's Take,0,0,0,0,3,3
1548782121,No Luxe Left Behind,0,0,0,0,4,4
1548802936,We Talk Back,1,1,0,0,24,26
1548809192,S2D: The Symptom to Diagnosis Podcast,0,0,0,0,2,2
1548809846,Beer on the Run Podcast,0,0,0,0,7,7
1548813183,Just Getting Started with Rich Eisen,0,0,0,0,19,19
1548814268,Counterjam,0,0,0,0,8,8
1548822885,Real World Peaceful Parenting,0,0,0,1,49,50
1548828477,WandaVision 30 Questions,0,0,0,2,5,7
1548831667,The 3 Amigos,0,0,0,0,2,2
1548914205,karmamind's podcast,0,0,0,0,36,36
1548923376,Master Your Mind With Marisa,1,0,0,0,2,3
1548946506,The Battersea Poltergeist,0,0,0,0,4,4
1548949708,The Dynasty Movement,0,0,0,0,1,1
1548997385,On The Screws Golf,0,0,0,0,1,1
1549004314,Skin and the City,1,0,0,0,36,37
1549004673,Hear to Slay,0,0,0,0,2,2
1549008737,Tech News for MBAs,0,0,0,2,14,16
1549021125,GoZen! Stories,0,0,0,0,10,10
1549026104,80s Wrestling The Podcast,0,0,0,0,3,3
1549026712,Side Piece with Melissa Pfeister,0,0,0,0,30,30
1549029999,Vox Quick Hits,0,1,1,1,4,7
1549033186,Bee-Attitudes,0,0,0,0,1,1
1549042450,Daleks Aren't Robots!?,0,0,0,0,2,2
1549045670,The Kelcey Ayer TV Show on Radio,0,0,0,0,4,4
1549051149,The Bun and Cardigan Show: A Detroit Pistons Podcast,0,3,0,0,32,35
1549058997,How It's Made Podcast,0,0,0,0,3,3
1549059898,The Morgan Harper Nichols Show,0,0,0,0,23,23
1549096697,The Well Read Poem,0,0,0,0,20,20
1549097450,Off Da Pine Podcast,0,0,0,0,4,4
1549123569,More to Life Podcast,0,0,0,0,2,2
1549128849,A Lititz Podcast,0,0,0,0,1,1
1549132201,Daily Fantasy Sports Picks & Bets: The Mix,1,0,0,0,103,104
1549136595,Ultimate Sports Mashup,0,0,0,0,1,1
1549140521,Chakras + Sex + Relationships with Eliza Boquin,0,0,0,0,11,11
1549145737,Fantasy Baseball Picks & Bets,0,0,0,0,60,60
1549178681,Good Times with Mo: The Podcast Year 10,0,0,0,0,1,1
1549179379,On the Road with Penguin Classics,0,0,0,0,2,2
1549198108,The Happy Pear Podcast,0,0,0,0,2,2
1549222388,The History Guy,0,1,0,0,4,5
1549225698,How It Happened,2,1,3,0,39,45
1549238369,KYLE and KEVIN: Did we do it?,0,0,0,0,5,5
1549249596,Lost Hills,3,5,1,2,29,40
1549249651,Living Centered Podcast,0,0,0,0,9,9
1549249879,The Chirp with Daren Millard,1,0,0,0,4,5
1549256298,Armchair Expert Mondays with Dax Shepard,0,1,0,0,3,4
1549266269,A Word … with Jason Johnson,1,0,1,1,23,26
1549272440,The Daily Punch,5,3,3,8,34,53
1549272753,The Wilkow Majority,0,0,0,0,4,4
1549273184,We Will NOT Play DnD,0,0,0,0,2,2
1549273432,Stark Wars | Star Wars and Marvel Series Recaps,0,0,0,0,24,24
1549276687,Flock Journey,0,0,1,0,1,2
1549292908,The Fit CEO Podcast with Chad Molyneux,0,0,0,0,2,2
1549302963,Your Next Favorite Movie,0,0,0,0,4,4
1549304340,FORTitude - Fort Worth Business Leaders,0,0,0,0,1,1
1549307879,The Battle Catz Podcast,0,0,0,0,7,7
1549324835,Jorgenson's Soundbox,0,0,0,0,32,32
1549326210,"First Take, Her Take",1,1,2,1,19,24
1549359065,Sound the Siren,0,0,0,0,3,3
1549359212,Check The Marc,0,0,0,0,4,4
1549365043,ATI Mometrix Teas Review : let’s pass this teas together,0,0,0,0,1,1
1549371727,Hi Nay,0,0,0,0,2,2
1549385121,Ian Wright's Everyday People,1,0,0,0,35,36
1549388085,Comedy Gold Minds with Kevin Hart,6,2,0,3,36,47
1549388085,Inside Jokes with Kevin Hart,6,2,0,3,36,47
1549388224,Narcosis: Into The Deep,0,0,0,0,2,2
1549389941,Cincinnati Zoo Tales,0,0,0,0,2,2
1549394821,Johnny B Unleashed,0,0,0,0,3,3
1549403625,Scene at Last,0,0,0,0,1,1
1549426288,ReviewPods - True Crime Podcast Reviews,0,0,0,0,2,2
1549428590,The Courtship of Mona Mae,0,0,0,0,3,3
1549457442,Just Grow It: The Podcast,0,0,0,0,7,7
1549465267,True Crime Binge,4,0,0,1,95,100
1549466181,Strange Language,0,0,0,0,1,1
1549470069,Game MISSconduct,0,0,0,0,3,3
1549478602,Knee On Belly,0,0,0,0,3,3
1549479154,The Summercast,0,0,0,0,7,7
1549483718,One Crazy Ride,0,0,0,0,4,4
1549487521,Jewel Heart Podcast,0,0,0,0,1,1
1549490720,Fore The People,1,0,0,0,18,19
1549502623,Cleanup on Aisle 45 with AG and Andrew Torrez,0,0,1,0,13,14
1549503479,The Backfield,0,0,0,0,1,1
1549508968,Hard Tackle - Football Podcast,0,0,0,0,5,5
1549518378,The College Baseball Nation Podcast,1,0,0,0,1,2
1549535213,The Am Side Podcast,0,0,0,0,1,1
1549560061,In The Weeds with Rob Law,0,0,0,0,2,2
1549562812,They Come to America,0,0,0,0,2,2
1549565484,Here For Healing,0,0,0,0,6,6
1549579649,Wokemanistan,0,0,0,0,16,16
1549580781,Behind the Veil,0,0,0,0,21,21
1549581778,Rewildology,0,0,0,0,1,1
1549584704,"Cheers, Brother!",3,2,2,4,39,50
1549589688,Your Hometown,0,0,0,0,2,2
1549590744,This Spiritual Fix,0,0,0,0,27,27
1549591186,Cardboard Fever,0,0,0,0,6,6
1549595301,Hobby Hunter,0,0,0,0,22,22
1549598078,Tennis Betting Tidbits,0,0,0,0,1,1
1549605791,LYF3,0,0,0,0,2,2
1549609168,Valley of the Suns: A Phoenix Suns Podcast,0,0,0,1,3,4
1549612258,Slab Talk,0,0,0,0,3,3
1549614918,How You Create,1,1,0,0,33,35
1549622699,Into the Shoujo-Verse,0,0,0,0,1,1
1549623127,This is Tulsi Gabbard,3,0,0,4,164,171
1549627522,The DAWG POD,0,0,0,0,5,5
1549666441,Kevin Frandsen’s Pine Tar for Breakfast,0,0,0,0,2,2
1549671911,3for30,0,0,0,0,1,1
1549673056,The India Energy Hour,0,0,0,0,1,1
1549700920,"Girl, I Guess",8,3,4,0,73,88
1549704404,The Experiment,48,10,20,12,98,188
1549706167,Buddhist Recovery Podcast,0,0,0,0,1,1
1549708960,A Little Something Extra,0,0,0,0,1,1
1549716001,Spinsters,2,1,1,1,182,187
1549717372,Public Power Underground,0,0,0,0,4,4
1549719303,Unsubscribe Podcast,0,0,0,0,50,50
1549723343,Find A Topic,0,0,0,0,6,6
1549731522,Working Title,3,0,3,1,41,48
1549731965,1st Edition Podcast,0,0,0,0,1,1
1549732645,The Mythical Menagerie,0,0,0,0,1,1
1549740252,Lisa Upside Down,0,0,0,0,1,1
1549740529,The Human Instrumentality Podcast,0,0,0,0,1,1
1549743244,Golf Cart Conversations,0,0,0,0,3,3
1549749722,Balance is Key,0,0,0,1,38,39
1549778206,Leading Steep,0,0,0,1,44,45
1549781724,This Week In Videogames,0,0,0,0,10,10
1549789559,Everyday Woodworking,0,0,1,0,0,1
1549790255,Tesseract TV: WandaVision,0,0,0,0,11,11
1549814799,Nurture vs Nurture with Dr. Wendy Mogel,8,8,0,4,142,162
1549817075,Just The Tip With Danee Bananas,2,1,0,0,6,9
1549844208,Snakey Talk,0,0,0,0,2,2
1549864072,Music For Kiddos Podcast,0,0,0,0,10,10
1549871382,What were you saying ??,0,0,0,0,1,1
1549883019,Judas and the Black Messiah Podcast,0,0,1,0,7,8
1549903604,Unsolved Mysteries,24,9,6,12,192,243
1549916401,Clever Clogs: Riddles for Kids Podcast,1,0,0,0,0,1
1549927778,Band of Mothers,1,0,0,1,30,32
1549981302,Sound Culture,0,0,0,0,6,6
1549981345,Dwellings,0,0,0,0,1,1
1549984055,Windy City Double Feature Picture Show,0,0,0,0,2,2
1550000522,SHE / THEY / GAY,0,0,0,0,1,1
1550007816,The Star Spangled Banter Podcast,0,0,0,0,2,2
1550010577,And The Best Picture Is...,0,0,0,0,3,3
1550018667,SpursLandia,0,0,1,0,11,12
1550019491,Bravo Group Chat,0,0,0,0,13,13
1550021440,Local Side of Key West,0,0,0,0,7,7
1550024934,New Species,0,0,0,0,3,3
1550031469,The Wrestfriends Podcast,0,0,0,0,1,1
1550041902,The Motherhood & Money Show,1,0,0,0,17,18
1550044944,Ebony and Irony,2,1,0,0,47,50
1550054120,Apple Tech Talk-ATT,0,0,0,0,1,1
1550058276,The Outcast,0,0,0,0,2,2
1550070783,Roblox!!,2,0,0,0,7,9
1550076112,NHT awareness.,0,0,0,0,1,1
1550086447,Skinny Dipping,0,0,0,0,50,50
1550112679,Good Words with Kirk Franklin,0,0,0,1,81,82
1550119969,Pop Music For Smart People,0,0,0,0,4,4
1550123118,Call Of The Wild,0,0,0,1,8,9
1550126795,Complete Performance Podcast,0,0,0,0,2,2
1550128844,The Broadway Hat Podcast,0,0,0,0,44,44
1550132782,Made of Stronger Stuff,0,0,0,0,13,13
1550150550,The Carnivore Yogi Podcast,0,0,0,0,13,13
1550151193,Nitty Gritty Training,0,0,0,0,3,3
1550156040,Alternative Design Podcast,0,0,0,0,2,2
1550169359,MODASUCKA with Michael Blackson,0,0,2,0,19,21
1550204549,The Big Sauce Podcast,0,0,0,0,3,3
1550213250,I Spent A Day With...,0,0,0,0,16,16
1550214443,That New Mom Life,0,0,0,0,3,3
1550227027,Keep the Heart,0,0,0,1,66,67
1550232404,Thirsty for Hallmark,0,0,0,0,3,3
1550239164,The Tree Thinking Podcast,0,0,0,0,4,4
1550299411,For The Love of Chaos,0,0,0,0,42,42
1550315187,Straight Shooters Golf Podcast,0,0,0,0,1,1
1550319265,The THRU-r Podcast,0,0,0,0,4,4
1550331348,The Office Deep Dive with Brian Baumgartner,6,4,2,6,118,136
1550331378,The Owen Jones Podcast,14,1,0,1,55,71
1550335502,Daily Discipline with Brian Kight,0,0,0,0,23,23
1550335755,Dodge Movie Podcast,0,0,0,0,3,3
1550339322,The Stretch Four: NBA Fantasy Experts,0,0,0,0,5,5
1550388942,The Project Healthy Body Podcast,0,0,0,1,38,39
1550389531,Gone-Gpn Show,0,0,0,0,1,1
1550401093,Anxious Like You,0,0,0,2,48,50
1550404706,Black Autonomy Podcast,0,0,0,0,3,3
1550406266,MilkMaids,0,0,0,0,2,2
1550407062,Jason Wilde,0,0,0,0,1,1
1550407106,Scalzo & Brust,1,0,0,0,21,22
1550408245,Wilde & Tausch,0,0,0,0,6,6
1550410215,Dr. Juan Santo Remedio,0,0,1,0,1,2
1550466922,Marvelvision,0,0,0,0,7,7
1550468942,The Next American Built Environment,0,0,0,0,3,3
1550475625,Tremendous Girl,1,1,0,0,16,18
1550478380,Brain Rot - An 80s Horror Podcast,0,0,0,0,1,1
1550478652,Granite State Gardening,0,0,0,0,2,2
1550479108,I Hate This Job,0,0,0,0,2,2
1550484247,Straight Ahead Animation Podcast,0,0,0,0,1,1
1550484856,One-Punch Fan,0,0,0,0,2,2
1550502395,The Undressing Room Podcast Presented by Macy’s,0,0,0,1,8,9
1550511220,How My Grandmother Won WWII,1,0,0,0,9,10
1550521347,Neural Networking,0,0,0,0,1,1
1550531238,The Homeschooling Journey Podcast,0,0,0,0,5,5
1550543719,The Pop Test – A comedy science quiz,2,0,0,0,6,8
1550543814,History of the MCU Podcast,0,0,0,0,9,9
1550568878,Genius Bar,0,0,0,0,11,11
1550602253,This Month in Sports,0,0,0,0,3,3
1550607818,The CX Tipping Point,0,0,0,0,2,2
1550620528,Shegone Nation Podcast,0,0,0,0,3,3
1550626556,Parenting with Ginger Hubbard,0,0,0,0,21,21
1550637746,Ministrytwear,1,0,0,0,7,8
1550640669,The Jordy Culotta Show,0,0,0,1,23,24
1550649018,The Language Neuroscience Podcast,0,0,0,0,1,1
1550650257,New York Gritty,0,0,0,0,8,8
1550650307,Ride or DIY with Liz Morrow,0,0,0,0,2,2
1550653746,Duluth News Tribune Minute,0,0,0,0,1,1
1550654681,The Find Your STRONG Podcast,0,0,0,0,7,7
1550656252,Objections: With Adam Klasfeld,0,0,1,0,11,12
1550656818,The Writers Room with Sam and Jim,0,0,0,0,7,7
1550665912,Capital Record,0,0,1,0,14,15
1550666283,Prompt Us,0,0,0,0,2,2
1550673485,The Training With Tucker Podcast,0,0,0,0,6,6
1550688418,Collapse,0,0,0,0,16,16
1550690099,Dirty Detectives,0,0,0,0,9,9
1550694528,RHAP Rewind,0,0,0,0,1,1
1550695064,Radical Musings with Rosanna Arquette,1,1,0,0,10,12
1550695887,Just Another Excuse,0,0,0,0,3,3
1550706492,Why Wait Till Sunday,0,0,0,0,2,2
1550709357,Chrisman Commentary - Daily Mortgage News,0,0,0,0,4,4
1550709885,Japanese with Shun,0,0,0,0,1,1
1550711873,It's Nice to Hear You,0,0,0,0,8,8
1550720527,Nuts & Bolts Rc Podcast,0,0,0,0,2,2
1550722014,Curious Questions with Ricky Williams Podcast,0,0,0,0,39,39
1550764907,"Grow, cook, eat, arrange with Sarah Raven & Arthur Parkinson",0,0,0,1,18,19
1550780030,China Stories,0,0,0,0,4,4
1550781253,Team Blaney Podcast,0,0,0,0,1,1
1550799341,To Be Honest,1,0,0,0,7,8
1550799858,MC! True Long Island Story,1,0,0,0,98,99
1550802656,Bolling with Favre,1,2,1,1,60,65
1550812348,Extreme Conversations w/ Brian Myers,0,0,0,0,26,26
1550826031,Channel Your Enthusiasm,0,0,0,0,4,4
1550828505,Emergency 9 Golf,0,0,0,0,7,7
1550832941,The #ANGELS Podcast,0,0,0,0,8,8
1550836069,STANDBY with JJ and Francisco,0,0,0,0,1,1
1550842131,BIG FACTS,0,0,0,0,2,2
1550843569,SYGNYL,0,0,0,0,50,50
1550845137,CMQ Investing Presents: Compound Money Quietly,0,0,0,0,9,9
1550850047,Muppeturgy: A Muppet Show Rewatch Podcast,0,0,0,0,3,3
1550853204,The Fernando Espuelas Show,0,0,0,0,4,4
1550859179,The HorrorBabble Podcast,0,0,0,0,5,5
1550859300,Flora Funga Podcast,0,0,0,0,2,2
1550859518,Trash Pandas Podcast Network,0,0,0,0,4,4
1550864262,Ask Dr. Julie Hanks,0,0,0,1,49,50
1550868229,Think About It with Victoria Azarenka,0,0,0,0,6,6
1550874620,Behind Every Dream,0,0,0,0,2,2
1550883345,PRETTYSMART,0,0,0,0,50,50
1550884342,The LoPriore Podcast,1,0,0,0,39,40
1550885150,Heterodox Out Loud,0,0,0,0,5,5
1550892467,Investing in Stocks & Crypto for Beginners,0,0,0,0,5,5
1550894249,Adventure Flying,0,0,0,0,2,2
1550897283,Trading Table - Dynasty Fantasy Football,0,0,0,0,1,1
1550932167,StribSports Daily Delivery,0,0,0,0,5,5
1550944310,Drift Off - Bedtime Stories for Sleep,0,0,0,0,3,3
1550977054,Above Par,0,0,0,0,13,13
1550987094,Green Acres Garden Podcast with Farmer Fred,0,0,0,0,3,3
1550998864,Alan Carr's 'Life's a Beach',1,0,1,2,84,88
1551000109,The Naruto Virgin,1,0,0,0,3,4
1551009162,THE DOG HOUSE with Adam & Jimmy,0,0,0,0,6,6
1551010195,Reality With Vicki,1,0,1,1,13,16
1551010519,Straight Forward Farming,0,0,0,1,13,14
1551013809,Whitehot Magazine: Art World with Noah Becker,0,0,0,0,1,1
1551014616,Harvard Torah,0,0,0,0,1,1
1551020757,The Dogist: Talking Dogs,0,0,1,0,54,55
1551039598,Opening Act,0,0,0,0,5,5
1551046426,Meet Star Gazers,0,0,0,0,1,1
1551058346,More Than Tracy Turnblad,0,0,0,0,7,7
1551060420,Passion For Collecting,0,0,0,0,5,5
1551063056,Organic Sexuality,0,0,0,0,11,11
1551063783,The Combat Corner,0,0,0,0,1,1
1551064493,Nat Wonderful,0,0,0,0,1,1
1551070045,Pillows and Beer,22,11,25,17,182,257
1551120994,Duchess,0,0,0,0,14,14
1551160076,The Panic Years,0,0,0,0,9,9
1551162705,The Opportunist,0,6,0,9,249,264
1551175509,Rainbow Bridge Connection- Pet loss support,0,0,0,0,3,3
1551176080,The Truth As I Know It,0,0,0,0,2,2
1551181322,Spectacle: An Unscripted History of Reality TV,3,1,4,0,30,38
1551187336,Peering Into The Narrow Room :Expanding the Spirit & Mind,0,0,0,0,9,9
1551193572,In the Holding Room,0,0,0,0,1,1
1551199886,Behind The Investigation Podcast,0,0,0,0,2,2
1551206847,#SistersInLaw,1,0,0,1,48,50
1551208110,Wedded: The Wedding Planner Podcast,0,0,0,0,28,28
1551232009,Dwell,0,0,0,0,2,2
1551238663,Tough on Art,0,0,0,0,1,1
1551241240,Marv Runs Far,0,0,0,0,2,2
1551245138,Big & Hungry,3,1,0,0,46,50
1551247626,Crushing Miles Daily,0,0,0,0,2,2
1551251928,The Artist and The Athlete with Lindsay Czarniak,0,0,0,0,9,9
1551287681,Audio Diary Of A Wimpy Kid,0,0,0,0,1,1
1551365571,The Colin Cowherd Podcast,3,1,1,3,50,58
1551374761,Pricing Nature,0,0,0,0,9,9
1551376748,Life in the Rough,0,0,0,0,1,1
1551379315,Our Birth Wisdom,0,0,0,0,7,7
1551381000,If/Then,0,0,1,1,30,32
1551384843,Morning Bru with Jaffe & Razor,0,0,0,0,12,12
1551396643,Clout101 - The Marketing Strategy Podcast,0,0,0,0,11,11
1551398819,Comeback Stories,0,0,0,0,47,47
1551404246,So What!? - A Come Follow Me Resource for LDS Youth,0,0,0,0,2,2
1551411428,The Love Fix,0,0,0,0,10,10
1551427513,Popping Corks w/ Winemaker Eric Jensen,0,0,0,0,1,1
1551432450,WGBD: When God is Black and Disabled,0,0,0,0,1,1
1551438879,Novafleet 86,0,0,0,0,1,1
1551439261,The Terminally Unique Podcast,0,0,0,0,2,2
1551443880,THE DAVID MCKAY-L8-NIGHT SPECIAL,0,0,0,0,2,2
1551459171,Honey I’m Home,0,0,0,0,11,11
1551489479,Chuckle Sandwich,1,0,0,1,48,50
1551494225,Not Your Average Globetrotter,0,0,0,0,4,4
1551495645,CMP Podcasts,0,0,0,0,2,2
1551497364,Running Realized,0,0,0,0,22,22
1551497433,The Pilot Base,0,0,0,0,7,7
1551499379,Your Dose of Death,0,0,0,0,2,2
1551515894,Are We Really Brothers,0,0,0,0,24,24
1551516071,Now and Then,0,0,0,0,1,1
1551527873,Free The Girls,1,0,0,1,23,25
1551540661,Joint Resolution with Joe Cunningham,0,0,0,1,27,28
1551541889,The National Pulse,0,0,0,1,49,50
1551546147,Is MMT Real? (A Current Affairs Production),0,0,0,0,2,2
1551548911,That Anime Podcast - For Casual Anime Fanatics,0,0,0,0,1,1
1551550585,K&G Radio,0,0,0,0,6,6
1551550842,Sailor Manga,0,0,0,0,1,1
1551560305,The Immersive Design Podcast,0,0,0,0,1,1
1551567962,TRUE,0,0,0,0,37,37
1551570777,a16z Live,0,0,0,0,1,1
1551571966,Travel Light with Chase Reeves,0,0,0,1,30,31
1551572614,GetReal!,0,0,0,0,7,7
1551573605,The Simple Garden Life,0,0,0,0,2,2
1551576680,On The Wire,0,0,0,0,3,3
1551579084,Baking A Murder,0,0,1,0,49,50
1551581358,Wilderness Warrior Podcast,0,0,0,0,5,5
1551581590,Eight Threads: Unraveled,0,0,0,0,1,1
1551581725,Tucson Heat,0,0,0,0,3,3
1551582052,The Lincoln Project,4,0,0,2,44,50
1551585024,Companions of the Compendium,0,0,0,1,1,2
1551587862,Blunt Talk with Gabriel Zamora,0,1,1,2,59,63
1551591610,All About Her | HerFitBod,0,0,0,0,4,4
1551594844,Pyramid Wrestling,0,0,0,0,5,5
1551595769,The Influential Nonprofit,0,0,0,0,1,1
1551610006,FantasyPros Dynasty Football Podcast,1,0,2,1,125,129
1551631124,The Sand Trap,0,0,0,0,1,1
1551642766,The Game Chat Sports Podcast,0,0,0,0,2,2
1551644089,The Food That Built America,2,4,8,2,44,60
1551653850,The Horse Fix,0,0,0,0,2,2
1551689428,There's Always a Ladder,0,0,0,0,5,5
1551693625,Ke Muela :V,0,0,0,0,3,3
1551695402,Travolting,0,0,0,0,2,2
1551696865,Macrodosing: Arian Foster and PFT Commenter,6,1,9,1,465,482
1551699251,Best Picture This,0,0,0,0,6,6
1551728960,Weighing In with David Mirikitani,0,0,0,0,1,1
1551740256,Bet the Best,0,0,0,0,4,4
1551740635,The Anime Virgin,0,0,0,1,4,5
1551743543,The Real HopeCast,0,0,0,0,4,4
1551751861,Track and Field Black History,0,0,0,0,2,2
1551752264,The Midheaven Podcast,0,0,0,0,3,3
1551754362,Rifles Only Accuracy Podcast,1,0,0,0,1,2
1551760175,Chris Distefano Presents: Chrissy Chaos,3,1,2,1,43,50
1551765452,3 Peas In A WOD,0,0,0,0,4,4
1551815590,The POPCast: A Patterns of Power Podcast,0,0,0,0,1,1
1551820452,Bridgerton: The Official Podcast,2,0,0,0,8,10
1551822928,Unified,0,0,1,0,27,28
1551825415,Eye of the Duck,0,0,0,0,2,2
1551827752,Third Degree,4,0,1,2,43,50
1551830599,CoolBusCast,0,0,0,0,7,7
1551832256,Teaching Meditation,0,0,0,0,1,1
1551835312,Dirty Air: A NASCAR DFS Podcast,0,0,0,0,1,1
1551839677,The Austin Approach,0,0,0,0,1,1
1551844065,Dugout Study Hall,0,0,0,0,1,1
1551855032,The Pat Tomasulo Podcast,0,0,0,1,25,26
1551857514,Kingdom Builders,0,0,0,0,4,4
1551862919,The Aaron Abke Podcast,0,0,0,0,4,4
1551866118,The Ice Guys,0,0,0,0,1,1
1551866554,Cup of Joe,0,0,0,0,6,6
1551868584,Fck Bogeys,0,0,0,0,3,3
1551871792,“Fishing After Dark” W/ The Beard & The Badge,0,0,0,0,6,6
1551880024,Choose You Now,0,0,0,0,19,19
1551885984,Keep or Kut,0,0,0,0,2,2
1551886278,Blueberries Hill,0,0,0,0,1,1
1551899680,For the Love of Nature,0,0,0,0,5,5
1551910973,The Center Collaborative: Creative Solutions in Behavioral Health and Criminal Justice,0,0,0,0,2,2
1551941149,Three Hillbillies on a Couch,0,0,0,0,1,1
1551984673,The Jab from Economist Radio,1,0,0,1,9,11
1552000243,RFK Jr The Defender Podcast,1,0,0,1,28,30
1552002159,Empowered Business,0,0,1,1,48,50
1552005275,Reef Beef,0,0,0,0,4,4
1552006904,"Hecha de Estrellas Podcast, con Alejandra Freile",0,0,0,0,3,3
1552012154,Teach Me A Lesson with Greg James and Bella Mackie,1,1,1,1,44,48
1552017580,Stacking Pennies with Corey LaJoie,0,1,2,1,24,28
1552017731,Level Up with Debbie Neal,0,0,0,0,32,32
1552021191,Locked On Wildcats - Daily Podcast On Arizona Wildcats Football & Basketball,0,0,0,0,5,5
1552027709,Sideways,0,0,4,0,4,8
1552031080,Peace In A Podcast,0,0,0,0,2,2
1552041386,The DR & the DJ,0,0,0,0,8,8
1552046129,Inflection Point,0,0,0,0,1,1
1552046733,Command The Zone,0,0,0,0,1,1
1552052711,Where Do You RunWell? Podcast,0,0,0,0,1,1
1552058389,This is Paris,10,5,0,10,410,435
1552059571,Mapping Out Eth 2.0,0,0,0,0,2,2
1552059697,The Ayaan Hirsi Ali Podcast,0,0,1,0,33,34
1552063406,Finding the Joys in the Journey,0,0,0,0,1,1
1552064903,Expected Points,0,0,0,0,3,3
1552065596,Deeply Human,0,0,0,0,25,25
1552069504,Astray,0,0,0,0,32,32
1552070127,Two Washups One Pro,0,0,0,0,9,9
1552072013,For All Mankind: The Official Podcast,1,0,0,0,10,11
1552085751,Runners Shuffled Podcast,0,0,0,0,1,1
1552095743,The Reroute by Good Humans Only,0,0,0,0,50,50
1552112392,Owning the Wait,0,0,0,0,37,37
1552114360,The Cross Connection with Tiffany Cross,0,0,0,0,10,10
1552124254,Velshi,0,0,0,0,18,18
1552124395,The Sunday Show with Jonathan Capehart,0,0,0,0,1,1
1552127203,PDA Parents,0,0,0,0,6,6
1552128937,Business & Beyond with Gerry Dick,0,0,0,0,6,6
1552141949,Everything is We,0,0,0,0,26,26
1552158625,Ball Gag,0,0,0,0,1,1
1552219290,Things You Don't Need to Know with Ari Cagan,0,0,0,0,30,30
1552221520,Inside The Vault with Ash Cash,0,0,0,0,16,16
1552229831,The Rockstar Show by Nicky Jam 🤟,0,0,0,0,3,3
1552230873,Space to Grow,0,0,0,0,1,1
1552263328,Rootsland,0,0,0,0,5,5
1552268469,The Story Nook,0,0,0,1,2,3
1552268811,Tracking the Storm,0,0,0,0,2,2
1552273027,The Cait Crowell Podcast,0,0,0,0,1,1
1552277644,The Gumbo Show,0,0,0,0,2,2
1552278175,"BloodBath w/ Annie, & Esther, & Khalyla",4,2,4,2,169,181
1552279821,"Unconditional Love Stories: Pet Parenting Inspiration | Dog Training, Nutrition, Tips & Tricks",0,0,0,0,4,4
1552285929,Becoming A Stress-Free Nurse Practitioner,0,0,0,1,49,50
1552286967,A Kids Book About: The Podcast,0,0,0,0,6,6
1552304882,The Horse People Podcast,0,0,0,0,1,1
1552309889,The Daily Aus,0,0,0,0,4,4
1552315835,OB POD,0,0,0,0,6,6
1552320625,Casually Uncomfortable,0,0,0,0,1,1
1552322984,Meaning Full Living,4,0,0,0,24,28
1552330837,OMG Hi! with George Lopez Podcast,2,0,0,0,12,14
1552331477,The Card Foundation Podcast,0,0,0,0,22,22
1552337915,Toxic Masculinity,0,0,0,0,2,2
1552371390,Charlando Tranquilamente,0,0,0,0,1,1
1552412331,Frost on Flowers,0,0,0,0,3,3
1552454666,Live Beautifully with Katrina Scott,0,1,0,1,198,200
1552454815,The River Certified Podcast,0,0,0,0,5,5
1552464409,Strange by Nature Podcast,0,0,0,0,6,6
1552467488,Return of the Pod: A Podcast About Star Wars,1,0,1,1,87,90
1552469206,Baka Banter Anime Podcast,0,0,0,0,18,18
1552470720,Guilty Pleasures,5,1,6,1,37,50
1552471058,Field & Garden,0,0,0,0,19,19
1552478032,Uncircumcised: Raw and Uncut,0,0,0,0,3,3
1552487207,My Darling Diary,1,0,1,0,31,33
1552493257,Insurance Agents Think Tank,0,0,0,0,2,2
1552499283,DFORundown's podcast,0,0,1,0,0,1
1552505169,Dead Zone Drive-In,0,0,0,0,8,8
1552509839,Walking Distance: Where Love for Neighbor and Neighborhood Meet Podcast,0,0,0,0,7,7
1552525144,Mangasplaining,0,0,0,0,3,3
1552532151,Pitcher's Duel Podcast,0,0,0,0,1,1
1552549384,The Language of Love,1,0,0,0,12,13
1552573627,The Social Media Mindset,0,0,0,0,6,6
1552575253,FAQ PODCAST,0,0,0,0,3,3
1552584748,The Falcon and the Winter Soldier Podcast by Phantastic Geek,0,0,0,0,9,9
1552587575,"""DOPE AS USUAL""",0,0,0,2,48,50
1552589375,The Shuli Show,0,2,0,2,46,50
1552612086,Keeping Up Appearances: The Luxury Podcast,0,0,0,0,1,1
1552618916,Sound Thoughts on Art,0,0,0,0,2,2
1552627136,The Business Journey Podcast,0,0,0,0,38,38
1552628415,Tomo Podcast,0,0,0,0,2,2
1552634215,SAUCED,0,0,0,0,1,1
1552642610,Terroir-Driven: The Waterford Whisky Podcast,0,0,0,0,3,3
1552646946,The Cast Die Podcast,0,0,0,0,6,6
1552657219,Not My Type,0,0,0,0,8,8
1552658085,Nerdabunga,0,0,0,0,7,7
1552660770,"Gacha Wolfe 3,000",0,0,0,0,1,1
1552665610,Juice Wrld,0,0,0,0,1,1
1552706362,talk to Cassius,0,0,0,0,2,2
1552711399,Almost Unbelievable Paranormal Podcast,0,0,0,0,1,1
1552711539,Kids Stories - The Boy & The Elf,0,0,0,1,0,1
1552713735,Key Battles of American History,0,1,0,0,24,25
1552721730,Coma Girl,0,0,0,0,15,15
1552723414,Evan's Brooklyn Basketball Podcast,0,0,0,0,2,2
1552728691,Bring a Trailer Podcast,0,0,0,2,6,8
1552732290,Not to Cut You Off,0,0,0,0,2,2
1552757386,AB Wellness Podcast,0,0,0,0,2,2
1552762727,Off Track,0,0,0,0,1,1
1552764356,America Recovers,0,0,0,0,8,8
1552766695,Community Building,0,0,1,0,7,8
1552766768,The Wrestling RHAP-up,0,0,0,0,2,2
1552770367,Ladies KAR Care Talk Show,0,0,0,0,4,4
1552787429,The OjiFanboys,0,0,0,0,2,2
1552793751,The Customer Engagement Lab,0,0,0,0,5,5
1552802920,Selling The Mountains,0,0,0,0,2,2
1552823545,Tips for raising Chicks,0,0,0,0,1,1
1552832916,The Plugged Lie,0,0,0,0,3,3
1552857571,Applied Mycology,0,0,0,0,1,1
1552891472,For Better and Worse | With Jess and Rach,0,0,1,0,20,21
1552899817,The Steve Sommers Overnight Drive,0,0,0,0,3,3
1552917994,The Sweet Spot - Golf Podcast,1,0,0,0,27,28
1552923641,Black Cowboys,1,0,1,0,28,30
1552923865,The Butterfly Forecast,0,0,0,0,12,12
1552926704,The Hezi,0,0,0,0,5,5
1552926820,"Sorry, I'm Sad",0,0,0,0,3,3
1552934059,Danger Close,0,0,0,0,9,9
1552942976,Money Confidential,0,0,0,0,26,26
1552949773,Wolf it Down Weekly - Tyler Florence Podcast,0,0,0,0,3,3
1552953528,Talk Louder,0,0,0,0,1,1
1552954856,The Pod Has Been Cast,0,0,0,0,10,10
1552965863,On The Frontlines,0,0,0,0,7,7
1552975779,Skincare School,0,0,2,0,30,32
1552979125,The Nature Dilemma,0,0,0,0,20,20
1552980232,HairB&B,0,0,0,0,12,12
1552982798,My Gay Playlist,0,0,0,0,3,3
1552988832,Pure American Podcast,0,0,0,0,4,4
1552989630,BOLTED,0,0,0,0,9,9
1552990311,Sasquatch Odyssey,0,0,0,0,4,4
1552993207,Open Ice Hits: An NHL Podcast,0,0,0,0,9,9
1553006733,The Quick Hit,0,0,0,0,1,1
1553013103,Ghost Party Radio,0,0,0,0,10,10
1553013670,Sit Down & STFU,0,0,0,0,3,3
1553016332,White House Press Briefings,0,0,1,0,1,2
1553016371,The Same! Podcast,0,0,0,0,3,3
1553035026,The Weird Gig Podcast,0,0,0,0,3,3
1553035270,Can I go home now? with John Kennedy,0,0,0,0,5,5
1553047028,Dynasty x Design,0,0,0,0,5,5
1553065577,Straight People Movies,0,0,0,0,5,5
1553086830,Raised Right,0,0,0,0,4,4
1553089886,La Brega,0,0,2,2,34,38
1553091721,Ceremony Circle,0,0,0,1,36,37
1553091779,THE ROCKSTAR SHOW,0,0,0,0,1,1
1553101582,Sin Rodeo con Jomari Goyso,0,0,0,0,7,7
1553105481,Storybrooke Circus: A Once Upon A Time Podcast,0,0,0,0,2,2
1553105854,The Working Genius Podcast with Patrick Lencioni,0,0,0,0,3,3
1553112247,High School Sucked,0,0,0,0,1,1
1553118840,More Than That with Gia Peppers,0,0,0,0,2,2
1553119130,Pretty For A Black Girl,0,0,0,0,4,4
1553120534,Enter The Knight,0,0,0,0,2,2
1553124251,Unwanted,2,2,3,1,42,50
1553141280,Riches in the Niches Investor Podcast,0,0,0,0,2,2
1553143241,The Anthony Sarandrea Show,0,0,0,0,32,32
1553152885,Raising Kale,0,0,0,0,2,2
1553169308,The Green Mind,0,0,0,0,1,1
1553179628,Ask the Vet,0,0,0,0,1,1
1553184153,Barrier Breakers,0,0,0,0,3,3
1553187470,"Move better, feel great with Ace Morgan",0,0,0,0,3,3
1553197072,Flight Following,0,0,0,0,1,1
1553199104,Two Hot Takes,0,0,1,3,27,31
1553199328,"Stars, Stripes, and Sanatanis: Young Hindu Voices of America",0,0,0,0,1,1
1553200510,eaJ x keshi - pillows,0,0,0,0,1,1
1553216944,Stefanie and Joan's Beauty Bar,0,0,0,0,59,59
1553218626,Girls Bedroom,1,0,0,0,4,5
1553268981,THE SANDBAGGERS,0,1,0,0,9,10
1553278091,SOAR Long Form,0,0,0,0,1,1
1553280643,Happiness Is with Bruce Aitchison,0,0,0,0,1,1
1553282727,Quick Single,0,0,0,0,1,1
1553283750,Therapy 4 Teens,0,0,1,0,33,34
1553300749,Well Suited,0,0,0,0,5,5
1553314202,"Royally Us - Harry, Meghan, Kate and William Royal News and Discussion",0,1,0,0,1,2
1553323633,Making It To The Mic,0,0,0,0,6,6
1553329585,Ready For It...A Taylor Swift Podcast,0,0,0,0,1,1
1553334816,A Little Bit Culty,4,0,1,2,83,90
1553335461,Against The Odds,30,6,6,6,480,528
1553337816,Fit Over 50 Life,0,1,0,0,6,7
1553340487,Scandalous Diamonds,0,0,0,0,9,9
1553344468,Good Sex,1,0,2,4,16,23
1553344692,Car CULTure,0,0,0,0,5,5
1553345193,The Al Galdi Podcast,0,0,1,4,170,175
1553368852,Lipsey's AIM HIGHER Podcast,0,0,0,0,2,2
1553369318,What You're Craving,0,0,0,0,11,11
1553377190,Serendipity With Inky Johnson,0,0,0,0,30,30
1553380832,Real America - La Vera America Senza Filtri,0,0,0,0,5,5
1553382555,Knead to Know,0,0,0,0,9,9
1553385416,BECOMING:us with Moriah & Joel Smallbone VIDEO,0,0,0,0,7,7
1553385816,BECOMING:us with Moriah & Joel Smallbone,0,0,0,0,63,63
1553386057,RNZ: Fragments,0,0,0,0,3,3
1553389010,The Homies Podcast,0,0,0,0,2,2
1553397067,We Go There Podcast,0,0,0,0,6,6
1553400216,The Ben Ryan Podcast,0,0,0,1,2,3
1553409426,Scratchquest: Golf Better,0,0,0,0,2,2
1553412134,The Schwabcast,0,0,0,0,3,3
1553412228,The Birds & Bees,0,0,0,0,12,12
1553413866,Left Reckoning,0,0,0,0,5,5
1553419148,Listen Sis.,0,0,1,1,28,30
1553423837,RNZ: NZ Wars: Stories of Tainui,0,0,0,0,5,5
1553469363,Fit For Life with Anjuli,0,0,0,0,3,3
1553480628,The Doc Talk- Baseball Doctor,0,0,0,0,1,1
1553493515,Creepscast,0,0,0,0,13,13
1553494094,The CISO Stories Podcast,0,0,0,0,2,2
1553497646,Creative Energy,0,0,0,0,3,3
1553499566,Views from the Edge,0,0,0,1,8,9
1553506699,Prevail with Greg Olear,0,0,0,1,21,22
1553512740,The Ryan Pineda Show,0,0,0,0,100,100
1553522975,Marc & Heidi - The Other D’Amelios,6,0,0,1,28,35
1553523860,Lincoln: Divided We Stand,0,0,0,0,1,1
1553526334,Muddy Boots Podcast,0,0,0,0,2,2
1553534946,Chicks University,0,0,0,0,3,3
1553536375,The Strands That Bind Us,0,0,0,0,2,2
1553536989,Fantasy Formula,0,0,0,0,1,1
1553542793,The Followers: House of Prayer,0,1,1,1,2,5
1553553004,Mostly Horror Movie Night,0,0,0,0,2,2
1553556384,The Thatcher Effect,0,0,0,0,1,1
1553564076,OVERCOME with Michaela,0,0,0,0,1,1
1553567709,KWEB — Weaving Earth Radio,0,0,0,0,3,3
1553572514,The Days for Girls Podcast,0,0,0,1,41,42
1553589951,The Design Diaries,0,0,0,0,8,8
1553592067,Water Pokemon,0,0,1,0,0,1
1553612805,Holy City Sinner Radio,0,0,0,0,6,6
1553613061,The Seed Pod,0,0,0,0,3,3
1553616957,Ecology & Me,0,0,0,0,3,3
1553621771,The Larry Kudlow Show,0,0,0,0,7,7
1553624471,The Bag Ladies Show,0,0,0,1,18,19
1553635942,Tom Morello’s Maximum Firepower,0,0,1,0,1,2
1553645812,The Chazz Palminteri Show,0,0,0,0,4,4
1553646523,Stoke The Fire,0,0,0,0,1,1
1553650436,Creativamente Libre con Frances Machuca,0,0,0,0,18,18
1553651089,Woodmother’s Workshop,0,0,0,0,4,4
1553661018,Interesting Lives of Normal People,0,0,0,0,1,1
1553676493,Making Marriage Cool Again,0,0,0,0,6,6
1553680628,Let's Talk About Snacks,0,0,0,0,10,10
1553689996,Integrative Nurse Coaches in ACTION!,0,0,0,0,3,3
1553695333,SweeTalks,0,0,0,0,37,37
1553695927,The Dr. John Berardi Show,0,0,1,2,47,50
1553696353,The Painfully Honest Podcast with Jason T. Lewis,0,0,0,0,2,2
1553698146,Shut The Funk Up Podcast,0,0,0,0,5,5
1553698479,Return to EverQuest,0,0,0,0,11,11
1553698633,On The Corner Podcast,0,0,0,0,2,2
1553700065,All Up In Your Business,0,0,0,0,1,1
1553704669,Fertile Me Radio,0,0,0,0,11,11
1553707988,The Sean & Sax Show,3,0,0,1,112,116
1553716205,PBTR - AMPLIFYING ADOPTION ISSUES,1,0,0,0,3,4
1553718256,That's Enough Already with Urzila Carlson,0,0,0,0,2,2
1553766752,Kids Trivia with Cayden,0,0,0,0,1,1
1553782780,Motherhood Meets Medicine,4,0,0,2,24,30
1553787111,TV GAYD,0,0,0,0,8,8
1553789921,Pypeline ACC Podcast,0,0,0,0,3,3
1553790495,Hollywood and Byrne,0,0,0,0,4,4
1553793022,The Simplified Podcast with Emily Ley,0,0,0,4,170,174
1553797333,The Butcher Shop,0,0,0,0,6,6
1553799632,Packaging Podcast,0,0,0,0,1,1
1553801095,Keep The Weight Off,0,0,0,0,1,1
1553814158,Pawsitively Dog-Powered,0,0,0,0,3,3
1553822984,The Homecare Bosses Podcast,0,0,0,0,9,9
1553836476,Rainbow Rewatch,0,0,0,0,13,13
1553840908,Shadow Banned Podcast,0,0,0,0,1,1
1553847709,NONSENSEOLOGY,0,0,0,0,4,4
1553848462,Fantasy Scouts Podcast,0,0,0,0,7,7
1553848978,Cinema Stories,0,0,0,0,2,2
1553858670,Something To Talk About with Samantha Armytage,0,0,0,0,13,13
1553858809,Garden Talk with Mr. Grow It,0,0,0,0,6,6
1553863567,No Limits Podcast,0,0,0,0,4,4
1553866605,The Chris Terrell Podcast,0,0,0,0,5,5
1553922436,Songs Out Loud,0,0,0,0,1,1
1553925815,Ruff Around The Edges,0,0,0,0,1,1
1553925876,The Esthetician’s Lounge,0,0,0,0,1,1
1553926854,Markets in Focus,0,0,0,0,2,2
1553948947,TE LO DIJO EL CHOMBO,0,0,0,0,1,1
1553960915,Counterbalance,0,0,0,0,10,10
1553969435,Tagline,0,0,0,0,3,3
1553969557,Don't Tell My Mother! with Nikki Levy,0,0,0,0,10,10
1553971950,Pops on Hops,0,0,0,0,1,1
1553973947,American Metamorphosis,0,0,0,0,9,9
1553989290,The Rockstar Superhero Podcast,0,0,0,0,1,1
1553998640,Momtini Talks,0,0,0,0,5,5
1553999385,The Across the Pond Show,0,0,0,0,5,5
1554002701,Sisters By Chance Podcast,0,0,0,0,39,39
1554013364,Trend Lightly,0,2,1,0,13,16
1554014333,Josh and Cassie Yell About Movies!,0,0,0,0,1,1
1554018451,Little stories by tiny people,1,0,0,0,0,1
1554018574,Seemingly Unknown Podcast,0,0,0,0,2,2
1554028460,Nava Cast,0,0,0,0,3,3
1554097435,The Bitboy Crypto Podcast,0,0,0,0,3,3
1554104635,No Dumb Answers with Mark & Brad,1,1,0,0,23,25
1554108046,Allen v. Farrow Podcast,4,0,4,8,36,52
1554109618,Big Money Energy,2,1,1,0,7,11
1554118718,Down in the Dugout,0,0,0,0,3,3
1554118799,Open Deeply Podcast,0,0,0,0,1,1
1554132477,In Plain Sight: Lady Bird Johnson,4,0,0,0,80,84
1554147193,Intentional Creative Podcast,0,0,0,0,1,1
1554153992,Stephen A's World,0,1,0,0,3,4
1554160791,Psychic Scoop with Spirit Sis,0,0,0,0,7,7
1554162563,Bond and Banter,0,0,0,0,1,1
1554169167,Powered By Audio,0,0,0,0,12,12
1554178457,The Interview with Hugh Hewitt,0,0,0,0,4,4
1554195886,Finding Mr. Height: The Podcast,0,0,0,1,29,30
1554197992,Just to Be Nominated: An Award Season Murder Mystery,0,0,0,0,7,7
1554200762,Ryann The Sagittarius,0,0,0,0,1,1
1554200792,Solutions with Mason Hargrave,0,0,0,0,1,1
1554202141,Passion for Dance,0,0,0,0,16,16
1554203807,The Rhythm Of Life,0,0,0,0,4,4
1554223612,The Bridgerton Bros,0,0,0,0,4,4
1554226651,GIRLS TO THE FRONT,0,0,0,0,13,13
1554228965,One Sweet Dream,0,0,0,0,4,4
1554303957,On The Farm Podcast,0,0,0,0,1,1
1554308618,I've Got Wanda Vision: A WandaVision Podcast,0,1,0,0,32,33
1554310965,Bandscamps,0,0,0,0,1,1
1554311382,Three Putt Par Podcast,0,0,0,0,1,1
1554312149,Down Memory Lane w/Mark Rosen,0,0,0,0,2,2
1554319539,Sew & So...,0,0,0,0,1,1
1554324714,Skin Tings,0,0,0,0,7,7
1554338077,The Edge Of Excellence Podcast,0,0,0,0,20,20
1554344962,Kid Contractor Podcast with Caleb Auman,0,0,0,0,20,20
1554353545,Fret Not,0,0,0,0,5,5
1554357300,MOB RADIO,0,0,0,0,51,51
1554357944,Mojo For Musicians,0,0,0,1,45,46
1554359700,The Tyson Durfey Show,0,0,0,0,16,16
1554363085,Brooklyn Art Library - Podcast,0,0,0,0,2,2
1554363724,For All Mankind (from TeeVee),0,0,0,0,2,2
1554384644,Daily Report,0,0,0,0,2,2
1554387610,UpOnly with Cobie & Ledger,0,0,0,0,35,35
1554394541,The Unholy Three,0,0,0,0,4,4
1554481644,The Austin Daily Drop,0,0,0,0,3,3
1554499736,Joyful Microbe,0,0,0,0,6,6
1554508774,The Scott Mansell Podcast,0,0,0,0,3,3
1554514290,I Love A Lifetime Movie,0,0,0,0,36,36
1554531240,The Rosary with Bishop Robert Barron,0,0,0,0,7,7
1554535518,"The CRUX, True Survival Stories",0,0,0,0,5,5
1554535631,Odessa,0,3,0,0,9,12
1554553411,615 Guys,0,0,0,0,1,1
1554555142,The Reinvention Project with Jim Rome,0,0,0,1,28,29
1554560086,Second Star to the Left,0,0,0,0,4,4
1554562101,Supported Sobriety,0,0,0,0,11,11
1554564173,The Real Question,0,1,0,0,47,48
1554565521,Domenick’s Den,0,0,0,0,8,8
1554567831,The Man and the MITH,0,0,0,0,57,57
1554572286,The Resleevables,0,0,0,0,5,5
1554578197,Unexplainable,3,2,2,0,23,30
1554578738,The Gear Patrol Podcast,0,0,0,0,5,5
1554595141,Hidden Gems: A Board Game Podcast,0,0,0,0,9,9
1554596221,DoubleTake with Yaqeen Institute,0,0,0,0,1,1
1554598354,Slumber Party Podcast,1,0,0,0,18,19
1554600150,FuturElitez Podcast,0,0,0,0,8,8
1554657285,Wild for Scotland,0,0,0,0,6,6
1554661983,Curl Up with a Cat Tale with Gwen Cooper,0,0,0,0,25,25
1554668538,Ode To Black Love,0,0,0,1,3,4
1554674261,In The Moment Pod,0,0,0,0,3,3
1554679318,Beyond The Big Bang,0,0,0,0,1,1
1554679929,The LexG Movie Podcast,0,0,0,1,38,39
1554684942,Don't Call Us Pretty,0,0,0,0,11,11
1554702705,The Roses That Be,0,0,0,0,13,13
1554703915,Master Thy Self - Vibration Meditation,0,0,0,0,1,1
1554710088,Weird Science Manga Podcast,0,0,0,0,4,4
1554712728,Eros to the Heart,0,0,0,0,2,2
1554716458,Kill James Bond!,0,0,0,0,7,7
1554743444,Fantasy Baseball Today in 5,1,0,0,0,13,14
1554745034,Life On Course,0,0,0,0,1,1
1554753102,Golf Fanatics Podcast,0,0,1,0,0,1
1554758745,Ravens Roost Radio,0,0,0,0,3,3
1554763239,Again From The Top,0,0,0,0,1,1
1554774751,Bravo Over Boys,1,0,0,2,19,22
1554782191,Fast Pace with Josh Phegan and Dean Mackie,0,0,0,0,14,14
1554785046,The Sunday Scaries with prettyrealcool,0,0,0,0,1,1
1554788421,Homeroom: A HSMTMTS Podcast,0,0,0,1,0,1
1554788504,Secrets in Nature,0,0,0,0,4,4
1554791194,F This Farm - A beginning farmer's saga,0,0,0,0,3,3
1554791701,Silent Run,0,0,0,0,7,7
1554794204,That's Nifty,0,0,0,0,2,2
1554795239,Baby Name Envy - UK's #1 Baby Name Consultancy,0,0,0,0,16,16
1554795535,The Spot Starter,0,0,0,0,4,4
1554796831,The Trumpet Summit,0,0,0,0,2,2
1554803373,chitchatwithauzi's Podcast,0,0,0,0,4,4
1554805021,Turning Two,0,0,0,0,1,1
1554813049,Sad Thoughts,1,0,0,0,0,1
1554817897,"Hello, My Name is Baseball",0,0,0,0,1,1
1554876547,What's Up Sister?,0,0,0,0,6,6
1554877313,Forgotten Hollywood,0,0,0,1,5,6
1554879052,Just the Truth with Jenna Ellis,5,0,0,0,15,20
1554884432,Authentic Conversion For Online Health and Fitness Coaches,0,0,0,0,2,2
1554891468,Football Bedtime Stories,0,0,0,0,2,2
1554894572,Whip's Whatever Happened To...?,0,0,0,0,1,1
1554900520,The Dirt on Love,0,0,0,1,1,2
1554902911,Aviation Social Club,0,0,0,0,1,1
1554906872,"Love, Marriage and Reality TV",0,0,0,0,4,4
1554909365,Movie Time Capsule,0,0,0,0,1,1
1554912213,The Sh3nanigans Podcast With Anthony & James,0,0,0,0,1,1
1554913959,Closet Nerd Podcast,0,0,0,0,1,1
1554914351,Thinking With... A Rhetorical Theory Podcast,0,0,0,0,1,1
1554921653,Dirty Genes Podcast,0,0,0,0,9,9
1554921693,Zee Soccer Podcast,0,0,0,0,2,2
1554924241,Against the Wind - Podcast,0,0,0,0,3,3
1554930038,Empire,0,0,0,0,16,16
1554941103,Chasin' Birdies,0,0,0,0,2,2
1554948499,Pickaxe and Roll,0,0,0,0,8,8
1554962073,Watt It Takes,0,0,0,0,3,3
1554965076,Beers In The Shop,0,0,0,0,1,1
1554973779,The Breakdown,0,0,0,0,3,3
1554974708,YulsFM_el podcast,0,0,0,0,1,1
1554976005,iRewatch iCarly,0,0,0,0,23,23
1554978625,Why We Marathon,0,0,0,0,1,1
1554981562,La Zona Segura con Yaminah Cabrera,0,0,0,0,6,6
1554982702,Show Up or Shut Up with Wendy Solganik,0,0,0,1,8,9
1554984790,Reality Escape Pod,0,0,0,0,10,10
1554990739,Zooming With The Homies,0,0,0,0,6,6
1555006677,Organize Your Closet And Your Life Will Follow,0,0,0,0,2,2
1555029504,After The Beep with Tyler Elliott,0,0,0,0,2,2
1555052841,Nats Chat,0,0,0,0,28,28
1555054096,MuniciPals Golf Podcast,0,0,0,0,1,1
1555072917,Saved by the Belial: An Atrocious Ultraman Podcast,0,0,0,0,3,3
1555077411,United Sessions,0,0,0,0,4,4
1555082352,The Sound: Posture Check,0,0,0,0,2,2
1555103494,The SociEATy Podcast,0,0,0,0,9,9
1555107599,WHOA It’s Ryan!,0,0,0,0,48,48
1555117357,The Hindu/Yoga Dharma.,0,0,1,0,0,1
1555120298,Simplifying The Magic,0,0,0,0,5,5
1555122535,Beauty After Betrayal™,0,0,0,0,18,18
1555127572,The Soup Kitchen of Boynton Beach,0,0,0,0,2,2
1555134064,The ME Spot,0,0,0,0,19,19
1555134165,More Right Rudder,0,0,0,0,2,2
1555137542,Howie Mandel Does Stuff Podcast,5,0,0,1,32,38
1555155060,Let's Talk Bravo,0,0,0,0,1,1
1555159068,Sonder Thinking,0,0,0,0,1,1
1555165626,High Realitea,0,0,0,0,1,1
1555167377,The Sneider Cut: Collider Movie News,0,0,0,0,1,1
1555169719,Permission for Pleasure,0,0,0,0,7,7
1555177766,My Three Things,0,0,0,0,2,2
1555243483,Mapping Evil with Mike King,0,0,0,0,22,22
1555257529,Moment of Truth,0,1,0,0,7,8
1555272051,Trade Secrets Podcast,0,0,0,0,1,1
1555282384,Bettor Golf,0,0,0,0,7,7
1555284292,Homeschool Guides,0,0,0,0,1,1
1555294476,Between 2 Rebuilds,0,0,0,0,1,1
1555299031,Future Projection — A Baseball America Podcast,0,0,1,2,15,18
1555301078,NFR Podcast,0,0,0,0,2,2
1555302876,The Gary DeMar Blogcast,0,0,0,0,1,1
1555311524,Bums in the basement,0,0,0,0,1,1
1555315790,The Villainous Podcast,0,0,0,0,1,1
1555334173,We Are The Runners Show,0,0,0,0,3,3
1555334180,The Greatness Machine,0,0,0,0,37,37
1555337774,Millenial Money Podcast,0,0,0,0,3,3
1555344764,Every Outfit,1,3,1,0,14,19
1555353000,Moviestruck,0,0,0,0,2,2
1555362566,Chicago Athlete Podcast,0,0,0,0,20,20
1555386162,Pretty Intuitive,0,0,0,0,3,3
1555388123,The Ghostbusters Containment Unit Podcast,0,0,0,0,4,4
1555417267,Willing To Be Wrong,0,0,0,0,14,14
1555495789,Dawes Podcast,0,0,0,0,6,6
1555502698,Global Grooves,0,0,0,0,1,1
1555512397,Debris Division,0,0,0,0,2,2
1555518171,Emerging Motherhood,0,0,0,0,6,6
1555525577,Nochegeek,0,0,0,0,2,2
1555526048,The Dynasty Duo,0,0,0,0,5,5
1555527248,Woodland War Machine,0,0,0,0,2,2
1555532184,The Chris Rose Rotation,0,0,2,0,83,85
1555537731,The 540,0,0,0,0,2,2
1555543363,Syria's Lost Generation,0,0,0,0,1,1
1555548098,Cosmic Conversations with Sarah R. Adams,1,0,0,0,2,3
1555554179,Plants and Rants Podcast,0,0,0,0,20,20
1555588085,cookies by christine,0,0,0,0,1,1
1555589799,Your Woo Woo Best Friend,0,0,0,0,45,45
1555597876,Takeline,0,0,0,0,29,29
1555605578,Starting In Strategy,0,0,0,0,1,1
1555609061,Policy Influencer Playbook,0,0,0,0,1,1
1555616082,Dynasty Diner Podcast,0,0,0,0,2,2
1555616752,That Happens,0,0,0,0,45,45
1555620563,The Juan O’ Savin Podcast,0,0,0,0,1,1
1555624956,All That To Say,0,0,0,0,2,2
1555638739,MLG Meditations,3,0,0,0,7,10
1555638953,Adventure awaits- stories,0,0,0,0,3,3
1555659782,Happy Brain,0,0,0,0,19,19
1555682681,Kyle's Valheim Bulletin,0,0,0,0,2,2
1555712010,Partners N Crime,0,0,0,0,6,6
1555712209,Straight Chubb - Fantasy Football Podcast,0,0,0,0,6,6
1555726307,The Ladd Life,0,0,0,0,10,10
1555731836,Chin Music,0,0,0,0,2,2
1555732909,Playing Guilty,0,0,0,0,1,1
1555735025,Procurement Rising,0,0,0,0,3,3
1555736348,I wanna jump like Dee Dee,0,0,0,0,2,2
1555737243,According to Need,0,0,0,0,18,18
1555741784,Tinseltown Thunderdome,0,0,0,0,6,6
1555751972,High Performance Founder,0,0,0,1,11,12
1555761143,Energy Impact,0,0,0,0,28,28
1555761880,POA Podcast,0,0,0,1,0,1
1555762235,Scared Confident,0,0,0,0,5,5
1555762398,MAN-slaughter,44,37,20,7,39,147
1555763736,Doing the Mos,0,0,0,0,4,4
1555769970,The Atlas Obscura Podcast,2,1,1,4,22,30
1555769971,The Jeff Dunham Podcast,0,0,0,2,40,42
1555772611,CRNA School Prep Academy Podcast,0,0,0,0,1,1
1555774134,Herbalist Kareem Speaks,0,0,0,0,2,2
1555774324,Confessions of a Server,0,0,0,0,4,4
1555776482,Greenletes Podcast,0,0,0,0,2,2
1555777775,The Houseplant Coach,0,0,0,0,1,1
1555778769,Vivir Casi Casi Cero,0,0,0,0,1,1
1555782021,Say Less,0,0,0,0,16,16
1555784243,Cars & Comrades,0,0,0,0,1,1
1555784520,SINPHONY Radio w/ Timmy Trumpet,0,0,0,0,2,2
1555791824,Shrink Rap,0,0,0,0,4,4
1555817777,Pod People’s Podcast (for People Who Make Podcasts),0,0,0,0,3,3
1555843026,The Final Batch Podcast,0,0,0,0,1,1
1555848961,Hang and Hunt Podcast,0,0,0,0,7,7
1555858207,Startup Renegades,0,0,0,0,21,21
1555863304,Into the Super-Verse,0,0,0,0,4,4
1555880247,Country First Conversations,0,0,0,0,2,2
1555897336,Some Anime,0,0,0,1,0,1
1555910733,Going Against The Flow,0,0,0,0,28,28
1555943922,Dirty T Podcast,0,1,0,0,0,1
1555948815,"Watched Once, Never Again",0,0,0,0,5,5
1555951437,The Gigi Meyer Podcast,0,0,0,0,5,5
1555951552,What The Parent?,0,0,0,0,1,1
1555952602,The Net Zero Life,0,0,0,0,10,10
1555954426,The Lizard Market,0,0,0,0,47,47
1555955858,ManKind Podcast,0,0,0,0,6,6
1555959543,Passages: Nicaea,0,0,0,0,3,3
1555965843,Weekly Skews,0,0,0,0,1,1
1555971094,1991 Movie Rewind,0,0,0,0,1,1
1555974971,Racin Rehab,0,0,0,0,3,3
1555983556,Get Better Today,0,0,0,0,33,33
1555990007,Young & Curious,0,0,0,0,2,2
1555995577,Multiply,0,0,0,0,2,2
1555999132,Finance Explained by Family Finance Mom,0,0,0,0,6,6
1556009848,Boundless Love,0,0,0,1,11,12
1556012940,Marvel Talk,0,0,0,0,4,4
1556020856,"Luther's World of Cryptids, Ghosts and the Unexplained",0,0,0,0,1,1
1556039868,Birthright,0,0,0,0,2,2
1556068808,The Jessica Haizman Podcast,0,0,0,1,14,15
1556068809,Trade Tales,0,0,0,0,2,2
1556090956,Winnipeg Sports Talk,0,0,0,0,2,2
1556095791,Cool Story Guys,0,0,0,0,7,7
1556100383,You Belong in the C-Suite,0,0,0,0,1,1
1556105705,Limitless with Callie Ray & Kendall,0,0,0,0,10,10
1556107480,The Way We Parent,0,0,0,0,1,1
1556108242,Always Be My Sisters,0,0,0,0,1,1
1556108250,PETPIX ACADEMY with Vasi Siedman,0,0,0,1,29,30
1556115508,HEALTHCARE HACKS AND CONNECTIONS,0,0,0,0,50,50
1556117130,Talking Hockey Sense,0,0,0,0,6,6
1556117187,ONE&ALL Daily Podcast,0,0,0,0,48,48
1556118468,My Warped Life,0,0,0,0,5,5
1556119707,Carol & Kay Save the USA,0,0,0,0,2,2
1556123349,The Super Podcast,0,0,0,0,1,1
1556127041,Locked On Blue Devils - Daily Podcast On Duke Blue Devils Football & Basketball,0,0,0,0,5,5
1556127592,"I'm The Promoter, He's The DJ",0,0,0,0,2,2
1556133498,Applehype,0,0,0,0,1,1
1556136290,Bold stories. Future focused.,0,0,0,0,3,3
1556136943,Unleashed with The Dingo and Danny Podcast Fueled by Monster Energy,0,0,0,0,3,3
1556141746,Out of the Dark with Mandisa & Laura Williams,2,0,0,0,24,26
1556143846,Worst Movies Ever Played,0,0,0,0,5,5
1556145872,Unfinished Attic,0,0,0,0,3,3
1556150939,Novel Dialogue,0,0,0,0,2,2
1556156450,HER Crowne,0,0,0,0,1,1
1556161125,Back On Air with Jared Lipscomb,1,0,0,0,16,17
1556163736,The Katie Armstrong Show,0,0,0,0,6,6
1556166428,Flycast,0,0,0,0,1,1
1556167402,Downtown Dish,0,0,0,0,3,3
1556170236,The Guide Post,0,0,0,0,8,8
1556170930,Hawkeye Podcast,1,0,0,0,13,14
1556174094,Inside the War Room: Case Studies in Crisis,0,0,0,0,8,8
1556178503,Jack Russell Parents,0,0,0,0,4,4
1556181577,Mat & Board,0,0,0,0,4,4
1556192301,Dame’s Dropback,0,0,0,0,1,1
1556194535,Down On The Farm,0,0,0,0,1,1
1556198318,Small Potatoes,1,0,0,0,10,11
1556203012,Bad. Dog. Owners.,0,0,0,0,1,1
1556211379,Speculative Futures,0,0,0,0,1,1
1556215258,The Father Daughter Dance,0,0,0,0,5,5
1556249417,Elaine Heney and Listening to the Horse for Equestrians and Horse Owners,0,0,0,0,3,3
1556252358,Sierra Spills: A College Girl's Guide to Breaking into the Music Industry,0,0,0,0,5,5
1556261212,She Did That.,0,0,0,0,3,3
1556261828,Being Known Podcast,0,0,0,0,5,5
1556274596,All The Best (& Worst) with Mr and Mrs Hinch,0,0,0,0,6,6
1556275377,Parenting On Purpose,0,0,0,0,7,7
1556277440,Quarterback Kids Podcast,0,0,0,0,3,3
1556285486,Things Every 13 Year Old Should Know,0,0,0,0,4,4
1556287587,The Cast with Rae & Jacquis,0,0,0,0,6,6
1556293968,The Hallway Nerds Sports Podcast,0,0,0,0,1,1
1556294177,The Rock Podcast with Denny Somach,0,0,0,1,2,3
1556294981,Gracious & Strong,0,0,0,1,2,3
1556298146,Dew Diligence,0,0,0,0,1,1
1556303441,The MaxLiving Podcast,0,0,0,0,5,5
1556315813,Baseball Elite,0,0,0,0,2,2
1556319156,A Remarkable Thought,0,0,0,1,23,24
1556322097,iMurder,0,0,1,0,20,21
1556322548,Moms on Break,0,0,0,0,1,1
1556324179,A Little Bit Crazy,1,0,0,0,32,33
1556325346,At least you didn't...,0,0,0,0,1,1
1556327367,Who What Wear with Hillary Kerr,0,0,0,0,3,3
1556333569,Hype Juice,1,0,0,0,0,1
1556346842,Milk Crates and Turntables,0,0,0,0,5,5
1556351210,Nomad or What,0,0,0,0,15,15
1556359588,Storykeepers Podcast,0,0,0,0,2,2
1556363937,The Razzle Dazzle Podcast ~ LOST,0,0,0,0,4,4
1556380230,Life & A Little Basketball,0,0,0,0,7,7
1556385005,BuckyCast Wisconsin Badgers Football and Basketball Podcast,0,0,0,0,1,1
1556394833,Flagrant Pod,0,0,0,0,10,10
1556399128,Playing with Madness,0,0,0,0,3,3
1556405287,Tap In w/ Harry Jowsey,2,0,0,0,26,28
1556412589,The Borderline Podcast,0,0,0,0,1,1
1556446577,RedPath Radio,0,0,0,0,1,1
1556449891,Behind The Edit,0,0,0,0,2,2
1556456461,Caps This Morning,0,0,0,0,3,3
1556457357,Pop Pantheon,0,0,0,0,4,4
1556468567,Lazy Lab Podcast,0,0,0,0,1,1
1556474042,The Livin' It Podcast,0,0,0,0,2,2
1556474825,The No Name Football Podcast,0,0,0,0,6,6
1556479134,The Ben Domenech Podcast,0,0,0,0,4,4
1556481732,Rediscover Italy Podcast,0,0,0,1,4,5
1556485009,Being An Artist,0,0,0,0,1,1
1556491705,Wake The Fake Up,0,0,0,1,49,50
1556502174,The Garden Kickback,0,0,0,0,6,6
1556506588,Stroke Alert,0,0,0,0,1,1
1556523798,IN Construction with Nate Lelle,0,0,0,0,1,1
1556527072,ALIVE 2021: A Daft Punk Podcast,0,0,0,0,1,1
1556538745,A GM's Toolbox,0,0,0,0,1,1
1556539663,Scoop World Order,0,0,0,0,1,1
1556541907,BirdSport,0,0,0,0,2,2
1556549466,Three Way Miss,0,0,0,0,3,3
1556553953,Gaters Gonna Rate,0,0,0,0,1,1
1556561215,Tables and Chairs with Kem,0,0,0,0,1,1
1556568709,Mad Vibeyy,0,0,0,0,3,3
1556572336,Toadally My Jam Podcast,0,0,0,0,1,1
1556587604,The X-Block Podcast,0,0,0,0,4,4
1556655392,The Teacher Talk Show,0,0,0,0,1,1
1556661422,The Amazing Clarks,0,0,0,0,4,4
1556679893,Marks of a Mogul,0,0,0,0,27,27
1556680950,Beauty Boss Millionaire,0,0,0,0,5,5
1556685428,FIO with Maddy Forberg,0,0,0,0,4,4
1556687660,Candace,6,0,1,0,42,49
1556687898,The Publishing Life Podcast,0,0,0,0,5,5
1556706345,JUVY Podcast,0,0,0,0,2,2
1556707445,Hobby Farms Presents: Growing Good,0,0,0,0,1,1
1556711535,The Leap Lifestyle Podcast,0,0,0,0,2,2
1556718910,Tripping with Tripp,0,0,0,0,1,1
1556726534,Baking it Down with Sugar Cookie Marketing,0,0,0,0,3,3
1556727567,Cake Money Confidential,0,0,0,0,2,2
1556735011,The Era,0,0,0,0,5,5
1556738909,Game Day Routine,0,0,0,0,6,6
1556747108,Bowtie Sales Guys,0,0,0,0,4,4
1556757450,Glitchless Gaming,0,0,0,0,1,1
1556758329,Legally Balanced,0,0,0,0,3,3
1556761351,Playlist Wars,0,0,0,0,12,12
1556767205,Huckleberry Gin,0,0,0,0,8,8
1556767230,Health Coach Success,0,0,0,0,4,4
1556772829,Two Dudes and Tunes,0,0,0,0,2,2
1556774903,Bloom With Bridget,0,0,0,0,5,5
1556782348,The Original Draft Breakdown Podcast,0,0,0,0,4,4
1556786856,Anchored In Hope with Father Larry Richards - Catholic Faith,0,0,0,0,2,2
1556787224,CraftFood Podcast,0,0,0,0,1,1
1556793630,A French Village Podcast with Sarah Longwell and Ben Wittes,1,0,0,1,41,43
1556796646,The Halfstep Pod,0,0,0,0,4,4
1556799191,BLACK GIRLS EATING,0,0,0,0,2,2
1556803035,Black Millennial Mamas,0,0,0,0,1,1
1556803265,Kitty Talk,0,0,0,0,1,1
1556847922,The Morelli Show,0,0,0,0,8,8
1556849457,Rennervate,0,0,0,0,1,1
1556881367,Bottom Line Up Front with SEAC,0,0,0,0,1,1
1556882801,Plan Paradise Podcast,0,0,0,0,1,1
1556882807,Soft Voice,1,0,1,0,15,17
1556895610,The Chaotic Duo,0,0,0,0,2,2
1556900425,Inside Global Girls' Education,0,0,0,0,1,1
1556915172,"But First, She Failed Podcast",0,0,0,0,21,21
1556922375,Boots and Bangles Podcast,0,0,0,0,3,3
1556929268,Beauty Uncovered,0,0,0,0,15,15
1556931936,The Macaroni Zone,0,0,0,0,1,1
1556932454,Mama Unscathed,0,0,0,0,1,1
1556945681,Bizarre Podcast: Dogs Must Die,0,0,0,0,3,3
1556959374,Your Journey to the Divine,0,0,0,0,2,2
1556962716,Learning Lots,0,0,0,0,32,32
1556967485,Press Pause,0,0,0,0,2,2
1556969784,Baseless Speculation,0,0,0,1,2,3
1556974739,Cinema Oblivia,0,0,0,0,1,1
1556981900,The Freaking Ricans,0,0,0,0,4,4
1557023319,Tell me How,0,0,0,0,1,1
1557029036,Hammer & Grind,0,0,0,0,11,11
1557043379,Spa Siobhan,0,0,0,0,1,1
1557043581,Chasing the Natty: A College Football Fantasy Podcast,0,0,0,0,1,1
1557047043,WTF Did I Just Watch?,0,0,0,0,7,7
1557068203,Causeway Kings,0,0,0,0,1,1
1557071751,Dead North,0,0,0,0,2,2
1557081667,Heroes of Gaming Podcast,0,0,0,1,4,5
1557108431,Stories with Brisco and Bradshaw,0,0,0,0,2,2
1557120332,Armchair Athlete Podcast,0,0,0,0,1,1
1557122262,Lit Matters,0,0,0,0,1,1
1557125646,Nourish You,0,0,0,0,1,1
1557127175,Dr. Garrett Soldano DC Podcast,0,0,0,0,2,2
1557136870,Chat Em Up w/ DCA,0,0,0,0,1,1
1557142975,Jets Banter,0,0,0,0,2,2
1557148383,Movie Luchador,0,0,0,0,3,3
1557149704,Implotsters,0,0,0,0,2,2
1557151861,Royals Weekly,0,0,0,0,4,4
1557153036,Friends to Watch With,0,0,0,0,2,2
1557153612,A Couple More Things,0,0,0,0,3,3
1557156887,ALASKA BARCAST,0,0,0,0,2,2
1557164140,Down In Sugar Land - The Official Podcast of the Sugar Land Skeeters,0,0,0,0,1,1
1557175310,swish media podcast,0,0,0,0,2,2
1557175342,Iconoblast Podcast,0,0,0,1,21,22
1557178614,32 Bar Cut: The Show,0,0,0,0,3,3
1557257063,The Greatest Music Podcast,0,0,0,0,5,5
1557287821,Bunker 2 Bunker,0,0,0,0,3,3
1557288837,22,0,0,0,0,4,4
1557289697,Jabin Chavez Leadership Podcast,0,0,0,0,3,3
1557301306,SweetTea,0,0,0,0,5,5
1557346480,The Balance After Baby,0,0,0,0,3,3
1557350727,Unprepared Casters,0,0,0,0,26,26
1557373207,The Chirp Hockey Podcast,0,0,0,0,3,3
1557381717,Scarlet Sandbox,0,0,0,0,15,15
1557385009,Swaggy Dot Com,0,0,0,0,2,2
1557394864,Spoiler Wars Podcast,0,0,0,0,2,2
1557396838,Chaos! Fantasy Football League Podcast,0,0,0,0,1,1
